"Forest","Agriculture","Urban","Grassland","Other","Area_Total","forest_sp","agriculture_sp","generalist_sp","Sp_Total"
147070000,292150000,454400000,20770000,1575750000,2490140000,28,21,61,110
172980000,395020000,49980000,810000,1579250000,2198040000,25,26,54,105
175890000,1257450000,148490000,14550000,903620000,2.5e+09,30,29,60,119
619460000,781250000,9630000,45460000,1044200000,2.5e+09,27,22,54,103
565210000,517030000,59010000,50480000,1308270000,2.5e+09,32,29,61,122
248050000,1979790000,12970000,16870000,242320000,2.5e+09,29,21,57,107
991010000,445190000,30880000,380000,1032540000,2.5e+09,26,22,62,110
597140000,1807380000,24770000,3650000,67060000,2.5e+09,30,24,62,116
469440000,1897980000,24410000,13200000,94970000,2.5e+09,30,21,63,114
597850000,1300620000,1.32e+08,30240000,439290000,2.5e+09,26,26,60,112
719640000,1444340000,76290000,30640000,229090000,2.5e+09,29,25,65,119
1221380000,659120000,39420000,4530000,575550000,2.5e+09,27,18,54,99
1340190000,1046150000,9510000,1620000,102530000,2.5e+09,30,26,61,117
922150000,855170000,126330000,48740000,547610000,2.5e+09,27,26,56,109
1456990000,358370000,18800000,12750000,653090000,2.5e+09,28,24,48,100
148730000,854620000,22350000,46710000,1427590000,2.5e+09,29,26,71,126
845680000,604670000,7430000,169460000,872760000,2.5e+09,30,29,63,122
414280000,744400000,53980000,48390000,1238950000,2.5e+09,27,28,72,127
439840000,1858190000,16840000,41220000,143910000,2.5e+09,28,22,63,113
466820000,1356390000,6910000,118840000,551040000,2.5e+09,35,26,66,127
380550000,2010980000,15190000,14730000,78550000,2.5e+09,28,22,59,109
122230000,1766120000,43360000,322040000,246250000,2.5e+09,35,30,74,139
786170000,983310000,22820000,35130000,672570000,2.5e+09,32,23,61,116
484080000,1091590000,3430000,187140000,733760000,2.5e+09,36,33,74,143
50250000,783370000,69970000,15240000,1581170000,2.5e+09,37,32,84,153
15130000,55280000,53640000,15490000,1599790000,1739330000,32,30,66,128
688730000,741300000,12970000,62060000,994940000,2.5e+09,32,31,66,129
505860000,1099070000,5040000,303590000,586440000,2.5e+09,25,22,35,82
283010000,1637100000,8120000,293570000,278200000,2.5e+09,30,26,57,113
64010000,904160000,21160000,1030490000,480180000,2.5e+09,33,30,70,133
133870000,1985160000,18900000,139840000,222230000,2.5e+09,34,29,71,134
96380000,1353660000,11820000,269900000,768240000,2.5e+09,32,33,71,136
219170000,163890000,4230000,75200000,1807420000,2269910000,21,19,29,69
462900000,289980000,242170000,16530000,1373140000,2384720000,24,16,50,90
594330000,1031150000,140410000,67260000,666850000,2.5e+09,25,19,39,83
1017820000,635340000,36020000,50430000,760390000,2.5e+09,24,23,45,92
748630000,529020000,125440000,161250000,935660000,2.5e+09,30,25,50,105
616790000,665380000,102820000,6.4e+07,1051010000,2.5e+09,28,23,57,108
602590000,694890000,23310000,546930000,632280000,2.5e+09,30,28,55,113
445530000,474580000,14300000,334390000,1231200000,2.5e+09,30,29,66,125
771040000,1126010000,17880000,78380000,506690000,2.5e+09,30,23,45,98
993420000,751790000,49430000,123650000,581710000,2.5e+09,27,28,48,103
632550000,1133560000,15680000,142520000,575690000,2.5e+09,27,21,40,88
481470000,784390000,32950000,146930000,1054260000,2.5e+09,29,25,49,103
5.1e+08,769190000,18960000,300740000,901110000,2.5e+09,37,31,73,141
367300000,1209360000,15220000,114990000,793130000,2.5e+09,26,26,46,98
401060000,9.86e+08,20730000,1.1e+08,982210000,2.5e+09,29,23,51,103
240340000,1373610000,10080000,193720000,682250000,2.5e+09,32,26,69,127
117380000,1164760000,8360000,219730000,989770000,2.5e+09,35,30,79,144
398500000,721480000,5170000,518640000,856210000,2.5e+09,31,30,61,122
363420000,1231180000,19020000,141690000,744690000,2.5e+09,34,32,64,130
286230000,1301070000,12350000,122270000,778080000,2.5e+09,30,31,69,130
443140000,1173540000,7760000,81640000,793920000,2.5e+09,30,27,46,103
932070000,543190000,27280000,174790000,822670000,2.5e+09,32,29,61,122
858840000,549600000,10720000,330700000,750140000,2.5e+09,25,22,41,88
606810000,682430000,2430000,213720000,994610000,2.5e+09,33,33,76,142
303540000,1296320000,4920000,258270000,636950000,2.5e+09,32,31,66,129
220280000,1427780000,5510000,536900000,309530000,2.5e+09,38,35,82,155
666910000,1084110000,1400000,84710000,662870000,2.5e+09,31,31,65,127
582370000,136120000,3930000,562130000,1215450000,2.5e+09,24,27,55,106
1120680000,441330000,16380000,241070000,680540000,2.5e+09,28,29,60,117
5310000,35110000,2610000,69960000,1727050000,1840040000,33,23,47,103
58030000,57560000,3030000,235730000,1982800000,2337150000,33,18,49,100
37110000,112050000,7280000,518800000,1824760000,2.5e+09,36,20,55,111
27670000,84540000,2040000,194440000,2191310000,2.5e+09,25,18,38,81
119890000,190870000,8900000,946780000,1233560000,2.5e+09,22,15,35,72
32620000,163980000,13840000,594360000,1695200000,2.5e+09,33,18,51,102
23120000,113910000,1970000,68970000,2285240000,2493210000,31,18,44,93
112360000,353130000,9530000,548640000,1476340000,2.5e+09,31,18,49,98
36010000,117270000,4400000,164190000,2113940000,2435810000,34,23,55,112
70190000,171530000,16580000,497740000,1743960000,2.5e+09,34,19,47,100
173250000,328050000,26870000,847960000,1123870000,2.5e+09,30,20,48,98
184890000,326790000,16720000,1151030000,820570000,2.5e+09,32,21,50,103
10730000,71200000,8280000,96140000,2151720000,2338070000,33,23,58,114
185500000,543890000,23630000,1571560000,175420000,2.5e+09,29,17,47,93
35240000,442590000,82760000,862160000,1077250000,2.5e+09,23,16,38,77
86140000,3.86e+08,17830000,713850000,1275780000,2479600000,29,17,45,91
39890000,143120000,70100000,1981400000,265490000,2.5e+09,29,17,40,86
134840000,317640000,20500000,1632530000,394490000,2.5e+09,29,15,38,82
121150000,308250000,18760000,1766180000,285660000,2.5e+09,28,17,41,86
28230000,101980000,30650000,1788660000,550480000,2.5e+09,30,19,47,96
106350000,117800000,21480000,2062810000,191560000,2.5e+09,28,16,40,84
33710000,159810000,90490000,2009740000,206250000,2.5e+09,32,19,49,100
41040000,161160000,59130000,453950000,1734450000,2449730000,32,23,53,108
64280000,106160000,24680000,628460000,1676420000,2.5e+09,34,21,51,106
365890000,1479860000,10260000,96060000,547930000,2.5e+09,31,32,75,138
239430000,421440000,58090000,957900000,823140000,2.5e+09,31,21,56,108
70130000,664930000,31140000,8.93e+08,840800000,2.5e+09,31,18,51,100
53260000,288930000,36700000,1678860000,442250000,2.5e+09,29,18,45,92
25630000,615480000,380160000,943780000,534950000,2.5e+09,30,19,56,105
131530000,2240000,540000,246510000,2119180000,2.5e+09,30,24,56,110
279420000,1510530000,24200000,316700000,369150000,2.5e+09,38,36,76,150
177720000,1765650000,6100000,275440000,275090000,2.5e+09,28,24,59,111
350550000,1022860000,5640000,4.81e+08,639950000,2.5e+09,33,28,70,131
48390000,1637350000,19100000,575030000,220130000,2.5e+09,31,31,78,140
314940000,1306160000,11060000,181790000,686050000,2.5e+09,35,35,78,148
305690000,1269610000,10680000,44370000,869650000,2.5e+09,28,32,64,124
104330000,64350000,75100000,6800000,1823710000,2074290000,26,21,49,96
114180000,1325100000,101850000,71710000,887160000,2.5e+09,30,32,74,136
20010000,2390150000,19860000,20380000,49600000,2.5e+09,32,29,59,120
98340000,1959360000,22360000,141770000,278170000,2.5e+09,28,31,71,130
484810000,1199410000,11930000,25590000,778260000,2.5e+09,24,24,52,100
461670000,762440000,2350000,248340000,1025200000,2.5e+09,30,26,63,119
316930000,922020000,6240000,479020000,775790000,2.5e+09,30,28,74,132
182410000,1916400000,42340000,82270000,276580000,2.5e+09,35,31,67,133
225940000,778480000,24650000,14640000,1456290000,2.5e+09,32,26,70,128
136790000,750710000,8090000,3450000,1600960000,2.5e+09,29,30,62,121
243730000,1931720000,24280000,32910000,267360000,2.5e+09,27,24,50,101
177050000,1994850000,80140000,31270000,216690000,2.5e+09,29,26,66,121
244300000,1492620000,6280000,13100000,743700000,2.5e+09,32,27,65,124
486270000,918480000,7740000,4290000,1083220000,2.5e+09,31,30,57,118
115310000,1762410000,11470000,75820000,534990000,2.5e+09,31,28,61,120
16930000,2052630000,34230000,17090000,379120000,2.5e+09,28,30,61,119
58830000,457090000,35410000,0,1948670000,2.5e+09,33,28,71,132
498960000,1372050000,6470000,3080000,619440000,2.5e+09,30,28,62,120
580420000,709350000,3910000,2640000,1203680000,2.5e+09,27,23,52,102
333500000,1458870000,3310000,12960000,691360000,2.5e+09,24,24,51,99
310490000,1387510000,5520000,119670000,676810000,2.5e+09,32,27,53,112
729220000,196780000,23150000,484020000,1066830000,2.5e+09,28,30,58,116
73210000,1241440000,98990000,3340000,1083020000,2.5e+09,32,26,70,128
307800000,1374150000,23120000,0,794930000,2.5e+09,25,24,53,102
135390000,1658220000,155370000,41480000,509540000,2.5e+09,34,33,80,147
527380000,1449160000,5210000,12700000,505550000,2.5e+09,29,23,57,109
538780000,1018480000,19950000,0,922790000,2.5e+09,28,24,63,115
465950000,762500000,8840000,6790000,1255920000,2.5e+09,28,22,58,108
772010000,471320000,2940000,98510000,1155220000,2.5e+09,30,23,53,106
739550000,581680000,1110000,30220000,1147440000,2.5e+09,30,28,67,125
209990000,901850000,115750000,33840000,1238570000,2.5e+09,28,25,63,116
56430000,987090000,240870000,7e+05,1214910000,2.5e+09,32,30,81,143
46080000,1244970000,83640000,1150000,1124160000,2.5e+09,32,29,72,133
457390000,956260000,64640000,650000,1021060000,2.5e+09,34,31,77,142
378300000,508300000,4670000,656220000,952510000,2.5e+09,32,35,78,145
201010000,1774140000,45880000,411030000,67940000,2.5e+09,38,36,80,154
626350000,1255410000,39620000,132860000,445760000,2.5e+09,34,36,75,145
363600000,386730000,2460000,536460000,1210750000,2.5e+09,35,33,76,144
568290000,406610000,42240000,5.64e+08,918860000,2.5e+09,36,33,76,145
143580000,2241420000,12120000,60380000,42500000,2.5e+09,32,28,72,132
147220000,1940430000,6010000,142490000,263850000,2.5e+09,35,27,74,136
770250000,1411350000,14550000,56760000,247090000,2.5e+09,33,26,63,122
383340000,1412210000,29560000,371230000,303660000,2.5e+09,35,29,78,142
46580000,2372500000,6310000,50410000,24200000,2.5e+09,32,30,57,119
103080000,2300680000,14140000,2.5e+07,57100000,2.5e+09,31,28,69,128
119490000,2226540000,18080000,18330000,117560000,2.5e+09,35,31,71,137
256750000,1871490000,59540000,50550000,261670000,2.5e+09,32,29,72,133
1131830000,125560000,1570000,223300000,1017740000,2.5e+09,31,31,63,125
849210000,1068750000,5420000,143310000,433310000,2.5e+09,34,35,72,141
982080000,73350000,3720000,323650000,1117200000,2.5e+09,32,32,67,131
585080000,1475130000,6070000,122600000,311120000,2.5e+09,36,32,77,145
294280000,141930000,7420000,222250000,1573920000,2239800000,27,24,49,100
55750000,47410000,5760000,91550000,1479660000,1680130000,28,27,56,111
206050000,970110000,535360000,382790000,405690000,2.5e+09,36,31,79,146
410630000,1336870000,4780000,244120000,503600000,2.5e+09,32,31,65,128
507360000,279410000,83600000,801490000,828140000,2.5e+09,36,34,79,149
572850000,865400000,5750000,214080000,841920000,2.5e+09,32,29,70,131
345510000,1177800000,29480000,110930000,836280000,2.5e+09,36,34,75,145
126200000,2127250000,29480000,10780000,206290000,2.5e+09,32,30,70,132
215360000,2062410000,9710000,28430000,184090000,2.5e+09,32,33,65,130
1226790000,681080000,7620000,129950000,454560000,2.5e+09,32,32,78,142
824830000,1161830000,1660000,1.01e+08,410680000,2.5e+09,34,34,76,144
713600000,232730000,25710000,510050000,1017910000,2.5e+09,32,30,66,128
484210000,1076310000,2770000,180650000,756060000,2.5e+09,34,31,72,137
925920000,477670000,19720000,432560000,644130000,2.5e+09,30,31,67,128
527230000,1293730000,3050000,28310000,647680000,2.5e+09,36,34,74,144
12350000,94040000,30170000,4490000,1856950000,1.998e+09,31,25,53,109
150350000,519740000,133190000,54420000,1637230000,2494930000,35,28,70,133
404410000,1610740000,12300000,34180000,438370000,2.5e+09,32,28,65,125
1179840000,563530000,540000,65900000,690190000,2.5e+09,32,28,66,126
405160000,1218250000,1940000,281740000,592910000,2.5e+09,29,27,63,119
690450000,1197540000,7400000,166730000,437880000,2.5e+09,30,29,66,125
1091690000,611850000,1460000,182660000,612340000,2.5e+09,30,25,54,109
1170060000,519070000,12370000,109750000,688750000,2.5e+09,33,31,82,146
1165950000,632560000,6740000,138080000,556670000,2.5e+09,33,32,74,139
383700000,1356340000,21380000,67730000,670850000,2.5e+09,39,35,88,162
373670000,1367310000,920000,106260000,651840000,2.5e+09,32,30,69,131
1174710000,66370000,88680000,489280000,680960000,2.5e+09,29,31,68,128
631160000,1491310000,44320000,20730000,312480000,2.5e+09,36,35,82,153
1275870000,27680000,61990000,577690000,556770000,2.5e+09,34,33,71,138
693310000,1299470000,16240000,135240000,355740000,2.5e+09,37,38,85,160
43680000,639190000,106510000,328830000,1381790000,2.5e+09,37,28,71,136
2.37e+08,1144870000,150290000,240240000,727600000,2.5e+09,37,27,82,146
4690000,88740000,40670000,12080000,1969870000,2116050000,29,23,66,118
263480000,1636930000,105190000,391910000,102490000,2.5e+09,37,28,72,137
40760000,926270000,195100000,536320000,801550000,2.5e+09,34,29,75,138
487610000,954170000,8890000,158290000,891040000,2.5e+09,29,25,51,105
179570000,1788640000,7480000,3270000,521040000,2.5e+09,35,28,64,127
131700000,1965880000,24820000,1710000,375890000,2.5e+09,39,33,81,153
196100000,1695170000,17150000,42350000,549230000,2.5e+09,38,30,73,141
499460000,1443880000,5860000,2480000,548320000,2.5e+09,36,33,77,146
1164500000,229800000,12190000,713960000,379550000,2.5e+09,39,32,80,151
625470000,1248390000,48850000,15770000,561520000,2.5e+09,38,38,80,156
1044700000,457090000,24360000,808400000,165450000,2.5e+09,36,33,73,142
1237830000,364860000,2440000,153880000,740990000,2.5e+09,34,35,70,139
650180000,53060000,37850000,650000,1449160000,2190900000,33,21,45,99
595070000,510110000,177160000,212230000,972170000,2466740000,30,28,69,127
1710380000,455660000,58930000,10740000,264290000,2.5e+09,30,20,49,99
595790000,1609260000,89470000,177260000,28220000,2.5e+09,32,26,66,124
268400000,2860000,36110000,850000,1436480000,1744700000,31,25,48,104
271530000,12310000,58320000,30000,1545270000,1887460000,30,23,49,102
711380000,499790000,355840000,136650000,796340000,2.5e+09,35,29,70,134
95670000,131240000,60190000,42800000,1845780000,2175680000,37,28,68,133
67030000,11850000,16070000,4190000,1488310000,1587450000,31,24,46,101
293760000,1712970000,99840000,290600000,102830000,2.5e+09,39,30,71,140
334950000,1135200000,45670000,245910000,738270000,2.5e+09,35,27,61,123
102240000,1881020000,110690000,393150000,12900000,2.5e+09,37,28,71,136
40580000,625090000,130990000,231520000,1471820000,2.5e+09,40,31,82,153
144570000,1729910000,79800000,536400000,9320000,2.5e+09,34,29,63,126
122150000,1965140000,124950000,272650000,15110000,2.5e+09,39,27,65,131
172030000,1724640000,70970000,508740000,23620000,2.5e+09,36,28,69,133
86690000,1586510000,283360000,478830000,64610000,2.5e+09,38,31,75,144
135830000,1352160000,155620000,816120000,40270000,2.5e+09,38,29,69,136
129650000,1703280000,103900000,547670000,15500000,2.5e+09,34,27,64,125
810760000,523760000,540000,174230000,990710000,2.5e+09,29,29,63,121
105690000,2070470000,12160000,0,311680000,2.5e+09,29,27,64,120
476550000,1254270000,7030000,31230000,730920000,2.5e+09,40,41,93,174
181910000,1949230000,6800000,4990000,357070000,2.5e+09,34,30,75,139
832090000,589140000,90280000,717830000,270660000,2.5e+09,35,32,76,143
873500000,159330000,8640000,486100000,972430000,2.5e+09,36,34,78,148
449870000,1535440000,152210000,245050000,117430000,2.5e+09,29,24,52,105
1371640000,761720000,42530000,113280000,210830000,2.5e+09,30,21,51,102
261140000,2068690000,107120000,50980000,12070000,2.5e+09,36,32,61,129
536380000,1595500000,32230000,108820000,227070000,2.5e+09,33,25,57,115
274950000,1777050000,99700000,330120000,18180000,2.5e+09,34,27,58,119
586180000,1239560000,84900000,565260000,24100000,2.5e+09,36,29,74,139
524930000,1607940000,118530000,193780000,54820000,2.5e+09,39,28,75,142
29850000,260420000,40150000,344060000,1825520000,2.5e+09,29,22,51,102
158680000,443870000,59330000,681430000,1156690000,2.5e+09,34,25,61,120
48050000,147670000,14610000,645280000,1384920000,2240530000,29,21,57,107
5370000,75550000,5560000,232230000,1466730000,1785440000,27,20,49,96
1890000,78430000,29480000,404970000,1829880000,2344650000,33,28,63,124
41330000,115520000,187470000,580300000,1575380000,2.5e+09,30,18,45,93
22110000,225070000,46300000,887620000,1318570000,2499670000,30,16,45,91
323120000,29270000,0,377660000,1769950000,2.5e+09,29,24,44,97
199420000,68520000,90520000,654370000,1487170000,2.5e+09,31,23,57,111
248470000,44640000,11300000,490690000,1704900000,2.5e+09,37,32,64,133
29600000,653710000,142240000,47080000,1627370000,2.5e+09,34,26,60,120
20640000,319350000,37250000,18520000,2101890000,2497650000,33,27,62,122
89290000,317310000,91340000,638070000,1362970000,2498980000,35,26,67,128
59970000,94990000,35130000,711920000,1597990000,2.5e+09,27,22,40,89
238490000,391710000,22600000,1741120000,106080000,2.5e+09,32,19,60,111
127850000,348440000,85320000,709940000,1228450000,2.5e+09,30,24,59,113
1.63e+08,622920000,141700000,1130780000,441600000,2.5e+09,32,26,62,120
234730000,43550000,5360000,1889090000,327270000,2.5e+09,36,29,61,126
98800000,148360000,175920000,1061110000,1015810000,2.5e+09,33,25,63,121
181070000,142980000,14040000,2002560000,159350000,2.5e+09,31,24,57,112
345770000,249810000,369530000,1276590000,258300000,2.5e+09,33,24,61,118
40370000,86040000,38270000,747160000,1588160000,2.5e+09,37,30,69,136
251040000,21230000,13290000,789110000,1424300000,2498970000,34,28,59,121
255310000,200550000,69410000,1646610000,328120000,2.5e+09,29,25,58,112
279510000,238040000,14620000,1819050000,148780000,2.5e+09,32,26,57,115
31280000,92960000,182330000,249020000,1701910000,2257500000,29,21,60,110
239010000,48330000,10530000,997360000,1204770000,2.5e+09,39,32,67,138
99170000,85770000,49970000,1322900000,942190000,2.5e+09,31,27,62,120
127920000,41760000,26050000,918360000,1385910000,2.5e+09,42,35,78,155
2.24e+08,185240000,471150000,1442480000,177130000,2.5e+09,31,23,50,104
575620000,31050000,16030000,1516030000,361270000,2.5e+09,27,21,47,95
250110000,354660000,192540000,1087490000,615200000,2.5e+09,36,28,67,131
572300000,84040000,22610000,1351050000,4.7e+08,2.5e+09,36,26,58,120
248590000,1450540000,120930000,151310000,528630000,2.5e+09,33,26,64,123
179460000,1777030000,144010000,198540000,200960000,2.5e+09,31,25,53,109
275310000,1923330000,76220000,135210000,89930000,2.5e+09,32,25,58,115
414640000,1735990000,63880000,207910000,77580000,2.5e+09,30,21,45,96
20580000,251810000,51520000,7e+06,1675380000,2006290000,32,21,50,103
50220000,886460000,80770000,850020000,632530000,2.5e+09,37,27,71,135
133680000,1431710000,119230000,806980000,8400000,2.5e+09,30,22,62,114
546400000,796600000,698260000,391320000,67420000,2.5e+09,30,22,57,109
274340000,803340000,203130000,335250000,883940000,2.5e+09,35,25,74,134
144350000,1518890000,59760000,767790000,9210000,2.5e+09,29,25,54,108
242580000,596450000,252420000,1107020000,301530000,2.5e+09,33,26,61,120
67990000,1693800000,210400000,524350000,3460000,2.5e+09,28,22,56,106
91710000,1563310000,202920000,622480000,19580000,2.5e+09,29,22,58,109
82590000,746650000,187680000,1471890000,11190000,2.5e+09,30,24,58,112
165690000,1306140000,140790000,849750000,37630000,2.5e+09,32,24,61,117
111030000,300620000,256620000,1769360000,62370000,2.5e+09,35,27,65,127
84830000,1081890000,890310000,395720000,47250000,2.5e+09,30,24,62,116
19100000,116490000,177280000,715670000,1471460000,2.5e+09,33,31,62,126
99950000,173440000,409350000,1480920000,336340000,2.5e+09,29,26,60,115
161150000,180450000,575370000,1156930000,426100000,2.5e+09,32,24,62,118
126330000,117510000,49240000,1838770000,368150000,2.5e+09,31,28,58,117
128390000,11990000,30470000,1932710000,396440000,2.5e+09,34,29,56,119
68440000,907180000,451600000,249620000,823160000,2.5e+09,32,26,68,126
70810000,1202010000,33710000,537480000,655990000,2.5e+09,35,23,66,124
617570000,208680000,9720000,1192510000,471520000,2.5e+09,31,26,60,117
32470000,520130000,88590000,220290000,1372390000,2233870000,36,24,70,130
152250000,1353300000,119530000,135550000,739370000,2.5e+09,36,25,64,125
220320000,1882950000,88920000,262570000,45240000,2.5e+09,31,21,50,102
137100000,1356850000,129310000,218790000,657950000,2.5e+09,33,28,70,131
300490000,1704090000,149940000,287820000,57660000,2.5e+09,31,23,54,108
18270000,218650000,42740000,222750000,1997590000,2.5e+09,37,32,69,138
211880000,560130000,315360000,297110000,1115520000,2.5e+09,38,26,70,134
100990000,445880000,181170000,209930000,1369160000,2307130000,31,22,58,111
41860000,1828100000,2.24e+08,395590000,10450000,2.5e+09,28,22,56,106
178840000,1710420000,207400000,378200000,25140000,2.5e+09,30,21,53,104
214450000,899940000,1087200000,252580000,45830000,2.5e+09,31,24,63,118
109590000,1481330000,446270000,414070000,48740000,2.5e+09,32,25,62,119
36860000,1559950000,361430000,514200000,27560000,2.5e+09,29,22,57,108
48890000,2257940000,114690000,63880000,14600000,2.5e+09,29,22,50,101
74690000,2035210000,214740000,123700000,51660000,2.5e+09,30,24,60,114
52700000,2089500000,177100000,145860000,34840000,2.5e+09,31,22,59,112
118870000,1742210000,431660000,114210000,93050000,2.5e+09,33,28,67,128
74940000,2000780000,173890000,157780000,92610000,2.5e+09,28,16,49,93
222060000,982270000,46070000,382550000,867050000,2.5e+09,35,24,66,125
104700000,1307400000,71110000,831160000,185630000,2.5e+09,39,30,78,147
160620000,1698020000,124810000,493570000,22980000,2.5e+09,35,26,64,125
158520000,968580000,53480000,1299720000,19700000,2.5e+09,34,27,63,124
137920000,1237830000,80800000,1032900000,10550000,2.5e+09,34,27,67,128
41770000,298870000,39660000,378870000,1708870000,2468040000,37,30,73,140
71800000,784060000,92630000,1330750000,220760000,2.5e+09,34,31,66,131
18020000,478440000,108590000,206610000,1469380000,2281040000,37,30,74,141
189150000,1187060000,120420000,985850000,17520000,2.5e+09,32,29,63,124
353710000,1031730000,59660000,1029490000,25410000,2.5e+09,34,27,67,128
334790000,1120310000,126690000,901050000,17160000,2.5e+09,34,27,60,121
284210000,15030000,2390000,421780000,1776590000,2.5e+09,32,23,58,113
317960000,16760000,1550000,430400000,1733330000,2.5e+09,33,25,64,122
243870000,5100000,3240000,635950000,1611840000,2.5e+09,31,26,58,115
92800000,1880000,2730000,188740000,2213850000,2.5e+09,25,19,48,92
121610000,10600000,340000,141400000,2226050000,2.5e+09,34,23,52,109
357390000,18840000,5320000,293290000,1825160000,2.5e+09,37,25,53,115
13100000,1550000,0,174490000,2266910000,2456050000,28,19,50,97
86400000,1910000,1010000,191280000,2219400000,2.5e+09,28,20,50,98
263370000,42880000,3870000,499720000,1690160000,2.5e+09,37,22,63,122
366320000,337580000,108740000,1000480000,686880000,2.5e+09,37,25,59,121
305960000,765190000,71380000,648770000,708700000,2.5e+09,36,27,56,119
493280000,381280000,49220000,381820000,1194400000,2.5e+09,42,27,68,137
163570000,14880000,3870000,167620000,2150060000,2.5e+09,38,27,63,128
557430000,297160000,41190000,470110000,1134110000,2.5e+09,32,25,65,122
209010000,49380000,8820000,510560000,1722230000,2.5e+09,31,24,55,110
156150000,1840000,330000,234440000,2107240000,2.5e+09,34,26,59,119
363840000,75840000,9470000,296960000,1753890000,2.5e+09,29,25,55,109
163200000,79670000,15090000,591120000,1650920000,2.5e+09,34,22,54,110
8440000,8e+06,1750000,27720000,2249530000,2295440000,32,21,52,105
0,3460000,3280000,280010000,2135870000,2422620000,32,20,50,102
498310000,1391960000,30540000,1e+06,578190000,2.5e+09,33,27,68,128
87260000,927460000,20910000,50000,1460580000,2496260000,34,32,71,137
432410000,1518100000,8800000,0,540690000,2.5e+09,34,30,74,138
721560000,1.181e+09,20360000,25080000,5.52e+08,2.5e+09,31,29,74,134
787760000,788790000,4960000,37320000,881170000,2.5e+09,34,35,74,143
119500000,2124240000,23200000,2600000,230460000,2.5e+09,37,33,79,149
857570000,825600000,87890000,534480000,194460000,2.5e+09,33,30,65,128
799770000,56840000,8350000,613370000,1021670000,2.5e+09,34,32,71,137
588660000,1743570000,24290000,81570000,61910000,2.5e+09,29,22,49,100
335090000,1866830000,30370000,251480000,16230000,2.5e+09,28,19,43,90
753320000,1445200000,66620000,200120000,34740000,2.5e+09,31,24,54,109
494210000,1771290000,58040000,124230000,52230000,2.5e+09,29,19,48,96
524660000,1577950000,138830000,2.36e+08,22560000,2.5e+09,36,31,69,136
789680000,1507410000,26190000,143850000,32870000,2.5e+09,31,25,54,110
571150000,1465850000,56320000,270000,406410000,2.5e+09,33,30,70,133
1230000,270240000,14070000,250000,1759410000,2045200000,36,32,86,154
377830000,1082940000,169820000,1420000,867990000,2.5e+09,31,26,62,119
851910000,435350000,3860000,174800000,1034080000,2.5e+09,38,32,78,148
192080000,1950050000,39550000,9e+05,317420000,2.5e+09,35,32,72,139
1308340000,266900000,6190000,219830000,698740000,2.5e+09,35,33,69,137
952400000,976260000,58500000,473770000,39070000,2.5e+09,33,31,72,136
827670000,38910000,6120000,791620000,835680000,2.5e+09,35,32,70,137
726960000,1221090000,44140000,440340000,67470000,2.5e+09,35,32,69,136
851500000,75740000,9110000,567710000,995940000,2.5e+09,33,29,69,131
154910000,2159130000,67520000,82230000,36210000,2.5e+09,31,26,58,115
166470000,2096320000,28060000,179410000,29740000,2.5e+09,28,23,50,101
422080000,1818480000,72220000,127540000,59680000,2.5e+09,31,31,66,128
156220000,1899420000,361990000,33680000,48690000,2.5e+09,30,28,54,112
1129760000,995940000,33960000,295910000,44430000,2.5e+09,32,25,58,115
478240000,1709850000,52730000,234030000,25150000,2.5e+09,30,22,48,100
1102720000,807920000,45860000,447400000,96100000,2.5e+09,36,26,67,129
1042150000,875510000,30360000,341770000,210210000,2.5e+09,30,27,58,115
697500000,834140000,53090000,869150000,46120000,2.5e+09,36,26,70,132
1129970000,1054290000,62590000,215240000,37910000,2.5e+09,31,24,54,109
769590000,624260000,124710000,913080000,68360000,2.5e+09,34,25,66,125
661150000,1034520000,67080000,716650000,20600000,2.5e+09,35,24,62,121
561200000,1688760000,75730000,140090000,34220000,2.5e+09,37,29,68,134
266730000,1233270000,32230000,931880000,35890000,2.5e+09,35,26,63,124
540120000,1150530000,43390000,657580000,108380000,2.5e+09,40,33,82,155
351710000,942120000,33960000,1144450000,27760000,2.5e+09,37,27,66,130
521550000,1484550000,128110000,330400000,35390000,2.5e+09,35,30,73,138
491790000,1602110000,137880000,218940000,49280000,2.5e+09,36,28,65,129
634110000,1666350000,106950000,45720000,46870000,2.5e+09,37,30,74,141
542570000,1675510000,46430000,216110000,19380000,2.5e+09,37,29,73,139
276920000,254530000,388250000,16300000,1536860000,2472860000,35,31,73,139
1251520000,417660000,20160000,307490000,503170000,2.5e+09,36,37,75,148
983580000,418360000,23910000,690520000,383630000,2.5e+09,38,32,83,153
1117860000,806570000,203730000,15730000,356110000,2.5e+09,33,32,64,129
1451260000,699010000,36030000,49150000,264550000,2.5e+09,37,32,84,153
1131530000,448860000,159160000,2860000,757590000,2.5e+09,34,33,69,136
685130000,1407390000,56800000,207620000,143060000,2.5e+09,34,27,70,131
1271600000,164910000,23110000,527460000,512920000,2.5e+09,35,33,69,137
499850000,1188240000,57170000,67540000,687200000,2.5e+09,35,35,77,147
675100000,949320000,119690000,102200000,653690000,2.5e+09,40,40,95,175
556010000,1516970000,67180000,314300000,45540000,2.5e+09,34,27,64,125
547050000,1647520000,67490000,216390000,21550000,2.5e+09,33,29,64,126
723070000,1268450000,18240000,410640000,79600000,2.5e+09,32,28,66,126
1471600000,361560000,13500000,420630000,232710000,2.5e+09,33,29,68,130
1011580000,532610000,33650000,866260000,55900000,2.5e+09,32,22,58,112
698740000,1029040000,40100000,641770000,90350000,2.5e+09,32,25,63,120
639620000,466590000,39420000,1269310000,85060000,2.5e+09,34,25,65,124
710520000,748850000,46150000,939470000,55010000,2.5e+09,33,28,60,121
1194440000,300530000,20890000,765100000,219040000,2.5e+09,36,26,68,130
1394060000,236240000,50750000,692640000,126310000,2.5e+09,33,27,62,122
7.91e+08,502050000,28340000,1106700000,71910000,2.5e+09,33,26,65,124
661960000,214510000,25610000,1515870000,82050000,2.5e+09,33,27,60,120
322190000,1320190000,65460000,752790000,39370000,2.5e+09,37,29,69,135
461530000,856040000,39070000,1131090000,12270000,2.5e+09,38,30,77,145
466830000,915310000,43370000,1039710000,34780000,2.5e+09,35,29,72,136
347390000,6.9e+08,76580000,1362340000,23690000,2.5e+09,38,32,73,143
1414640000,834220000,70200000,124300000,56640000,2.5e+09,37,31,81,149
750100000,1489740000,86050000,139320000,34790000,2.5e+09,36,28,66,130
704190000,1274380000,67600000,409770000,44060000,2.5e+09,37,32,77,146
427590000,1546770000,88970000,395500000,41170000,2.5e+09,35,26,65,126
24940000,420900000,42390000,420000,1873730000,2362380000,35,36,83,154
18690000,479480000,91860000,10330000,1621100000,2221460000,33,33,76,142
705660000,1168600000,89950000,104010000,431780000,2.5e+09,37,36,83,156
1151010000,648730000,86960000,126070000,487230000,2.5e+09,36,32,79,147
142980000,724790000,226220000,57250000,1348760000,2.5e+09,41,34,83,158
906950000,501840000,19270000,862020000,209920000,2.5e+09,36,28,71,135
930900000,436570000,19430000,791750000,321350000,2.5e+09,38,30,77,145
7.97e+08,494210000,42610000,963380000,202800000,2.5e+09,37,28,73,138
1428620000,185730000,13450000,252300000,619900000,2.5e+09,39,30,71,140
598640000,1093220000,206800000,541540000,59800000,2.5e+09,37,31,75,143
1031490000,608620000,45770000,693360000,120760000,2.5e+09,38,31,71,140
841730000,414350000,91730000,1042670000,109520000,2.5e+09,38,32,83,153
1.119e+09,573430000,73330000,654070000,80170000,2.5e+09,36,28,71,135
512750000,629370000,65840000,1227050000,64990000,2.5e+09,34,31,76,141
341160000,940950000,85600000,1095580000,36710000,2.5e+09,37,31,73,141
535040000,418570000,57720000,1451820000,36850000,2.5e+09,35,29,76,140
365680000,389820000,78580000,1639390000,26530000,2.5e+09,33,25,64,122
764770000,1371370000,64280000,283860000,15720000,2.5e+09,39,29,74,142
822590000,805210000,57290000,758130000,56780000,2.5e+09,37,29,70,136
827590000,1166230000,38200000,444020000,23960000,2.5e+09,35,26,64,125
1132470000,213300000,22680000,1094530000,37020000,2.5e+09,36,24,69,129
684060000,1234460000,224890000,39350000,317240000,2.5e+09,32,33,75,140
74070000,1017520000,72590000,190010000,1145810000,2.5e+09,36,36,91,163
813500000,1239960000,131860000,46740000,267940000,2.5e+09,37,35,88,160
348420000,731130000,346330000,211230000,862890000,2.5e+09,35,32,79,146
1204550000,559560000,85860000,469740000,180290000,2.5e+09,37,31,76,144
974390000,878890000,108340000,226540000,311840000,2.5e+09,37,31,77,145
1121080000,861760000,77140000,254680000,185340000,2.5e+09,35,38,84,157
1113230000,867100000,22650000,116190000,380830000,2.5e+09,34,34,76,144
412460000,900200000,431210000,704660000,51470000,2.5e+09,36,34,76,146
844380000,824040000,240660000,491950000,98970000,2.5e+09,32,30,69,131
625400000,1261060000,270940000,192320000,150280000,2.5e+09,40,38,90,168
696810000,1372750000,110310000,296770000,23360000,2.5e+09,36,32,74,142
581700000,719750000,161210000,968450000,68890000,2.5e+09,38,31,76,145
668570000,822040000,116470000,855240000,37680000,2.5e+09,36,29,67,132
581990000,1267850000,92980000,514750000,42430000,2.5e+09,38,33,80,151
691320000,1033130000,103740000,568340000,103470000,2.5e+09,37,34,83,154
1069140000,1030120000,30820000,347070000,22850000,2.5e+09,37,28,63,128
788910000,781320000,69120000,821720000,38930000,2.5e+09,36,28,68,132
873450000,1160330000,58080000,379330000,28810000,2.5e+09,36,28,66,130
725310000,1288770000,198330000,214270000,73320000,2.5e+09,35,29,71,135
105270000,54640000,137570000,1680000,1873080000,2172240000,32,26,62,120
1088700000,811490000,50270000,136440000,413100000,2.5e+09,36,40,86,162
1177680000,717870000,153940000,12560000,437950000,2.5e+09,33,32,85,150
1182650000,266250000,43410000,556560000,451130000,2.5e+09,35,37,77,149
1122500000,545770000,15500000,226720000,589510000,2.5e+09,32,37,80,149
1084700000,780220000,152280000,348840000,133960000,2.5e+09,38,36,83,157
1118820000,598190000,217280000,375980000,189730000,2.5e+09,38,37,78,153
1320280000,404490000,65970000,602720000,106540000,2.5e+09,39,30,82,151
1096980000,599850000,253960000,404620000,144590000,2.5e+09,37,30,81,148
982430000,918280000,73340000,488010000,37940000,2.5e+09,36,27,73,136
1078720000,745450000,140470000,482890000,52470000,2.5e+09,35,30,72,137
403720000,1217580000,45710000,809180000,23810000,2.5e+09,35,29,64,128
397580000,1367530000,57240000,666650000,1.1e+07,2.5e+09,35,29,63,127
345130000,1932740000,134290000,67820000,20020000,2.5e+09,35,29,62,126
254060000,2117850000,48020000,65890000,14180000,2.5e+09,34,27,60,121
357080000,1041620000,180830000,770260000,150210000,2.5e+09,41,30,84,155
412650000,969230000,58730000,1036340000,23050000,2.5e+09,33,28,59,120
581230000,1215880000,266780000,362990000,73120000,2.5e+09,36,30,67,133
5.27e+08,1657840000,192490000,95500000,27170000,2.5e+09,33,27,58,118
63380000,713050000,58810000,121900000,1341740000,2298880000,30,22,52,104
292750000,1121130000,109200000,487080000,489840000,2.5e+09,39,30,66,135
335080000,1196660000,319490000,569570000,79200000,2.5e+09,37,27,72,136
125620000,283230000,104940000,327220000,1399900000,2240910000,37,27,75,139
111680000,935580000,157570000,123290000,1171880000,2.5e+09,37,27,74,138
53760000,2148770000,167920000,117950000,11600000,2.5e+09,35,27,71,133
80530000,1478900000,527730000,189210000,223630000,2.5e+09,33,26,69,128
45670000,899370000,71360000,85850000,1360460000,2462710000,39,30,80,149
9450000,335180000,33490000,40550000,2041640000,2460310000,28,20,52,100
162070000,2035810000,114800000,119750000,67570000,2.5e+09,39,30,79,148
49310000,7.21e+08,33820000,14560000,1431070000,2249760000,35,28,75,138
112570000,2108030000,128760000,128070000,22570000,2.5e+09,38,31,82,151
588180000,1571210000,273850000,47590000,19170000,2.5e+09,35,29,59,123
436710000,1811520000,158480000,52280000,41010000,2.5e+09,36,29,66,131
798960000,1148650000,455160000,21150000,76080000,2.5e+09,38,31,67,136
430230000,1820940000,106660000,109270000,32900000,2.5e+09,36,28,70,134
351160000,1592880000,132310000,408620000,15030000,2.5e+09,34,26,58,118
638260000,1519500000,221770000,53720000,66750000,2.5e+09,38,28,72,138
141090000,828340000,104690000,227760000,1194210000,2496090000,43,34,88,165
298590000,1753850000,124660000,286330000,36570000,2.5e+09,38,28,69,135
107860000,1820420000,350300000,178710000,42710000,2.5e+09,34,26,63,123
145440000,2112010000,145130000,29840000,67580000,2.5e+09,36,27,65,128
55830000,802280000,101280000,116860000,1409700000,2485950000,37,34,78,149
63180000,2062850000,209250000,150180000,14540000,2.5e+09,35,31,68,134
19350000,414310000,58610000,129870000,1363660000,1985800000,30,25,64,119
402680000,1918660000,88820000,24470000,65370000,2.5e+09,36,28,64,128
636840000,1672470000,102500000,36150000,52040000,2.5e+09,41,30,77,148
232160000,2074300000,100880000,53060000,39600000,2.5e+09,38,29,64,131
785700000,1412910000,86920000,175160000,39310000,2.5e+09,36,29,66,131
738790000,1431280000,153690000,123340000,52900000,2.5e+09,36,30,80,146
547500000,1700210000,99310000,129980000,2.3e+07,2.5e+09,33,22,56,111
317550000,1916500000,120880000,98020000,47050000,2.5e+09,39,31,75,145
485860000,1806370000,95820000,42370000,69580000,2.5e+09,39,31,68,138
201650000,1555510000,417560000,241950000,83330000,2.5e+09,36,30,72,138
140740000,2025420000,161340000,153640000,18860000,2.5e+09,34,27,65,126
375320000,1069370000,424690000,559900000,70720000,2.5e+09,35,26,65,126
476980000,939490000,113610000,955750000,14170000,2.5e+09,36,28,70,134
59620000,1336750000,361070000,203650000,538910000,2.5e+09,41,28,76,145
51250000,1557310000,709380000,156870000,25190000,2.5e+09,32,25,63,120
94560000,1310090000,553570000,113800000,427980000,2.5e+09,40,26,83,149
23970000,124570000,282460000,167470000,1595780000,2194250000,38,27,76,141
34030000,1203980000,202410000,97420000,962160000,2.5e+09,42,28,80,150
695660000,1363730000,72070000,213820000,154720000,2.5e+09,40,31,74,145
1118260000,1170420000,45240000,139430000,26650000,2.5e+09,38,28,60,126
985120000,1030260000,44620000,326470000,113530000,2.5e+09,36,28,70,134
882350000,826260000,61660000,700850000,28880000,2.5e+09,33,24,56,113
510540000,1246370000,43180000,609140000,90770000,2.5e+09,38,32,80,150
445990000,1624530000,68660000,206280000,154540000,2.5e+09,38,32,76,146
733190000,1028530000,107290000,580600000,50390000,2.5e+09,38,29,79,146
827950000,1089990000,56170000,414370000,111520000,2.5e+09,40,29,77,146
624160000,1186240000,443880000,201800000,43920000,2.5e+09,31,23,60,114
1369850000,394060000,138860000,547560000,49670000,2.5e+09,39,28,76,143
1131040000,677740000,189520000,464910000,36790000,2.5e+09,31,24,65,120
1172050000,697070000,114240000,483560000,33080000,2.5e+09,34,26,69,129
3.59e+08,930410000,738630000,403740000,68220000,2.5e+09,36,26,70,132
491460000,1219960000,442530000,152090000,193960000,2.5e+09,41,31,78,150
237610000,1268880000,741420000,174470000,77620000,2.5e+09,39,28,76,143
37020000,398510000,545250000,1299040000,220180000,2.5e+09,40,28,83,151
209280000,1236130000,413440000,476700000,164450000,2.5e+09,42,34,82,158
699640000,533300000,332780000,707870000,226410000,2.5e+09,41,31,83,155
285040000,1334940000,396040000,403310000,80670000,2.5e+09,40,31,80,151
13320000,362980000,44950000,120440000,1958310000,2.5e+09,37,25,78,140
75610000,438160000,412780000,733360000,840090000,2.5e+09,40,31,80,151
35510000,126060000,120610000,1394570000,823250000,2.5e+09,38,27,81,146
245640000,908860000,148930000,318420000,878150000,2.5e+09,43,38,91,172
3500000,170320000,25610000,337790000,1961100000,2498320000,37,28,70,135
685710000,806860000,171950000,677830000,157650000,2.5e+09,39,29,71,139
967030000,633440000,67910000,797490000,34130000,2.5e+09,36,25,66,127
108460000,282770000,10450000,15240000,1965560000,2382480000,37,32,84,153
3.3e+07,130950000,42750000,28940000,2192310000,2427950000,38,33,81,152
0,15670000,0,0,1463900000,1479570000,27,20,48,95
765180000,261830000,7860000,37540000,1427590000,2.5e+09,36,31,81,148
349260000,597940000,117150000,96270000,1339380000,2.5e+09,38,38,94,170
661800000,139270000,100880000,2200000,1595850000,2.5e+09,35,27,72,134
518910000,214960000,28710000,8910000,1728510000,2.5e+09,36,33,74,143
609790000,86350000,940000,9690000,1793230000,2.5e+09,34,27,70,131
1154460000,431960000,182640000,507380000,223560000,2.5e+09,33,32,78,143
698210000,270610000,74460000,4410000,1452310000,2.5e+09,34,28,68,130
193330000,88850000,5260000,4240000,2208320000,2.5e+09,40,33,79,152
554400000,127030000,9260000,440000,1808870000,2.5e+09,35,29,74,138
640000,19720000,550000,2260000,1739640000,1762810000,41,32,80,153
428420000,252430000,130960000,4470000,1683720000,2.5e+09,31,26,64,121
985620000,500350000,27600000,241130000,745300000,2.5e+09,39,37,82,158
1297450000,574060000,97640000,99390000,431460000,2.5e+09,35,31,74,140
403780000,91210000,11430000,592050000,1401530000,2.5e+09,31,34,69,134
885740000,441360000,36110000,421220000,715570000,2.5e+09,31,36,74,141
975480000,236230000,72140000,645120000,571030000,2.5e+09,30,30,63,123
1228220000,71980000,4480000,535770000,659550000,2.5e+09,34,32,72,138
802800000,214440000,307660000,154190000,1020910000,2.5e+09,33,35,73,141
1150230000,123590000,39300000,482890000,703990000,2.5e+09,32,35,69,136
68270000,37900000,133720000,11850000,1648080000,1899820000,28,22,50,100
811470000,34750000,28190000,678790000,946800000,2.5e+09,33,32,69,134
607580000,63370000,16370000,688110000,1124570000,2.5e+09,32,31,68,131
674390000,1239160000,271710000,181430000,133310000,2.5e+09,36,37,80,153
924310000,1016870000,69120000,276760000,212940000,2.5e+09,32,34,64,130
658470000,68480000,70830000,638230000,1063990000,2.5e+09,35,32,70,137
547130000,51070000,37770000,769260000,1094770000,2.5e+09,29,30,64,123
566490000,110760000,35600000,495670000,1291480000,2.5e+09,32,31,67,130
658250000,307660000,58580000,581940000,893570000,2.5e+09,35,37,75,147
648910000,1282890000,191460000,148290000,228450000,2.5e+09,45,36,91,172
979300000,219240000,168680000,479930000,652850000,2.5e+09,40,38,87,165
702720000,729960000,167500000,725070000,174750000,2.5e+09,38,32,81,151
730830000,166630000,111220000,705470000,785850000,2.5e+09,41,35,79,155
1213880000,658020000,197610000,386700000,43790000,2.5e+09,38,33,80,151
974330000,654020000,91540000,679530000,100580000,2.5e+09,42,31,81,154
836480000,1177890000,321130000,99290000,65210000,2.5e+09,42,32,80,154
966290000,993740000,239050000,228240000,72680000,2.5e+09,41,31,84,156
945450000,242290000,53140000,159340000,1099780000,2.5e+09,33,31,65,129
540690000,1794640000,107610000,44170000,12890000,2.5e+09,28,27,61,116
1071490000,1169080000,58510000,112840000,88080000,2.5e+09,32,29,62,123
208420000,2096040000,109450000,8300000,77790000,2.5e+09,29,30,73,132
935500000,470460000,114120000,78790000,901130000,2.5e+09,30,25,59,114
1063900000,86870000,38180000,396340000,914710000,2.5e+09,32,32,69,133
397640000,1747120000,148820000,80390000,126030000,2.5e+09,35,38,81,154
1136500000,491590000,503140000,46020000,322750000,2.5e+09,33,36,74,143
194110000,1986570000,247820000,7430000,64070000,2.5e+09,27,27,69,123
787970000,60590000,46720000,850550000,754170000,2.5e+09,33,26,71,130
662560000,70860000,43990000,477650000,1244940000,2.5e+09,33,34,70,137
413860000,11880000,24180000,769640000,1280440000,2.5e+09,30,26,67,123
1290410000,59780000,69790000,389520000,690500000,2.5e+09,34,32,72,138
1322210000,644120000,218350000,278410000,36910000,2.5e+09,41,24,80,145
802090000,1107680000,286630000,226320000,77280000,2.5e+09,41,27,80,148
833730000,1194070000,301570000,115830000,54800000,2.5e+09,38,25,78,141
718900000,642860000,317270000,453870000,367100000,2.5e+09,43,32,90,165
633040000,239710000,134950000,10020000,1439280000,2.457e+09,31,27,50,108
616460000,1637090000,73670000,31130000,141650000,2.5e+09,32,34,77,143
1559230000,279470000,42980000,110600000,507720000,2.5e+09,29,27,66,122
285200000,1986480000,119940000,2800000,105580000,2.5e+09,28,28,58,114
1590510000,654800000,21390000,61820000,171480000,2.5e+09,29,26,58,113
1053170000,552140000,469520000,179350000,245820000,2.5e+09,42,38,78,158
52900000,1770730000,573630000,69870000,32870000,2.5e+09,30,26,64,120
1277210000,399820000,208430000,283270000,331270000,2.5e+09,40,33,75,148
49690000,2154720000,255460000,18360000,21770000,2.5e+09,32,28,64,124
759180000,39900000,42400000,941510000,717010000,2.5e+09,33,29,65,127
1053810000,92010000,54550000,453220000,846410000,2.5e+09,37,31,74,142
479580000,2e+06,23900000,729190000,1265330000,2.5e+09,30,26,58,114
789380000,105240000,30790000,455420000,1119170000,2.5e+09,31,28,65,124
485610000,1.082e+09,272580000,152800000,507010000,2.5e+09,38,28,84,150
909120000,226340000,167600000,946490000,250450000,2.5e+09,34,32,75,141
802060000,192800000,134710000,1283540000,86890000,2.5e+09,40,33,82,155
861340000,24890000,84550000,954720000,574500000,2.5e+09,32,28,70,130
494860000,538850000,40330000,37940000,1388020000,2.5e+09,32,23,51,106
1207500000,964320000,25190000,124280000,178710000,2.5e+09,28,22,50,100
394610000,1067080000,29860000,43750000,964700000,2.5e+09,31,23,61,115
1557750000,601810000,127200000,83360000,129880000,2.5e+09,33,31,64,128
569700000,1305830000,153040000,23180000,448250000,2.5e+09,32,24,61,117
1351520000,835750000,159920000,62960000,89850000,2.5e+09,31,26,59,116
886470000,1406740000,107920000,26070000,72800000,2.5e+09,30,23,56,109
114490000,2142240000,198840000,2340000,42090000,2.5e+09,27,29,69,125
803950000,1406940000,107440000,44660000,137010000,2.5e+09,28,27,64,119
35610000,2312270000,102360000,980000,48780000,2.5e+09,26,22,56,104
484980000,1650710000,202040000,44470000,117800000,2.5e+09,34,31,74,139
1449110000,232330000,62100000,261430000,495030000,2.5e+09,34,31,71,136
90820000,1850150000,246260000,67500000,245270000,2.5e+09,34,30,74,138
1405460000,492890000,132270000,310490000,158890000,2.5e+09,36,31,71,138
216260000,1934910000,253200000,31240000,64390000,2.5e+09,33,23,57,113
564340000,81130000,10870000,555430000,1288230000,2.5e+09,31,29,69,129
1084080000,204220000,41230000,538500000,631970000,2.5e+09,34,28,64,126
1522080000,409200000,102550000,162170000,3.04e+08,2.5e+09,33,30,68,131
935430000,158390000,75930000,983170000,347080000,2.5e+09,36,29,77,142
837530000,27260000,57730000,684210000,893270000,2.5e+09,26,24,51,101
1238390000,101830000,74880000,541750000,543150000,2.5e+09,39,32,77,148
852720000,69940000,103130000,584380000,889830000,2.5e+09,31,25,62,118
200090000,888320000,30830000,78760000,1217160000,2415160000,30,22,48,100
561490000,1606090000,47940000,114640000,169840000,2.5e+09,31,25,57,113
682090000,1413310000,20150000,160580000,223870000,2.5e+09,30,22,52,104
1472740000,819490000,29770000,41280000,136720000,2.5e+09,30,24,54,108
1292030000,918490000,68790000,61690000,1.59e+08,2.5e+09,31,27,57,115
11460000,2318450000,119960000,1040000,49090000,2.5e+09,22,20,44,86
72590000,2212650000,94010000,25100000,95650000,2.5e+09,34,30,73,137
807140000,1238870000,211170000,182540000,60280000,2.5e+09,36,35,76,147
104700000,2081430000,283030000,1330000,29510000,2.5e+09,28,17,46,91
1172300000,82050000,28490000,482010000,735150000,2.5e+09,33,28,70,131
1371270000,265140000,49900000,259120000,554570000,2.5e+09,35,32,78,145
1475620000,42920000,106270000,704790000,170400000,2.5e+09,34,23,69,126
703450000,14270000,30940000,806990000,944350000,2.5e+09,30,25,61,116
1035150000,343460000,83610000,963090000,74690000,2.5e+09,33,22,68,123
898490000,973760000,148960000,443640000,35150000,2.5e+09,31,26,68,125
1120720000,1023250000,163270000,148500000,44260000,2.5e+09,34,24,69,127
1169780000,838360000,95180000,337090000,59590000,2.5e+09,33,21,64,118
255060000,1471790000,557680000,126600000,88870000,2.5e+09,36,26,71,133
630120000,1133510000,315970000,283680000,136720000,2.5e+09,36,26,73,135
659260000,693590000,640300000,458560000,48290000,2.5e+09,30,18,67,115
768660000,735560000,525830000,418820000,51130000,2.5e+09,32,23,70,125
213850000,1154890000,180540000,920040000,30680000,2.5e+09,42,32,79,153
260290000,1301050000,318230000,516890000,103540000,2.5e+09,38,29,71,138
244690000,1860950000,222810000,157080000,14470000,2.5e+09,36,26,67,129
374290000,1137200000,779450000,151800000,57260000,2.5e+09,33,23,63,119
256100000,713140000,175430000,1231960000,123370000,2.5e+09,41,31,80,152
205380000,617290000,190180000,1379870000,107280000,2.5e+09,41,29,82,152
146680000,1822910000,176630000,297190000,56590000,2.5e+09,39,30,80,149
336700000,1754690000,130670000,161110000,116830000,2.5e+09,37,29,75,141
14340000,4.42e+08,56970000,567130000,1419560000,2.5e+09,37,28,75,140
21410000,684620000,134940000,698440000,960590000,2.5e+09,37,27,78,142
979240000,809170000,108230000,542800000,60560000,2.5e+09,39,28,77,144
1468660000,434310000,127410000,413410000,56210000,2.5e+09,36,28,69,133
1346700000,775110000,151160000,180140000,46890000,2.5e+09,40,27,80,147
1054230000,1030350000,193480000,156420000,65520000,2.5e+09,43,34,81,158
751020000,1047250000,245400000,379030000,77300000,2.5e+09,37,32,75,144
458810000,1247540000,176960000,554250000,62440000,2.5e+09,39,29,79,147
845030000,967420000,296750000,370950000,19850000,2.5e+09,34,24,66,124
975840000,835210000,166120000,492340000,30490000,2.5e+09,38,26,76,140
1105220000,909850000,177790000,273790000,33350000,2.5e+09,36,24,72,132
622670000,1521290000,228660000,60950000,66430000,2.5e+09,35,27,75,137
841310000,1085870000,365060000,192850000,14910000,2.5e+09,38,27,77,142
778450000,1093490000,417020000,148890000,62150000,2.5e+09,36,28,75,139
1432060000,515910000,226820000,295960000,29250000,2.5e+09,31,19,68,118
1233960000,308930000,255550000,670320000,31240000,2.5e+09,29,21,66,116
1270860000,760970000,97370000,340880000,29920000,2.5e+09,32,18,64,114
1109370000,798120000,191330000,384900000,16280000,2.5e+09,33,21,69,123
293310000,1884650000,246410000,63310000,12320000,2.5e+09,34,27,72,133
244440000,1.787e+09,278920000,164930000,24710000,2.5e+09,34,23,70,127
339810000,1667660000,401990000,70960000,19580000,2.5e+09,36,26,77,139
648670000,1368260000,197700000,244580000,40790000,2.5e+09,33,27,75,135
230750000,1513510000,175470000,475670000,104600000,2.5e+09,36,27,78,141
286230000,2028670000,77480000,86600000,21020000,2.5e+09,35,26,71,132
206640000,1233890000,321410000,696660000,41400000,2.5e+09,39,27,78,144
169820000,1838430000,78100000,252440000,161210000,2.5e+09,39,30,72,141
112550000,521400000,150580000,1358980000,356490000,2.5e+09,35,27,82,144
23150000,294870000,50330000,280890000,1850760000,2.5e+09,35,28,79,142
158280000,399440000,141050000,1400530000,400700000,2.5e+09,41,31,83,155
29990000,659080000,59810000,335470000,1415650000,2.5e+09,37,34,85,156
33090000,4960000,17870000,14990000,1436380000,1507290000,30,21,53,104
174560000,1808910000,82210000,53170000,381150000,2.5e+09,38,29,78,145
29450000,961180000,71190000,76520000,1361660000,2.5e+09,38,32,87,157
967660000,9.34e+08,283110000,163270000,151960000,2.5e+09,43,29,84,156
1346090000,539680000,141320000,457410000,15500000,2.5e+09,36,24,72,132
1169920000,912170000,173060000,174550000,70300000,2.5e+09,34,17,63,114
1057760000,815930000,192730000,417430000,16150000,2.5e+09,37,21,68,126
1275230000,919680000,190310000,103220000,11560000,2.5e+09,33,23,65,121
1094300000,976420000,222990000,118270000,88020000,2.5e+09,39,26,80,145
857340000,990300000,453830000,134840000,63690000,2.5e+09,41,27,80,148
904080000,1080010000,321500000,105660000,88750000,2.5e+09,34,24,68,126
1191280000,6.31e+08,115550000,525530000,36640000,2.5e+09,36,24,72,132
1378510000,766010000,180380000,125110000,49990000,2.5e+09,37,26,76,139
1063980000,992740000,86980000,3.39e+08,17300000,2.5e+09,36,23,70,129
541680000,1691070000,189640000,49710000,27900000,2.5e+09,37,30,79,146
947420000,1151850000,219070000,156020000,25640000,2.5e+09,31,19,66,116
1064460000,869980000,98980000,450570000,16010000,2.5e+09,31,19,57,107
9.66e+08,1278350000,102620000,142820000,10210000,2.5e+09,34,26,75,135
983990000,908950000,138780000,451630000,16650000,2.5e+09,37,27,76,140
746580000,1463550000,198490000,76520000,14860000,2.5e+09,33,23,71,127
977570000,1213720000,107670000,190170000,10870000,2.5e+09,32,26,71,129
520090000,1597020000,270080000,80890000,31920000,2.5e+09,37,29,84,150
887370000,1267930000,172500000,144540000,27660000,2.5e+09,40,25,74,139
413780000,1277330000,137630000,627200000,44060000,2.5e+09,37,29,74,140
479550000,1432540000,205680000,271080000,111150000,2.5e+09,41,29,81,151
1177440000,895180000,95970000,159780000,171630000,2.5e+09,38,29,72,139
835050000,1134070000,240130000,220880000,69870000,2.5e+09,38,31,77,146
142940000,942050000,128840000,1110380000,175790000,2.5e+09,38,31,83,152
219810000,1118490000,154810000,9.09e+08,97880000,2499990000,42,30,83,155
287800000,1417270000,169650000,549360000,75920000,2.5e+09,39,28,83,150
438130000,1034210000,652690000,291340000,83630000,2.5e+09,41,32,93,166
132260000,1432780000,115770000,573650000,245540000,2.5e+09,36,29,84,149
141430000,694400000,125500000,1402560000,136110000,2.5e+09,37,25,73,135
28540000,538160000,39030000,28480000,1865790000,2.5e+09,38,28,80,146
158360000,1146350000,152880000,269550000,772860000,2.5e+09,41,27,86,154
194500000,1885860000,154530000,29930000,235180000,2.5e+09,35,27,71,133
49460000,1721830000,113110000,19280000,596320000,2.5e+09,33,27,74,134
63860000,781160000,57560000,9940000,1587480000,2.5e+09,35,26,74,135
881520000,1019990000,324560000,257820000,16110000,2.5e+09,32,19,66,117
902030000,1108710000,112240000,335470000,41550000,2.5e+09,35,24,70,129
755640000,1285760000,226500000,183510000,48590000,2.5e+09,38,24,74,136
643510000,907530000,155250000,712980000,80730000,2.5e+09,34,25,71,130
919680000,1310580000,122630000,112570000,34540000,2.5e+09,30,19,62,111
752510000,1198790000,373760000,144540000,30400000,2.5e+09,30,20,62,112
513570000,1784010000,56640000,132310000,13470000,2.5e+09,32,25,68,125
851290000,995160000,151350000,462670000,39530000,2.5e+09,31,21,70,122
950030000,1235890000,93980000,207560000,12540000,2.5e+09,36,27,76,139
980960000,1258630000,122380000,115200000,22830000,2.5e+09,38,29,80,147
1076710000,1035460000,99890000,263030000,24910000,2.5e+09,32,26,75,133
1016560000,1022850000,80010000,327180000,53400000,2.5e+09,36,27,78,141
389080000,1868290000,159290000,57550000,25790000,2.5e+09,36,27,74,137
1171940000,879710000,223490000,213780000,11080000,2.5e+09,37,29,77,143
309900000,1938340000,161700000,40920000,49140000,2.5e+09,35,29,73,137
1046930000,1165400000,140740000,120400000,26530000,2.5e+09,35,25,75,135
372180000,1780540000,211270000,98400000,37610000,2.5e+09,36,30,82,148
1331540000,883590000,1.35e+08,103150000,46720000,2.5e+09,37,28,80,145
234180000,1852650000,253970000,106370000,52830000,2.5e+09,36,30,83,149
232550000,1994020000,205530000,30450000,37450000,2.5e+09,42,34,85,161
752360000,1461770000,73080000,199370000,13420000,2.5e+09,38,30,83,151
646420000,1391810000,134230000,303840000,23700000,2.5e+09,39,34,90,163
663810000,1255600000,72370000,4.65e+08,43220000,2.5e+09,40,33,86,159
676350000,1258740000,96880000,381320000,86710000,2.5e+09,39,33,86,158
191790000,1416260000,165320000,156030000,570600000,2.5e+09,40,30,81,151
619570000,1375910000,83660000,368550000,52310000,2.5e+09,41,31,92,164
309510000,1456060000,96980000,203410000,434040000,2.5e+09,41,34,94,169
665640000,1283240000,118220000,367340000,65560000,2.5e+09,34,26,70,130
85290000,764910000,45340000,74160000,1530300000,2.5e+09,40,29,81,150
12250000,80870000,9900000,18110000,2378870000,2.5e+09,32,24,61,117
644390000,1376570000,220280000,195930000,62830000,2.5e+09,34,26,82,142
621630000,779030000,147700000,908380000,43260000,2.5e+09,33,24,77,134
507150000,1691080000,127640000,160600000,13530000,2.5e+09,34,25,72,131
733990000,739820000,454120000,378650000,193420000,2.5e+09,36,29,81,146
696440000,1340210000,218520000,217570000,27260000,2.5e+09,33,24,75,132
708500000,1321960000,94620000,327100000,47820000,2.5e+09,39,28,82,149
1076330000,1006730000,129630000,270680000,16630000,2.5e+09,37,24,76,137
860230000,1379490000,128600000,109150000,22530000,2.5e+09,40,28,85,153
413070000,1822890000,141130000,112730000,10180000,2.5e+09,34,24,79,137
722130000,831580000,147670000,697450000,101170000,2.5e+09,33,25,80,138
1268330000,118920000,9750000,210000,1102790000,2.5e+09,36,30,78,144
313450000,63830000,13440000,0,1723880000,2114600000,36,35,85,156
211710000,25770000,5800000,590000,2256130000,2.5e+09,29,27,60,116
265740000,30500000,4160000,3e+05,2199300000,2.5e+09,29,25,61,115
385040000,1.9e+07,4910000,0,2091050000,2.5e+09,30,24,60,114
607490000,70410000,6e+06,0,1816100000,2.5e+09,31,23,64,118
672600000,110440000,11810000,970000,1704180000,2.5e+09,31,27,64,122
720630000,129260000,7550000,0,1642560000,2.5e+09,32,24,63,119
43040000,85050000,2410000,0,2175410000,2305910000,33,26,62,121
655260000,146810000,46560000,1530000,1649840000,2.5e+09,34,30,78,142
9210000,68240000,22080000,18980000,1394190000,1512700000,27,22,53,102
111180000,1462330000,76420000,22190000,827880000,2.5e+09,36,29,73,138
241270000,1854450000,89760000,2660000,311860000,2.5e+09,35,26,71,132
2011630000,135500000,19430000,0,333440000,2.5e+09,34,30,73,137
575250000,52410000,54360000,0,1582760000,2264780000,37,31,78,146
1438550000,116900000,50070000,0,894480000,2.5e+09,37,31,76,144
38960000,5160000,840000,0,1053990000,1098950000,27,20,49,96
1149330000,35780000,3400000,0,1311490000,2.5e+09,34,27,70,131
1088300000,23810000,3500000,0,1384390000,2.5e+09,31,26,68,125
1731270000,57200000,3050000,0,708480000,2.5e+09,34,26,62,122
2032020000,28910000,3470000,0,435600000,2.5e+09,33,24,65,122
572300000,21830000,8830000,0,1897040000,2.5e+09,32,28,68,128
1169340000,51710000,12210000,0,1266740000,2.5e+09,32,30,71,133
585020000,46890000,6020000,270000,1861800000,2.5e+09,26,23,60,109
412060000,82080000,12420000,0,1993440000,2.5e+09,33,30,73,136
1110360000,127600000,28770000,3900000,1229370000,2.5e+09,33,31,72,136
433660000,98060000,2370000,1810000,1964100000,2.5e+09,39,30,72,141
690410000,271270000,26320000,0,1.512e+09,2.5e+09,39,29,78,146
619180000,99070000,7800000,450000,1773500000,2.5e+09,33,30,66,129
810170000,146080000,5240000,3e+05,1538210000,2.5e+09,36,30,77,143
273170000,50900000,6070000,0,2169860000,2.5e+09,32,30,68,130
549150000,95740000,1130000,0,1853980000,2.5e+09,33,27,75,135
159940000,1805690000,94460000,125260000,314650000,2.5e+09,31,25,68,124
449800000,1680670000,113390000,19710000,236430000,2.5e+09,32,26,64,122
218090000,1363860000,92120000,21600000,804330000,2.5e+09,33,25,70,128
184510000,1380580000,196490000,27300000,711120000,2.5e+09,36,26,71,133
110990000,1194890000,69360000,53160000,1071600000,2.5e+09,37,29,74,140
102910000,1316530000,139140000,31920000,909500000,2.5e+09,34,26,70,130
24990000,910000,220000,0,1034170000,1060290000,17,10,33,60
1855630000,221910000,65200000,2170000,355090000,2.5e+09,40,34,80,154
1176130000,61870000,35920000,0,1213890000,2487810000,39,29,79,147
785700000,554830000,140310000,0,1019160000,2.5e+09,41,38,88,167
82740000,71320000,33180000,0,1674400000,1861640000,32,25,65,122
1706260000,95650000,12690000,440000,684960000,2.5e+09,34,28,69,131
1877630000,176150000,36970000,0,409250000,2.5e+09,40,29,81,150
1578250000,329080000,35390000,0,557280000,2.5e+09,38,31,75,144
1312090000,385010000,269280000,420000,533200000,2.5e+09,39,30,78,147
1053120000,138540000,15890000,0,1292450000,2.5e+09,34,32,71,137
1535340000,94140000,10520000,0,8.6e+08,2.5e+09,34,27,70,131
1293550000,361330000,4.9e+07,2870000,793250000,2.5e+09,37,32,80,149
1399750000,360550000,28650000,960000,710090000,2.5e+09,39,32,79,150
566170000,115730000,7470000,1e+06,1809630000,2.5e+09,39,35,71,145
1141650000,137060000,10710000,1750000,1208830000,2.5e+09,35,34,83,152
1085970000,116910000,17770000,870000,1278480000,2.5e+09,38,35,81,154
650890000,153010000,4490000,0,1691610000,2.5e+09,35,31,71,137
372150000,86710000,6440000,610000,2034090000,2.5e+09,28,32,60,120
755270000,150440000,3710000,0,1590580000,2.5e+09,28,28,60,116
716500000,99690000,2980000,0,1680830000,2.5e+09,34,27,63,124
168180000,182210000,8520000,0,2141090000,2.5e+09,24,24,65,113
881070000,236120000,10590000,0,1372220000,2.5e+09,31,32,78,141
784490000,196080000,3140000,0,1516290000,2.5e+09,33,27,69,129
731730000,375600000,90160000,0,1302510000,2.5e+09,33,32,74,139
47840000,221750000,17720000,5790000,1931130000,2224230000,30,24,62,116
55250000,212250000,26660000,6760000,2162790000,2463710000,32,28,67,127
1129600000,408510000,70330000,23050000,868510000,2.5e+09,43,34,85,162
496090000,269210000,92330000,42220000,1586980000,2486830000,40,32,84,156
1362860000,600150000,125060000,0,411930000,2.5e+09,37,35,91,163
911910000,197120000,21940000,13230000,1355800000,2.5e+09,36,28,77,141
1881600000,148060000,8850000,2e+06,459490000,2.5e+09,36,27,65,128
1774540000,329790000,18640000,3890000,373140000,2.5e+09,34,25,68,127
1380440000,704200000,75060000,1020000,339280000,2.5e+09,39,28,72,139
1553380000,572680000,57420000,0,316520000,2.5e+09,40,33,80,153
1489450000,115140000,20680000,1350000,873380000,2.5e+09,33,34,75,142
1362850000,404240000,31260000,0,701650000,2.5e+09,40,33,81,154
985140000,39260000,1030000,0,1474570000,2.5e+09,34,25,67,126
1493380000,29810000,7670000,0,969140000,2.5e+09,31,28,66,125
547770000,93740000,1070000,0,1857420000,2.5e+09,31,30,62,123
956190000,115510000,7310000,0,1420990000,2.5e+09,31,27,63,121
579040000,488130000,19080000,0,1413750000,2.5e+09,37,32,80,149
587990000,146840000,5650000,420000,1759100000,2.5e+09,31,27,71,129
53310000,14980000,0,0,2377420000,2445710000,16,15,41,72
443900000,49290000,0,0,2006810000,2.5e+09,24,23,65,112
722750000,184070000,10140000,0,1583040000,2.5e+09,34,28,69,131
1052420000,233750000,10680000,0,1203150000,2.5e+09,30,26,65,121
242230000,53230000,0,0,2204540000,2.5e+09,28,27,58,113
338740000,430840000,34990000,114850000,1579310000,2498730000,29,15,43,87
558710000,338280000,25200000,53330000,1358280000,2333800000,23,14,36,73
264100000,252860000,12800000,32800000,1673200000,2235760000,29,22,52,103
1064400000,429150000,26720000,2.25e+08,754730000,2.5e+09,29,23,49,101
794990000,809590000,42540000,17510000,835370000,2.5e+09,28,13,49,90
833900000,1211450000,55220000,50870000,348560000,2.5e+09,32,25,54,111
1350550000,836960000,78890000,65400000,168200000,2.5e+09,31,23,57,111
191690000,1072380000,43070000,25520000,1167340000,2.5e+09,28,22,45,95
451330000,1775850000,99800000,33700000,139320000,2.5e+09,32,26,54,112
68380000,733310000,371070000,9480000,1276850000,2459090000,32,22,53,107
666930000,1424240000,115030000,15230000,278570000,2.5e+09,31,25,50,106
704870000,1613740000,49900000,20830000,110660000,2.5e+09,31,29,54,114
480060000,1582430000,111700000,35010000,290800000,2.5e+09,30,26,58,114
1221240000,879470000,34400000,152900000,211990000,2.5e+09,31,25,50,106
18720000,346510000,20830000,0,1914720000,2300780000,32,26,62,120
36890000,1217400000,81260000,0,1164450000,2.5e+09,32,23,73,128
344090000,1809060000,256460000,36310000,54080000,2.5e+09,37,38,80,155
6e+06,1147850000,222120000,1460000,1122570000,2.5e+09,28,21,55,104
73940000,767340000,74190000,1.5e+07,1484120000,2414590000,30,21,50,101
326580000,748190000,48010000,34060000,1343160000,2.5e+09,31,22,41,94
1122880000,994850000,54180000,104060000,224030000,2.5e+09,34,34,65,133
573730000,1505110000,183460000,60440000,177260000,2.5e+09,32,31,59,122
613740000,699040000,55610000,704440000,427170000,2.5e+09,29,31,60,120
990120000,980020000,78320000,214130000,237410000,2.5e+09,33,33,67,133
899910000,1175470000,63950000,206890000,153780000,2.5e+09,32,31,49,112
1185460000,792410000,51420000,264270000,206440000,2.5e+09,34,32,64,130
318660000,1831790000,75440000,99460000,174650000,2.5e+09,28,27,50,105
1126370000,693520000,35980000,366780000,277350000,2.5e+09,30,32,62,124
45470000,733090000,98310000,1970000,1402900000,2281740000,28,21,49,98
642320000,1508500000,62780000,90040000,196360000,2.5e+09,32,33,59,124
32410000,2080950000,226990000,9940000,149710000,2.5e+09,33,31,73,137
269080000,1.125e+09,177500000,10530000,917890000,2.5e+09,37,35,87,159
163320000,294860000,35750000,5160000,1665400000,2164490000,30,28,60,118
1384340000,61130000,39740000,554310000,460480000,2.5e+09,27,23,59,109
1326560000,528250000,71180000,171290000,402720000,2.5e+09,34,31,70,135
1556350000,133570000,64460000,464090000,281530000,2.5e+09,29,29,63,121
1320670000,561140000,111630000,116050000,390510000,2.5e+09,36,34,69,139
1435280000,27850000,93900000,589640000,353330000,2.5e+09,32,29,70,131
790910000,18640000,37520000,893980000,758950000,2.5e+09,33,26,61,120
1440540000,15140000,97950000,460920000,485450000,2.5e+09,35,26,71,132
1029010000,7900000,59820000,765940000,637330000,2.5e+09,29,21,52,102
47090000,221370000,30710000,11240000,1863440000,2173850000,27,14,32,73
742610000,1296450000,75640000,141040000,244260000,2.5e+09,32,28,60,120
782390000,1180500000,275950000,61430000,199730000,2.5e+09,29,23,54,106
475190000,1434510000,78970000,168860000,342470000,2.5e+09,33,36,71,140
1189600000,525870000,20720000,407400000,356410000,2.5e+09,35,35,72,142
52710000,720500000,36260000,9830000,1464020000,2283320000,29,19,44,92
444480000,1770640000,24130000,56590000,204160000,2.5e+09,30,27,51,108
11790000,182630000,23750000,0,1332290000,1550460000,21,14,33,68
57420000,899590000,79170000,0,1271210000,2307390000,28,28,47,103
388400000,131720000,28800000,177790000,1773290000,2.5e+09,33,27,61,121
1580920000,483830000,75710000,171240000,188300000,2.5e+09,37,35,83,155
1369790000,540300000,41880000,162420000,385610000,2.5e+09,34,33,80,147
1647020000,496550000,61560000,236040000,58830000,2.5e+09,39,35,91,165
1817530000,71630000,75580000,96460000,438800000,2.5e+09,37,30,77,144
1484560000,336610000,141510000,351700000,185620000,2.5e+09,35,30,72,137
1661640000,321400000,37740000,138140000,341080000,2.5e+09,39,29,72,140
1396820000,644850000,81860000,314180000,62290000,2.5e+09,37,29,71,137
1599750000,477510000,92590000,169770000,160380000,2.5e+09,34,32,72,138
1467270000,20930000,48490000,300890000,662420000,2.5e+09,35,27,64,126
1342730000,58450000,26240000,729260000,343320000,2.5e+09,27,26,58,111
1828320000,6700000,34730000,296690000,333560000,2.5e+09,34,29,60,123
1582320000,216890000,66410000,472980000,161400000,2.5e+09,34,28,58,120
961620000,1077960000,43970000,201220000,215230000,2.5e+09,32,30,64,126
1135760000,877040000,33800000,208700000,244700000,2.5e+09,33,29,59,121
224830000,2106940000,41260000,65640000,61330000,2.5e+09,30,22,47,99
782150000,1364950000,37470000,165450000,149980000,2.5e+09,32,32,63,127
7720000,2010190000,44560000,36580000,400950000,2.5e+09,22,17,46,85
403880000,1936990000,33300000,64970000,60860000,2.5e+09,31,24,55,110
51410000,1741410000,27170000,86980000,593030000,2.5e+09,32,26,61,119
426820000,582430000,29660000,226070000,1235020000,2.5e+09,39,34,70,143
1.21e+08,458690000,122790000,198440000,1599080000,2.5e+09,31,28,59,118
4.33e+08,551640000,24110000,670300000,820950000,2.5e+09,30,27,61,118
1663290000,2.83e+08,10420000,224710000,318580000,2.5e+09,28,24,53,105
1378660000,910360000,39410000,110220000,61350000,2.5e+09,33,28,68,129
1462770000,623880000,38960000,109190000,265200000,2.5e+09,31,26,76,133
715600000,1149360000,266300000,201790000,166950000,2.5e+09,34,30,77,141
1019260000,949540000,19470000,190080000,321650000,2.5e+09,27,21,58,106
1384560000,661670000,109170000,279190000,65410000,2.5e+09,33,25,73,131
1260210000,908490000,71560000,239940000,19800000,2.5e+09,35,32,69,136
795630000,1507300000,103860000,69560000,23650000,2.5e+09,35,33,80,148
835040000,1272270000,58080000,192930000,141680000,2.5e+09,38,35,84,157
1906750000,42220000,59600000,232370000,259060000,2.5e+09,34,26,64,124
1500950000,373980000,226090000,380630000,18350000,2.5e+09,30,25,66,121
1529900000,520150000,132710000,244960000,72280000,2.5e+09,33,27,62,122
997770000,1292530000,135020000,69100000,5580000,2.5e+09,35,27,77,139
386210000,1733650000,25860000,50320000,303960000,2.5e+09,29,22,49,100
67380000,810720000,84170000,40150000,1482220000,2484640000,26,21,41,88
152490000,1969450000,50330000,298280000,29450000,2.5e+09,25,18,38,81
189410000,1900740000,83310000,35920000,290620000,2.5e+09,22,16,32,70
445680000,289630000,25740000,57320000,1681630000,2.5e+09,24,20,42,86
634780000,448820000,80410000,289910000,1046080000,2.5e+09,31,27,60,118
1079590000,1087590000,24120000,202500000,106200000,2.5e+09,24,20,61,105
1629980000,328970000,6990000,425790000,108270000,2.5e+09,23,18,39,80
893110000,1476290000,36760000,31870000,61970000,2.5e+09,26,27,72,125
691840000,1386110000,58820000,120880000,242350000,2.5e+09,26,24,61,111
7.98e+08,1039400000,71680000,211720000,379200000,2.5e+09,25,29,74,128
891540000,1242970000,60520000,149730000,155240000,2.5e+09,35,33,80,148
1152230000,919150000,41310000,161100000,226210000,2.5e+09,31,27,78,136
1026270000,1097670000,107340000,177010000,91710000,2.5e+09,33,31,76,140
641340000,1366070000,118780000,174700000,199110000,2.5e+09,30,25,69,124
620770000,1009200000,125320000,323200000,421510000,2.5e+09,33,31,87,151
889520000,1256440000,76780000,114580000,162680000,2.5e+09,32,29,70,131
630480000,1345450000,145090000,131410000,247570000,2.5e+09,39,33,91,163
735330000,1485160000,130030000,96380000,53100000,2.5e+09,29,25,71,125
307740000,1714920000,162720000,197450000,117170000,2.5e+09,32,28,68,128
639070000,1398610000,116460000,224670000,121190000,2.5e+09,27,25,62,114
560870000,1416850000,206130000,164120000,152030000,2.5e+09,38,33,84,155
327360000,600320000,40070000,150720000,1381530000,2.5e+09,28,25,66,119
955290000,320260000,29090000,328540000,866820000,2.5e+09,28,26,61,115
805290000,1455850000,1.7e+07,159570000,62290000,2.5e+09,27,24,58,109
1476570000,564260000,19710000,344800000,94660000,2.5e+09,25,17,43,85
668050000,1506210000,43210000,124720000,157810000,2.5e+09,30,24,61,115
1101400000,1090920000,53960000,70790000,182930000,2.5e+09,31,27,72,130
429420000,1624920000,107260000,68770000,269630000,2.5e+09,35,29,74,138
770370000,1301200000,146210000,152170000,130050000,2.5e+09,30,30,69,129
400910000,1755300000,161380000,76410000,1.06e+08,2.5e+09,36,32,84,152
740630000,962160000,150550000,328210000,318450000,2.5e+09,36,30,82,148
287830000,4.51e+08,75510000,166490000,1519170000,2.5e+09,37,31,82,150
238330000,1041340000,67400000,245960000,906970000,2.5e+09,41,33,94,168
78040000,1141280000,241150000,68090000,971440000,2.5e+09,39,30,80,149
2500000,347710000,41620000,15630000,1695820000,2103280000,35,28,76,139
462810000,1839250000,67200000,118740000,1.2e+07,2.5e+09,33,23,72,128
630830000,1011090000,116300000,602030000,139750000,2.5e+09,36,27,79,142
551650000,1623700000,99990000,184220000,40440000,2.5e+09,33,26,77,136
802430000,709150000,128100000,792530000,67790000,2.5e+09,30,29,73,132
1096310000,1015470000,71040000,281310000,35870000,2.5e+09,41,27,88,156
647160000,1515040000,107890000,198530000,31380000,2.5e+09,37,31,81,149
820950000,1173220000,73590000,409300000,22940000,2.5e+09,41,32,89,162
1529540000,216080000,62570000,582770000,109040000,2.5e+09,40,32,84,156
1233960000,607760000,147350000,3.62e+08,148930000,2.5e+09,40,29,83,152
1105570000,870890000,82920000,3.83e+08,57620000,2.5e+09,39,29,88,156
684710000,972890000,94040000,397410000,350950000,2.5e+09,41,32,84,157
917230000,1281200000,125200000,139850000,36520000,2.5e+09,39,30,87,156
421060000,1669120000,305900000,71110000,32810000,2.5e+09,34,27,81,142
270660000,1960760000,1.67e+08,46030000,55550000,2.5e+09,35,28,76,139
685850000,1216160000,240860000,222830000,134300000,2.5e+09,35,28,75,138
1048590000,1083770000,104110000,203830000,59700000,2.5e+09,36,30,78,144
960260000,1035590000,138960000,247520000,117670000,2.5e+09,37,30,75,142
798090000,1330970000,106470000,206390000,58080000,2.5e+09,39,26,72,137
1135490000,833530000,86490000,323580000,120910000,2.5e+09,37,32,83,152
577550000,802270000,762100000,233010000,125070000,2.5e+09,39,32,85,156
367360000,1532350000,133540000,405570000,61180000,2.5e+09,37,33,77,147
623710000,1281760000,68480000,245190000,280860000,2.5e+09,40,32,88,160
323810000,1627330000,97510000,395660000,55690000,2.5e+09,39,31,84,154
780930000,1225410000,84770000,242330000,166560000,2.5e+09,37,28,81,146
89860000,122690000,21440000,52460000,2022750000,2309200000,37,29,79,145
424040000,838960000,46470000,105050000,1085480000,2.5e+09,41,32,88,161
17340000,402440000,26730000,23590000,1371580000,1841680000,32,28,65,125
984990000,847490000,103080000,496460000,67980000,2.5e+09,31,20,72,123
579430000,1431470000,226210000,229990000,32900000,2.5e+09,36,21,77,134
1233250000,908710000,61390000,282450000,14200000,2.5e+09,38,23,73,134
877040000,1055840000,138470000,387220000,41430000,2.5e+09,34,22,77,133
748530000,1358980000,82550000,232340000,77600000,2.5e+09,41,29,89,159
1159600000,675490000,39410000,492360000,133140000,2.5e+09,43,35,92,170
721890000,1501070000,90720000,159340000,26980000,2.5e+09,40,27,89,156
952120000,1071670000,121300000,226230000,128680000,2.5e+09,45,34,100,179
401740000,1808710000,177170000,39070000,73310000,2.5e+09,36,32,86,154
1131070000,1028600000,151340000,138510000,50480000,2.5e+09,38,29,81,148
514880000,1659470000,232530000,33570000,59550000,2.5e+09,37,31,79,147
686550000,1364310000,326320000,80950000,41870000,2.5e+09,39,29,84,152
759730000,1253020000,300100000,98150000,8.9e+07,2.5e+09,38,28,84,150
975520000,826410000,202890000,337310000,157870000,2.5e+09,37,33,86,156
713860000,1272320000,151230000,142520000,220070000,2.5e+09,40,31,89,160
1044210000,792180000,168560000,392920000,102130000,2.5e+09,38,32,85,155
1245900000,768780000,136400000,228350000,120570000,2.5e+09,39,31,85,155
844830000,1011590000,166410000,201210000,275960000,2.5e+09,37,29,74,140
1417930000,728060000,101230000,144870000,107910000,2.5e+09,33,31,80,144
1166060000,742350000,156950000,177700000,256940000,2.5e+09,38,32,83,153
954360000,1083980000,102410000,236810000,122440000,2.5e+09,38,33,89,160
902660000,1085680000,349530000,102040000,60090000,2.5e+09,38,31,84,153
707290000,1409890000,57360000,236190000,89270000,2.5e+09,40,36,95,171
771820000,1320860000,70490000,299910000,36920000,2.5e+09,42,36,94,172
396810000,798920000,77110000,389590000,837570000,2.5e+09,34,32,82,148
470720000,1504650000,78370000,380160000,66100000,2.5e+09,38,35,88,161
481450000,414930000,32600000,237280000,1333740000,2.5e+09,42,40,92,174
940360000,802930000,146790000,382650000,227270000,2.5e+09,42,37,94,173
26910000,48260000,18610000,24240000,1262500000,1380520000,32,28,75,135
303340000,547180000,50950000,113160000,1273390000,2288020000,38,37,84,159
1175990000,1144690000,74990000,86610000,17720000,2.5e+09,35,26,76,137
1219550000,875910000,96130000,287930000,20480000,2.5e+09,32,25,75,132
508650000,1785710000,173250000,1190000,31200000,2.5e+09,36,25,72,133
1347340000,594400000,331510000,212150000,14600000,2.5e+09,34,26,78,138
744350000,1508520000,91670000,137380000,18080000,2.5e+09,37,28,80,145
846560000,1434700000,77620000,106950000,34170000,2.5e+09,39,29,89,157
778450000,1453120000,102580000,134790000,31060000,2.5e+09,36,28,78,142
645430000,1686730000,114130000,9540000,44170000,2.5e+09,40,31,83,154
552820000,1673560000,141960000,108290000,23370000,2.5e+09,39,31,87,157
625080000,1659810000,133670000,42290000,39150000,2.5e+09,38,32,89,159
736290000,1346200000,185260000,191540000,40710000,2.5e+09,42,35,92,169
649810000,1464810000,164710000,174420000,46250000,2.5e+09,39,33,89,161
1085010000,1115300000,100370000,96660000,102660000,2.5e+09,36,31,81,148
905390000,842290000,144710000,305430000,302180000,2.5e+09,41,33,82,156
606260000,1598190000,137560000,111190000,46800000,2.5e+09,36,32,88,156
913200000,1129700000,135220000,252830000,69050000,2.5e+09,36,36,83,155
1393090000,820680000,70240000,1.51e+08,64990000,2.5e+09,34,32,82,148
1151740000,1010470000,94580000,156370000,86840000,2.5e+09,36,33,82,151
902510000,1176980000,63640000,286660000,70210000,2.5e+09,38,35,86,159
846610000,1254360000,93120000,197530000,108380000,2.5e+09,38,36,85,159
945420000,1242350000,34090000,212300000,65840000,2.5e+09,39,35,86,160
1232260000,850810000,61900000,287940000,67090000,2.5e+09,36,34,86,156
1491740000,638410000,22700000,217200000,129950000,2.5e+09,40,35,87,162
1191390000,1104440000,27410000,108040000,68720000,2.5e+09,37,33,85,155
748540000,1274120000,31660000,340170000,105510000,2.5e+09,35,31,77,143
711220000,1414790000,42450000,247920000,83620000,2.5e+09,37,33,87,157
1061200000,1163840000,39700000,204630000,30630000,2.5e+09,32,31,75,138
1221180000,927480000,38390000,131140000,181810000,2.5e+09,33,31,79,143
1036530000,1126700000,53910000,199650000,83210000,2.5e+09,37,32,84,153
447120000,467760000,16540000,166480000,1317640000,2415540000,37,35,82,154
1116890000,1135980000,38400000,139480000,69250000,2.5e+09,36,32,80,148
440050000,1820730000,173930000,34710000,30580000,2.5e+09,35,29,80,144
358990000,1586850000,331690000,37540000,184930000,2.5e+09,39,33,89,161
920690000,1328590000,140460000,30530000,79730000,2.5e+09,43,35,94,172
282480000,1784560000,263270000,22740000,146950000,2.5e+09,41,35,91,167
1047340000,1145170000,186330000,47660000,73500000,2.5e+09,37,28,80,145
335840000,1891350000,195580000,12320000,64910000,2.5e+09,45,36,95,176
604300000,1546570000,240410000,50210000,58510000,2.5e+09,40,35,91,166
788690000,1370670000,172920000,139530000,28190000,2.5e+09,42,39,93,174
987820000,1037720000,69920000,273120000,131420000,2.5e+09,40,33,79,152
901640000,1197400000,152310000,202350000,46300000,2.5e+09,41,30,81,152
609910000,1508790000,147880000,155090000,78330000,2.5e+09,40,32,82,154
835290000,974730000,108030000,465660000,116290000,2.5e+09,42,39,89,170
489270000,1579190000,261770000,124760000,45010000,2.5e+09,40,35,85,160
397580000,1915600000,130830000,32810000,23180000,2.5e+09,35,28,74,137
736620000,1396260000,116710000,218110000,32300000,2.5e+09,37,37,86,160
671700000,1501820000,130550000,127640000,68290000,2.5e+09,38,35,84,157
473430000,1678280000,92880000,216220000,39190000,2.5e+09,40,37,92,169
559710000,1607430000,99510000,191900000,41450000,2.5e+09,39,34,85,158
434450000,1771360000,88620000,189430000,16140000,2.5e+09,38,37,85,160
722570000,1387060000,112720000,212880000,64770000,2.5e+09,39,34,90,163
810550000,1250830000,57430000,344070000,37120000,2.5e+09,38,36,87,161
684970000,1426680000,222430000,112440000,53480000,2.5e+09,37,33,84,154
498470000,1552870000,84390000,294530000,69740000,2.5e+09,35,36,82,153
431960000,1870130000,65420000,65920000,66570000,2.5e+09,32,30,77,139
1347760000,891710000,25850000,128340000,106340000,2.5e+09,34,29,78,141
1121690000,1088930000,31740000,153050000,104590000,2.5e+09,37,31,82,150
1473270000,712420000,26630000,169500000,118180000,2.5e+09,37,32,88,157
653100000,1627380000,37190000,117800000,64530000,2.5e+09,40,36,85,161
506120000,1707090000,223070000,10360000,53360000,2.5e+09,33,31,79,143
63070000,2200120000,189240000,7330000,40240000,2.5e+09,34,31,79,144
155710000,508210000,168170000,9380000,1647820000,2489290000,35,28,67,130
939720000,672550000,99320000,48650000,739760000,2.5e+09,39,34,80,153
810540000,1058520000,145860000,75850000,409230000,2.5e+09,39,32,88,159
789060000,240560000,202430000,28040000,1239910000,2.5e+09,38,30,84,152
69880000,224830000,33070000,26410000,1839350000,2193540000,40,33,79,152
1942520000,275580000,64950000,16790000,200160000,2.5e+09,35,29,75,139
1903880000,394760000,28920000,9930000,162510000,2.5e+09,37,30,75,142
525120000,1269920000,40100000,12750000,652110000,2.5e+09,38,31,77,146
1669220000,560640000,57080000,29200000,183860000,2.5e+09,39,29,70,138
1654110000,323370000,25640000,7820000,489060000,2.5e+09,33,28,74,135
578970000,216530000,13930000,1840000,1688730000,2.5e+09,36,28,69,133
2048220000,7.4e+07,9040000,0,368740000,2.5e+09,30,26,65,121
1823980000,201250000,24110000,2680000,447980000,2.5e+09,34,27,70,131
1599500000,12450000,14240000,540000,873270000,2.5e+09,34,25,65,124
1756030000,20230000,3480000,0,720260000,2.5e+09,31,28,62,121
1157870000,15480000,8540000,690000,1317420000,2.5e+09,39,31,76,146
613260000,10970000,1320000,21070000,1853380000,2.5e+09,31,29,61,121
827840000,7620000,7530000,4.2e+07,1615010000,2.5e+09,33,29,66,128
1936070000,233170000,33420000,20260000,277080000,2.5e+09,37,31,75,143
1563460000,598690000,89480000,114040000,134330000,2.5e+09,40,35,82,157
1815990000,232420000,19710000,24460000,407420000,2.5e+09,38,31,74,143
1233130000,380890000,76150000,67360000,742470000,2.5e+09,40,35,94,169
1974630000,209110000,49120000,10010000,257130000,2.5e+09,36,32,74,142
1711250000,241290000,45710000,16190000,485560000,2.5e+09,39,31,78,148
1812470000,355850000,46920000,35120000,249640000,2.5e+09,35,29,68,132
1848180000,238120000,52010000,16110000,345580000,2.5e+09,36,31,72,139
1062240000,1111890000,61110000,90380000,174380000,2.5e+09,37,33,79,149
1498710000,653540000,49130000,62020000,236600000,2.5e+09,38,30,70,138
703010000,518140000,38440000,19620000,1220790000,2.5e+09,37,33,82,152
1258270000,365710000,52250000,41750000,782020000,2.5e+09,35,29,70,134
673120000,290640000,75710000,6500000,1454030000,2.5e+09,36,31,74,141
425450000,230580000,18300000,3280000,1822390000,2.5e+09,33,30,75,138
1670410000,317630000,5.8e+07,8460000,445500000,2.5e+09,35,30,77,142
1515300000,280200000,22380000,8170000,673950000,2.5e+09,36,32,76,144
1836590000,60790000,13880000,8e+05,587940000,2.5e+09,33,26,63,122
1791100000,192840000,17110000,5510000,493440000,2.5e+09,32,30,70,132
1839410000,13260000,8020000,990000,638320000,2.5e+09,32,25,67,124
1799030000,39780000,27310000,1810000,632070000,2.5e+09,34,25,65,124
1658500000,32800000,20240000,3590000,784870000,2.5e+09,32,27,65,124
1402390000,33120000,16210000,2880000,1045400000,2.5e+09,31,26,65,122
1691520000,64370000,40490000,8330000,695290000,2.5e+09,35,31,74,140
1197130000,4840000,4270000,1170000,1292590000,2.5e+09,32,26,65,123
1390800000,1700000,3790000,310000,1103400000,2.5e+09,30,26,64,120
1466380000,23720000,8960000,1930000,999010000,2.5e+09,32,26,65,123
1511140000,650000,8e+05,0,987410000,2.5e+09,30,27,63,120
1051080000,2090000,810000,30940000,1415080000,2.5e+09,33,27,66,126
1480860000,10690000,8570000,2550000,997330000,2.5e+09,33,28,67,128
1464460000,161120000,7300000,740000,866380000,2.5e+09,33,28,69,130
1414800000,22910000,7300000,2360000,1052630000,2.5e+09,32,25,64,121
1510190000,57460000,11360000,10200000,910790000,2.5e+09,32,31,73,136
2087810000,139460000,24110000,12460000,236160000,2.5e+09,37,30,73,140
738990000,174080000,44400000,31980000,1510480000,2499930000,40,34,88,162
183480000,396900000,50310000,154120000,1713760000,2498570000,41,37,92,170
1904130000,262440000,37400000,23180000,272850000,2.5e+09,35,28,68,131
2094550000,105140000,18030000,17500000,264780000,2.5e+09,35,29,72,136
1813840000,180980000,24500000,17260000,463420000,2.5e+09,36,32,86,154
1504440000,194180000,36490000,12580000,752310000,2.5e+09,37,33,84,154
1000500000,1078880000,98400000,53320000,268900000,2.5e+09,38,30,76,144
1764510000,207740000,15870000,41250000,470630000,2.5e+09,34,30,69,133
908960000,479080000,14930000,21290000,1075740000,2.5e+09,39,33,87,159
999790000,890860000,84020000,18720000,506610000,2.5e+09,40,30,78,148
1785880000,340310000,33770000,2.3e+07,317040000,2.5e+09,33,32,72,137
1134820000,761400000,80570000,21760000,501450000,2.5e+09,35,30,74,139
1514610000,493190000,42670000,18560000,430970000,2.5e+09,35,30,74,139
1720050000,198690000,53390000,2100000,525770000,2.5e+09,36,31,71,138
1759840000,207740000,23290000,2930000,506200000,2.5e+09,38,31,70,139
1627540000,422160000,33940000,8890000,407470000,2.5e+09,37,30,72,139
1301830000,733580000,99120000,17820000,347650000,2.5e+09,40,34,77,151
1795700000,43210000,9600000,4910000,646580000,2.5e+09,33,28,69,130
1820550000,155420000,20260000,1940000,501830000,2.5e+09,36,32,68,136
1865070000,154500000,39700000,4770000,435960000,2.5e+09,34,28,67,129
1772620000,36530000,5590000,590000,684670000,2.5e+09,35,28,70,133
1788690000,37080000,8740000,1100000,664390000,2.5e+09,39,31,72,142
1621970000,95290000,17230000,3110000,762400000,2.5e+09,36,29,73,138
1803090000,212870000,25530000,2180000,456330000,2.5e+09,37,31,73,141
1704720000,25060000,4350000,820000,765050000,2.5e+09,32,27,64,123
1533930000,31010000,5860000,1950000,927250000,2.5e+09,34,28,68,130
1655810000,51550000,6530000,3710000,782400000,2.5e+09,32,27,68,127
1736580000,83900000,8900000,1010000,669610000,2.5e+09,34,27,68,129
1353770000,39850000,7120000,16670000,1082590000,2.5e+09,31,28,65,124
1566190000,45420000,3050000,4470000,880870000,2.5e+09,32,27,67,126
1597610000,36130000,5400000,4370000,856490000,2.5e+09,34,27,70,131
1621320000,64840000,3590000,3140000,807110000,2.5e+09,36,28,71,135
104540000,80390000,4660000,32040000,2263010000,2484640000,37,34,78,149
1171320000,510830000,48690000,24260000,744900000,2.5e+09,34,31,74,139
1138680000,583190000,55730000,14060000,708340000,2.5e+09,36,32,84,152
932960000,314560000,611670000,21830000,618980000,2.5e+09,39,35,77,151
364040000,114280000,21400000,6990000,1922770000,2429480000,35,33,83,151
1466160000,537450000,25780000,16300000,454310000,2.5e+09,40,33,77,150
967870000,1086690000,99250000,44110000,302080000,2.5e+09,39,31,76,146
452690000,14490000,32120000,1340000,1727720000,2228360000,36,36,80,152
1150010000,104200000,73650000,12720000,1159420000,2.5e+09,40,37,84,161
845850000,89510000,10660000,320000,1553660000,2.5e+09,35,31,77,143
473020000,43130000,22320000,5840000,1916220000,2460530000,35,33,78,146
1739860000,94600000,30620000,1200000,633720000,2.5e+09,37,30,74,141
1234750000,180650000,87910000,5580000,991110000,2.5e+09,44,35,87,166
1524840000,18740000,1870000,3510000,951040000,2.5e+09,35,28,68,131
1784670000,105810000,14900000,2450000,592170000,2.5e+09,34,28,70,132
773040000,105850000,2520000,0,1618590000,2.5e+09,28,21,54,103
769470000,80910000,1140000,0,1648480000,2.5e+09,28,24,63,115
315160000,120480000,6860000,0,2057500000,2.5e+09,26,26,55,107
648070000,70510000,1280000,0,1780140000,2.5e+09,29,23,50,102
171640000,112140000,6450000,640000,2209130000,2.5e+09,31,22,58,111
764820000,22700000,1470000,2900000,1708110000,2.5e+09,31,28,58,117
511310000,13540000,310000,6240000,1968600000,2.5e+09,32,26,61,119
1052880000,5260000,1600000,58930000,1381330000,2.5e+09,33,27,59,119
1220820000,4500000,50000,6120000,1268510000,2.5e+09,33,28,63,124
787050000,31470000,890000,0,1680590000,2.5e+09,24,18,38,80
821970000,21260000,1410000,26450000,1628910000,2.5e+09,29,25,52,106
499160000,6270000,1340000,59200000,1934030000,2.5e+09,30,26,57,113
317080000,46520000,0,0,2136400000,2.5e+09,29,19,52,100
784940000,143330000,11880000,0,1559850000,2.5e+09,35,28,68,131
643610000,29570000,16630000,0,1810190000,2.5e+09,38,31,73,142
171270000,32040000,1850000,0,2116380000,2321540000,27,26,62,115
268340000,56470000,20420000,460000,2154310000,2.5e+09,28,26,65,119
562980000,54830000,1990000,0,1880200000,2.5e+09,29,22,61,112
1356410000,8100000,560000,6750000,1128180000,2.5e+09,35,28,66,129
1413540000,30410000,1390000,8340000,1046320000,2.5e+09,30,25,64,119
1274440000,23140000,4200000,9340000,1188880000,2.5e+09,35,27,67,129
1429480000,24440000,3730000,7080000,1035270000,2.5e+09,34,28,69,131
1258690000,3950000,4610000,23600000,1209150000,2.5e+09,34,30,64,128
1426130000,3350000,2470000,20980000,1047070000,2.5e+09,34,28,65,127
1690200000,6840000,910000,1130000,800920000,2.5e+09,37,28,66,131
1399610000,4280000,2340000,0,1093770000,2.5e+09,35,26,69,130
148460000,1660000,0,44620000,2305260000,2.5e+09,28,24,50,102
354140000,470000,0,148960000,1996430000,2.5e+09,29,28,56,113
1105960000,0,0,18660000,1375380000,2.5e+09,32,28,61,121
611390000,28410000,4800000,18480000,1836920000,2.5e+09,33,30,66,129
483610000,30130000,2650000,0,1983610000,2.5e+09,22,17,50,89
675420000,60090000,960000,0,1763530000,2.5e+09,26,23,57,106
622240000,48290000,13810000,5820000,1809840000,2.5e+09,27,27,53,107
453710000,37060000,1620000,0,2007610000,2.5e+09,22,23,59,104
762160000,127330000,15400000,0,1595110000,2.5e+09,27,26,55,108
1234010000,16100000,0,1490000,1248400000,2.5e+09,34,27,65,126
1414330000,19920000,4290000,850000,1060610000,2.5e+09,35,28,68,131
1359360000,1.9e+07,8330000,2390000,1110920000,2.5e+09,33,26,67,126
259890000,0,620000,67930000,2171560000,2.5e+09,25,23,53,101
982890000,3e+05,0,25850000,1490960000,2.5e+09,32,26,64,122
795250000,71440000,7240000,27060000,1599010000,2.5e+09,18,17,45,80
34950000,283470000,6790000,68270000,2106520000,2.5e+09,23,16,35,74
100620000,493410000,30310000,196300000,1679360000,2.5e+09,35,27,65,127
422240000,724990000,45620000,340550000,966600000,2.5e+09,34,33,71,138
39840000,691870000,37510000,141610000,1589170000,2.5e+09,35,32,79,146
1196180000,286930000,9530000,250500000,756860000,2.5e+09,33,36,70,139
56600000,570090000,6030000,14170000,1853110000,2.5e+09,22,16,45,83
11900000,922240000,27500000,0,1538360000,2.5e+09,18,17,31,66
377580000,1116990000,7580000,152720000,845130000,2.5e+09,29,22,46,97
298880000,1203720000,23020000,170350000,804030000,2.5e+09,23,17,42,82
181920000,937670000,38540000,162050000,1179820000,2.5e+09,36,29,64,129
30660000,595930000,12060000,25380000,1835970000,2.5e+09,29,20,57,106
883700000,359880000,8690000,44290000,1203440000,2.5e+09,34,28,54,116
229470000,769150000,41080000,83630000,1376670000,2.5e+09,31,22,52,105
376250000,558220000,8230000,137390000,1419910000,2.5e+09,33,26,72,131
149010000,1422780000,85480000,429570000,413160000,2.5e+09,34,32,65,131
408950000,905840000,11550000,389900000,783760000,2.5e+09,32,28,61,121
163610000,616830000,8930000,197970000,1512660000,2.5e+09,31,27,52,110
0,51800000,260000,72420000,1932240000,2056720000,18,14,21,53
44010000,457430000,6030000,87560000,1904970000,2.5e+09,22,19,35,76
366990000,732820000,14510000,210270000,1175410000,2.5e+09,33,25,51,109
561910000,683870000,1.2e+07,380290000,861930000,2.5e+09,32,23,51,106
138940000,812830000,39490000,79800000,1428940000,2.5e+09,26,18,34,78
77020000,250160000,7440000,175020000,1990360000,2.5e+09,26,16,37,79
558970000,564710000,18100000,238410000,1119810000,2.5e+09,36,31,70,137
289440000,408200000,10710000,96660000,1694990000,2.5e+09,29,21,42,92
107520000,1027640000,27280000,38710000,1298850000,2.5e+09,35,27,45,107
279290000,538380000,24020000,118540000,1539770000,2.5e+09,25,19,33,77
6150000,1977790000,74390000,181170000,260500000,2.5e+09,23,28,45,96
141420000,1224570000,41220000,90040000,1002750000,2.5e+09,32,29,66,127
366770000,464700000,47970000,54550000,1516770000,2450760000,29,25,49,103
327970000,513490000,32300000,53930000,1572310000,2.5e+09,26,22,34,82
672140000,353890000,7650000,381610000,1084710000,2.5e+09,25,17,46,88
268580000,284550000,30910000,70400000,1845560000,2.5e+09,33,32,64,129
700540000,1495230000,70870000,173370000,59990000,2.5e+09,25,25,69,119
447160000,1736750000,78950000,91040000,146100000,2.5e+09,35,34,84,153
673110000,1516710000,78630000,80100000,151450000,2.5e+09,28,30,59,117
1198400000,502580000,5360000,303310000,490350000,2.5e+09,31,27,66,124
333800000,1914430000,143990000,5630000,102150000,2.5e+09,30,25,69,124
363420000,1666190000,85760000,78440000,306190000,2.5e+09,33,28,81,142
340460000,1805110000,132360000,20290000,201780000,2.5e+09,24,22,52,98
7500000,2273400000,122380000,54990000,41730000,2.5e+09,31,29,69,129
260860000,1939780000,114450000,49450000,135460000,2.5e+09,32,28,72,132
286440000,1823370000,119760000,154230000,116200000,2.5e+09,32,30,75,137
501870000,1672630000,105610000,79940000,139950000,2.5e+09,30,31,71,132
284460000,1311750000,79640000,523380000,300770000,2.5e+09,33,30,74,137
492600000,1521050000,90440000,216410000,179500000,2.5e+09,31,28,71,130
813450000,1112470000,278410000,138860000,156810000,2.5e+09,35,36,85,156
169420000,1769570000,243920000,155940000,161150000,2.5e+09,35,32,84,151
498510000,1229280000,547100000,101390000,123720000,2.5e+09,32,29,69,130
455620000,1344500000,157140000,389210000,153530000,2.5e+09,33,27,73,133
779960000,1555340000,62220000,70050000,32430000,2.5e+09,24,24,59,107
1214020000,772020000,33290000,81840000,398830000,2.5e+09,28,24,56,108
245090000,1919640000,180780000,25670000,128820000,2.5e+09,32,31,76,139
111300000,1878300000,277910000,57340000,175150000,2.5e+09,30,31,76,137
18280000,2031620000,108850000,232870000,108380000,2.5e+09,35,32,83,150
118610000,1845840000,169330000,154310000,211910000,2.5e+09,41,37,89,167
4420000,2205220000,132610000,103310000,54440000,2.5e+09,29,29,65,123
13350000,1943900000,122860000,276610000,143280000,2.5e+09,36,36,92,164
206050000,1753170000,98370000,327570000,114840000,2.5e+09,34,31,78,143
217600000,1715230000,167490000,268470000,131210000,2.5e+09,34,32,86,152
30660000,2200640000,93030000,151910000,23760000,2.5e+09,28,27,65,120
33740000,2123600000,117100000,176800000,48760000,2.5e+09,30,26,68,124
183020000,1898240000,139590000,194140000,85010000,2.5e+09,28,30,70,128
98670000,1627860000,120700000,449690000,203080000,2.5e+09,35,34,87,156
557150000,1067240000,24750000,285390000,565470000,2.5e+09,37,39,85,161
771510000,897340000,25910000,228640000,576600000,2.5e+09,40,41,99,180
904590000,523770000,12560000,455610000,603470000,2.5e+09,30,31,63,124
803310000,798660000,30820000,350200000,517010000,2.5e+09,37,40,96,173
680050000,1547450000,108170000,32820000,131510000,2.5e+09,24,23,54,101
448790000,1535330000,77590000,163800000,274490000,2.5e+09,37,34,88,159
1698430000,360480000,31410000,297380000,112300000,2.5e+09,27,26,61,114
1689470000,414450000,13860000,148940000,233280000,2.5e+09,26,23,60,109
222730000,1718550000,173830000,334670000,50220000,2.5e+09,23,27,65,115
146580000,1935010000,109370000,272330000,36710000,2.5e+09,23,24,54,101
871980000,979670000,148540000,400110000,99700000,2.5e+09,24,25,59,108
1213840000,703960000,89010000,381630000,111560000,2.5e+09,26,23,58,107
134290000,1664970000,152550000,443510000,104680000,2.5e+09,31,32,73,136
89840000,1905540000,181350000,225660000,97610000,2.5e+09,25,25,64,114
707150000,1166510000,139150000,413840000,73350000,2.5e+09,30,27,70,127
1181020000,802580000,119240000,284800000,112360000,2.5e+09,29,26,55,110
97510000,1451940000,126650000,661980000,161920000,2.5e+09,32,31,80,143
53070000,1811230000,87500000,490190000,58010000,2.5e+09,31,29,68,128
705900000,1323250000,141450000,186790000,142610000,2.5e+09,30,28,67,125
262660000,1634620000,197590000,319190000,85940000,2.5e+09,30,23,67,120
440070000,1335980000,62010000,13490000,648450000,2.5e+09,38,39,96,173
98020000,926560000,95720000,37040000,1342660000,2.5e+09,32,28,67,127
840710000,767920000,33030000,202540000,655800000,2.5e+09,34,32,77,143
355020000,1830740000,65060000,96410000,152770000,2.5e+09,32,33,68,133
902830000,980490000,54200000,179670000,382810000,2.5e+09,36,38,106,180
298380000,1402340000,93280000,227660000,478340000,2.5e+09,32,30,75,137
1185440000,596370000,29760000,388850000,299580000,2.5e+09,26,31,71,128
893120000,799700000,73730000,349780000,383670000,2.5e+09,41,39,90,170
1224340000,527870000,30670000,318370000,398750000,2.5e+09,40,41,91,172
996820000,577090000,71830000,369760000,484500000,2.5e+09,34,37,82,153
453890000,1171720000,3.37e+08,254160000,283230000,2.5e+09,38,37,93,168
177350000,1800300000,166670000,108490000,247190000,2.5e+09,28,29,67,124
1351580000,471380000,57360000,450260000,169420000,2.5e+09,24,21,50,95
438380000,1612300000,148640000,217320000,83360000,2.5e+09,20,22,47,89
1531850000,247660000,33270000,428180000,259040000,2.5e+09,24,20,49,93
1468860000,429790000,65630000,440010000,95710000,2.5e+09,29,24,58,111
1593940000,428560000,133460000,294700000,49340000,2.5e+09,24,22,44,90
1263160000,337930000,58920000,735020000,104970000,2.5e+09,25,23,61,109
229170000,1684820000,190430000,342230000,53350000,2.5e+09,25,24,63,112
865330000,657180000,31350000,280100000,666040000,2.5e+09,32,32,76,140
372390000,1343980000,47250000,26530000,709850000,2.5e+09,34,32,74,140
1589580000,433600000,35130000,149640000,292050000,2.5e+09,34,38,77,149
906210000,864230000,97940000,275430000,356190000,2.5e+09,35,34,79,148
1190460000,721460000,100570000,160550000,326960000,2.5e+09,35,36,72,143
248420000,1703620000,141780000,172980000,233200000,2.5e+09,28,25,66,119
369140000,1312980000,150390000,554660000,112830000,2.5e+09,30,32,78,140
1185710000,386310000,98400000,610300000,219280000,2.5e+09,32,22,69,123
702430000,1202440000,307140000,101990000,1.86e+08,2.5e+09,35,33,83,151
370240000,1466240000,401880000,124290000,137350000,2.5e+09,41,35,95,171
853930000,747360000,528480000,179110000,191120000,2.5e+09,37,37,89,163
746410000,1282040000,237930000,122650000,110970000,2.5e+09,40,38,93,171
533790000,1665820000,97980000,187600000,14810000,2.5e+09,35,36,79,150
1231500000,919040000,84050000,185940000,79470000,2.5e+09,38,34,82,154
688300000,1245920000,107600000,328250000,129930000,2.5e+09,35,34,84,153
791850000,1187790000,186260000,272130000,61970000,2.5e+09,37,36,83,156
516050000,1473500000,84120000,339380000,86950000,2.5e+09,35,34,83,152
425550000,1691230000,111720000,198790000,72710000,2.5e+09,36,36,88,160
226490000,1916270000,67760000,272090000,17390000,2.5e+09,40,37,84,161
521870000,1476130000,286660000,181340000,3.4e+07,2.5e+09,36,38,84,158
700690000,1409180000,128640000,149140000,112350000,2.5e+09,36,31,81,148
232120000,1996750000,36050000,86670000,148410000,2.5e+09,35,33,82,150
558640000,1757300000,28650000,90700000,64710000,2.5e+09,36,35,86,157
553380000,1685170000,53370000,89800000,118280000,2.5e+09,39,36,90,165
1045030000,1216210000,41320000,140570000,56870000,2.5e+09,37,35,83,155
779930000,1469030000,39990000,124560000,86490000,2.5e+09,35,34,86,155
350640000,1861170000,62120000,145250000,80820000,2.5e+09,35,34,86,155
440010000,1833380000,40810000,111370000,74430000,2.5e+09,37,34,89,160
425100000,358770000,69310000,91800000,1526350000,2471330000,37,38,82,157
727670000,1243680000,190190000,77160000,261300000,2.5e+09,36,35,83,154
74770000,918940000,5e+07,42780000,1413510000,2.5e+09,39,36,96,171
1319450000,802100000,119220000,147970000,111260000,2.5e+09,31,25,70,126
487390000,1808690000,129270000,26660000,47990000,2.5e+09,39,36,94,169
1226820000,765830000,83570000,286010000,137770000,2.5e+09,39,34,79,152
904780000,1228320000,110810000,189280000,66810000,2.5e+09,36,37,85,158
1530960000,568530000,133040000,184620000,82850000,2.5e+09,42,35,83,160
911100000,1104210000,123870000,272890000,87930000,2.5e+09,35,35,90,160
1414160000,705360000,128030000,168350000,84100000,2.5e+09,41,38,86,165
1289370000,557880000,84510000,363160000,205080000,2.5e+09,31,34,75,140
1594340000,338710000,88640000,303440000,174870000,2.5e+09,41,38,84,163
375680000,1910940000,110290000,93300000,9790000,2.5e+09,37,30,85,152
630020000,1528510000,200950000,104210000,36310000,2.5e+09,35,32,81,148
199950000,1818670000,114630000,322860000,43890000,2.5e+09,37,35,87,159
710840000,1517690000,107360000,103740000,60370000,2.5e+09,36,33,85,154
816940000,1231790000,97250000,273980000,80040000,2.5e+09,34,35,83,152
843080000,1196760000,66740000,336640000,56780000,2.5e+09,36,36,82,154
1079600000,955180000,96800000,225920000,142500000,2.5e+09,36,35,87,158
737710000,1296230000,150040000,262220000,53800000,2.5e+09,37,38,89,164
315240000,1850460000,97940000,207150000,29210000,2.5e+09,35,36,84,155
633180000,1549430000,155920000,125110000,36360000,2.5e+09,36,36,87,159
536630000,1415140000,335270000,157130000,55830000,2.5e+09,35,36,82,153
506880000,1707440000,65910000,188480000,31290000,2.5e+09,35,37,86,158
605200000,1359610000,29340000,464190000,41660000,2.5e+09,34,34,78,146
382180000,1891170000,49980000,103010000,73660000,2.5e+09,37,35,90,162
456110000,1679560000,42380000,293100000,28850000,2.5e+09,33,33,72,138
471290000,1679530000,81720000,216260000,51200000,2.5e+09,36,36,88,160
730090000,1506290000,33650000,91340000,138630000,2.5e+09,36,34,83,153
639830000,1566610000,33980000,170660000,88920000,2.5e+09,35,34,80,149
703650000,1507490000,65060000,125700000,98100000,2.5e+09,39,38,89,166
1267440000,825580000,29450000,240720000,136810000,2.5e+09,37,37,86,160
0,0,0,0,2.24e+08,2.24e+08,38,36,91,165
443040000,913790000,17370000,58360000,521890000,1954450000,37,34,87,158
0,0,0,0,0,0,41,44,93,178
313450000,922230000,13860000,63050000,16480000,1329070000,39,38,88,165
11570000,0,960000,0,918770000,931300000,29,30,60,119
1252450000,950200000,72480000,158390000,66480000,2.5e+09,41,35,87,163
1319740000,671990000,125990000,263140000,119140000,2.5e+09,33,33,75,141
1207450000,788870000,80990000,278450000,144240000,2.5e+09,39,35,89,163
867190000,1146370000,190890000,189490000,106060000,2.5e+09,31,29,72,132
1042100000,680430000,86880000,501490000,189100000,2.5e+09,33,34,69,136
1425360000,379670000,68830000,301080000,325060000,2.5e+09,36,29,70,135
1247410000,860550000,100290000,212090000,79660000,2.5e+09,39,32,86,157
1238780000,726180000,94270000,209290000,231480000,2.5e+09,39,30,82,151
631150000,1540310000,110260000,146840000,71440000,2.5e+09,36,34,86,156
565450000,1733140000,113310000,78250000,9850000,2.5e+09,37,32,79,148
626140000,1484930000,153980000,164990000,69960000,2.5e+09,38,35,83,156
520050000,1713140000,103360000,119650000,43800000,2.5e+09,37,34,85,156
407870000,1836090000,97490000,108470000,50080000,2.5e+09,38,38,88,164
851470000,1307490000,102100000,153930000,85010000,2.5e+09,42,38,93,173
703670000,1165590000,346650000,232470000,51620000,2.5e+09,37,35,88,160
791880000,1294010000,92950000,230410000,90750000,2.5e+09,38,37,88,163
534300000,1453720000,74230000,411360000,26390000,2.5e+09,36,37,80,153
537160000,1517830000,81140000,298130000,65740000,2.5e+09,37,38,86,161
787990000,1105310000,39990000,526770000,39940000,2.5e+09,35,37,84,156
771560000,1262770000,82640000,314150000,68880000,2.5e+09,37,37,88,162
547710000,1476760000,49080000,409840000,16610000,2.5e+09,37,40,90,167
682270000,1400500000,62580000,320510000,34140000,2.5e+09,34,39,87,160
614390000,1426460000,37320000,138460000,283370000,2.5e+09,40,35,93,168
1216060000,542850000,12540000,643870000,84680000,2.5e+09,37,34,85,156
701200000,1344380000,30670000,165700000,258050000,2.5e+09,37,36,86,159
683420000,1254510000,31690000,486370000,44010000,2.5e+09,39,42,96,177
0,0,0,0,0,0,36,40,85,161
181460000,776390000,9690000,60470000,51300000,1079310000,34,35,86,155
26920000,43920000,10400000,17460000,7190000,105890000,34,32,73,139
364990000,689060000,9330000,58550000,22590000,1144520000,40,35,89,164
630340000,1255350000,120390000,86220000,407700000,2.5e+09,37,39,89,165
258570000,618690000,32800000,251610000,619660000,1781330000,42,44,97,183
761730000,1367100000,48710000,216720000,105740000,2.5e+09,40,38,91,169
723580000,1255760000,80340000,241790000,179630000,2481100000,36,36,82,154
896910000,1208050000,166250000,143900000,84890000,2.5e+09,35,34,84,153
216220000,1720120000,119810000,327560000,116290000,2.5e+09,37,34,87,158
193820000,1496450000,148090000,193970000,72480000,2104810000,40,35,93,168
367770000,1644500000,189330000,206800000,91570000,2499970000,31,31,74,136
1396830000,761790000,65150000,231110000,45120000,2.5e+09,32,25,73,130
1165500000,1019750000,145480000,79050000,90220000,2.5e+09,33,29,76,138
1349150000,798470000,74250000,235940000,42190000,2.5e+09,37,30,85,152
1320380000,828760000,119490000,96300000,135070000,2.5e+09,40,36,90,166
1017300000,1100390000,79930000,260840000,41540000,2.5e+09,37,37,83,157
523830000,1312600000,120600000,162970000,38980000,2158980000,38,36,93,167
554770000,789550000,38520000,132970000,30410000,1546220000,45,39,96,180
7250000,4110000,0,2430000,380000,14170000,44,40,102,186
352880000,1773600000,143780000,194490000,35250000,2.5e+09,36,36,84,156
764110000,1484130000,59640000,162570000,29550000,2.5e+09,37,39,82,158
455320000,1193170000,62680000,282080000,79630000,2072880000,43,39,100,182
325550000,1.801e+09,95370000,260810000,17270000,2.5e+09,43,40,94,177
579880000,1418530000,71410000,400380000,17250000,2487450000,37,38,84,159
584770000,1332140000,64130000,467280000,51680000,2.5e+09,43,40,94,177
289950000,480990000,24790000,202740000,28050000,1026520000,36,39,87,162
540160000,550720000,25640000,212820000,41110000,1370450000,44,41,103,188
556110000,1350240000,97840000,430050000,65760000,2.5e+09,39,39,88,166
694730000,1365530000,38870000,378420000,22450000,2.5e+09,32,37,87,156
1149760000,677360000,19600000,419950000,54230000,2320900000,44,42,98,184
576420000,360070000,30450000,153930000,31800000,1152670000,41,39,96,176
863220000,1285910000,31660000,196480000,122730000,2.5e+09,40,39,88,167
636770000,9.84e+08,19830000,565240000,294160000,2.5e+09,42,42,96,180
1105530000,461150000,22980000,146180000,119110000,1854950000,40,40,91,171
528550000,833620000,20110000,209730000,20390000,1612400000,36,37,88,161
267160000,1590780000,77110000,103700000,86370000,2125120000,38,38,87,163
3.77e+08,1742990000,30030000,156110000,84140000,2390270000,38,39,88,165
823010000,1197500000,179190000,102510000,197790000,2.5e+09,34,36,83,153
402090000,1487300000,71530000,299510000,239570000,2.5e+09,41,41,93,175
658920000,1334750000,57790000,210640000,237900000,2.5e+09,37,34,82,153
522450000,1683660000,80940000,71690000,141260000,2.5e+09,31,33,69,133
560200000,1667950000,75220000,88980000,107650000,2.5e+09,30,29,70,129
0,5e+05,0,3850000,0,4350000,34,31,78,143
123790000,1063210000,87020000,293130000,57740000,1624890000,33,34,81,148
451600000,445180000,70410000,195560000,78690000,1241440000,33,30,78,141
897980000,194850000,9830000,165400000,30300000,1298360000,35,35,86,156
670040000,45610000,5490000,94180000,19690000,835010000,31,25,73,129
354330000,186320000,63040000,147730000,115550000,866970000,36,25,77,138
437920000,47670000,92570000,1270000,1920570000,2.5e+09,36,31,81,148
926780000,224530000,27080000,11790000,1309820000,2.5e+09,41,34,82,157
1311300000,452610000,48100000,23010000,664980000,2.5e+09,39,34,87,160
1739890000,26770000,2480000,970000,729890000,2.5e+09,35,29,67,131
1825860000,163810000,14710000,1390000,494230000,2.5e+09,39,33,85,157
568640000,37780000,9e+06,660000,1669240000,2285320000,36,33,80,149
1080220000,109480000,58400000,9420000,1242480000,2.5e+09,40,35,88,163
915250000,864830000,41990000,330060000,347870000,2.5e+09,39,39,83,161
773870000,1170880000,56180000,188210000,310860000,2.5e+09,41,44,91,176
1018930000,941400000,26190000,207320000,306160000,2.5e+09,38,34,81,153
698640000,1452900000,81290000,150620000,116550000,2.5e+09,39,41,85,165
712720000,276250000,6520000,232010000,1272500000,2.5e+09,35,34,76,145
1210520000,570140000,23280000,291550000,404510000,2.5e+09,36,35,78,149
151450000,44100000,2370000,19410000,2282670000,2.5e+09,30,29,70,129
861590000,399700000,87270000,0,1151440000,2.5e+09,41,40,93,174
932950000,306700000,76790000,0,1183560000,2.5e+09,40,39,90,169
877230000,4.02e+08,29890000,0,1190880000,2.5e+09,38,38,92,168
1240590000,771980000,81430000,520000,405480000,2.5e+09,40,37,84,161
1201990000,929880000,169900000,450000,197780000,2.5e+09,42,36,85,163
1156850000,150090000,17740000,0,1175320000,2.5e+09,44,40,101,185
662130000,209640000,93100000,360000,1534770000,2.5e+09,42,41,102,185
1618670000,419010000,20670000,0,441650000,2.5e+09,40,33,71,144
1793820000,394780000,29720000,0,281680000,2.5e+09,38,39,83,160
1055200000,389270000,73120000,290000,982120000,2.5e+09,42,41,97,180
1.303e+09,430390000,45320000,0,721290000,2.5e+09,40,40,96,176
1098850000,921600000,87180000,0,392370000,2.5e+09,39,33,75,147
1378610000,628570000,37390000,0,455430000,2.5e+09,38,31,73,142
482740000,70110000,31790000,0,1915360000,2.5e+09,36,35,91,162
337280000,127190000,44590000,0,1858540000,2367600000,41,35,88,164
1109290000,524120000,34200000,0,832390000,2.5e+09,39,33,85,157
798020000,1180520000,20280000,263750000,237430000,2.5e+09,33,33,73,139
710690000,1350150000,88270000,160110000,190780000,2.5e+09,35,34,79,148
685300000,1.468e+09,35400000,120570000,190730000,2.5e+09,35,36,79,150
815680000,702340000,23440000,292120000,666420000,2.5e+09,41,43,86,170
394090000,141770000,149280000,129820000,1647350000,2462310000,39,43,87,169
401230000,245840000,7410000,118770000,1667080000,2440330000,37,38,90,165
645290000,311460000,7e+06,79320000,1456930000,2.5e+09,41,41,99,181
31250000,44950000,6150000,10790000,2133380000,2226520000,32,33,80,145
62400000,10730000,350000,7270000,2070850000,2151600000,32,33,71,136
346870000,214930000,13740000,60710000,1863750000,2.5e+09,40,40,96,176
770270000,320260000,46170000,70820000,1292480000,2.5e+09,39,39,85,163
1066260000,700450000,16610000,159740000,556940000,2.5e+09,43,40,93,176
1455440000,590310000,79190000,0,375060000,2.5e+09,41,39,93,173
281930000,21660000,11910000,0,1916920000,2232420000,39,38,91,168
1347750000,892990000,39440000,0,219820000,2.5e+09,41,37,81,159
1149560000,1.107e+09,55410000,670000,187360000,2.5e+09,39,37,78,154
1777700000,190710000,15660000,0,515930000,2.5e+09,38,36,74,148
1219970000,502050000,184340000,0,593640000,2.5e+09,40,36,82,158
1482580000,500900000,38310000,0,478210000,2.5e+09,40,37,76,153
1550290000,387440000,21560000,0,540710000,2.5e+09,38,34,75,147
1176720000,396110000,63010000,0,864160000,2.5e+09,41,36,88,165
1445240000,426180000,28130000,0,600450000,2.5e+09,39,33,82,154
1445040000,18280000,11480000,2140000,1023060000,2.5e+09,33,28,70,131
1572100000,18570000,1290000,840000,907200000,2.5e+09,34,28,67,129
1071120000,7470000,1090000,730000,1419590000,2.5e+09,34,26,64,124
794880000,0,0,2110000,1703010000,2.5e+09,29,28,61,118
1210260000,148130000,8670000,0,1132940000,2.5e+09,33,26,62,121
404730000,14670000,720000,6050000,2073830000,2.5e+09,28,22,47,97
352140000,21930000,1240000,19330000,2105360000,2.5e+09,27,27,54,108
148620000,0,0,33960000,2317420000,2.5e+09,23,21,41,85
480260000,63220000,22590000,250000,1933680000,2.5e+09,25,25,59,109
127350000,13430000,810000,0,2358410000,2.5e+09,17,17,41,75
387090000,65370000,5540000,0,2.042e+09,2.5e+09,22,22,47,91
1688360000,10750000,3260000,1060000,796570000,2.5e+09,35,29,70,134
1842980000,49960000,5e+06,320000,601740000,2.5e+09,34,27,69,130
1861100000,195150000,30650000,3170000,409930000,2.5e+09,36,30,73,139
1905540000,155550000,5380000,1060000,432470000,2.5e+09,37,33,76,146
1415610000,6080000,8510000,6810000,1062990000,2.5e+09,33,28,65,126
1587840000,19350000,4450000,12450000,875910000,2.5e+09,33,28,70,131
1802860000,30120000,5950000,3110000,657960000,2.5e+09,34,29,68,131
1477590000,470000,1310000,1370000,1019260000,2.5e+09,33,27,61,121
1614960000,5420000,4670000,2850000,872100000,2.5e+09,31,27,66,124
1708680000,0,780000,2030000,788510000,2.5e+09,31,25,63,119
1675810000,1720000,11320000,260000,810890000,2.5e+09,32,27,65,124
743770000,0,2800000,5330000,1748100000,2.5e+09,29,29,63,121
1273920000,490000,3060000,5610000,1216920000,2.5e+09,29,25,57,111
1298070000,820000,1670000,2640000,1196800000,2.5e+09,30,25,59,114
229370000,0,0,8550000,2262080000,2.5e+09,26,29,53,108
836070000,7250000,1830000,0,1654850000,2.5e+09,22,22,46,90
881040000,1990000,530000,0,1616440000,2.5e+09,23,21,52,96
459920000,1930000,0,0,2038150000,2.5e+09,18,16,31,65
504560000,53940000,21940000,4e+05,1690670000,2271510000,35,33,71,139
469480000,56170000,2030000,320000,1566900000,2094900000,36,33,73,142
472770000,22720000,37930000,4720000,1961860000,2.5e+09,37,32,78,147
1521060000,59400000,11870000,18190000,889480000,2.5e+09,37,33,74,144
1389370000,2600000,3100000,6640000,1098290000,2.5e+09,31,27,56,114
1205530000,7930000,5580000,4500000,1276460000,2.5e+09,31,27,58,116
1292880000,3840000,4020000,0,1199260000,2.5e+09,31,28,67,126
1560310000,1650000,7880000,2960000,927200000,2.5e+09,32,28,63,123
451070000,0,0,0,2048930000,2.5e+09,27,22,47,96
428230000,137730000,25120000,450000,1711550000,2303080000,41,37,85,163
1486880000,60800000,16250000,19720000,916350000,2.5e+09,34,33,74,141
1704540000,17770000,7720000,770000,769200000,2.5e+09,33,31,67,131
1620160000,16400000,7570000,12550000,843320000,2.5e+09,34,32,72,138
1302620000,369700000,27710000,250550000,549420000,2.5e+09,35,37,76,148
173300000,586690000,40290000,74650000,1625070000,2.5e+09,39,37,94,170
1838600000,279560000,22480000,134160000,225200000,2.5e+09,36,29,65,130
816020000,1147490000,85980000,231840000,218670000,2.5e+09,28,29,55,112
1398640000,534560000,53270000,259550000,253980000,2.5e+09,32,36,71,139
904750000,753770000,103800000,578500000,159180000,2.5e+09,30,29,60,119
1294550000,432290000,33740000,109680000,629740000,2.5e+09,35,34,79,148
92390000,680760000,23850000,31410000,1570570000,2398980000,42,40,107,189
901460000,794650000,37080000,111380000,655430000,2.5e+09,32,34,77,143
179210000,691900000,26080000,49030000,1532330000,2478550000,36,35,85,156
1627990000,385290000,41840000,130420000,314460000,2.5e+09,35,38,82,155
688090000,1071880000,81700000,334990000,323340000,2.5e+09,38,32,87,157
1146430000,726910000,87480000,262160000,277020000,2.5e+09,37,43,90,170
1424630000,637570000,121240000,136710000,179850000,2.5e+09,34,40,81,155
1486310000,391980000,102490000,377750000,141470000,2.5e+09,33,23,54,110
625370000,1203680000,183630000,380970000,106350000,2.5e+09,36,32,82,150
1318660000,389220000,81970000,478110000,232040000,2.5e+09,34,29,78,141
848700000,659260000,87100000,652550000,252390000,2.5e+09,35,30,77,142
1452630000,248700000,52580000,487290000,198160000,2439360000,26,22,52,100
1551030000,360400000,75240000,273510000,145620000,2405800000,24,20,38,82
1547850000,176790000,43880000,434800000,296680000,2.5e+09,28,23,48,99
992550000,865870000,22070000,112610000,506900000,2.5e+09,33,31,77,141
452590000,1034510000,40210000,128260000,844430000,2.5e+09,42,42,110,194
109370000,1983990000,68130000,158290000,180220000,2.5e+09,24,22,41,87
549160000,1283590000,62560000,253620000,351070000,2.5e+09,35,35,83,153
357650000,1614160000,92220000,277500000,158470000,2.5e+09,29,31,69,129
136380000,1770960000,69470000,2.67e+08,256190000,2.5e+09,26,26,59,111
941140000,1086940000,128510000,148240000,195170000,2.5e+09,26,26,64,116
1109650000,867060000,101770000,181250000,240270000,2.5e+09,35,38,86,159
861150000,1239830000,149210000,109350000,140460000,2.5e+09,32,32,84,148
662030000,1410800000,103990000,233240000,89940000,2.5e+09,35,34,80,149
252310000,1857400000,178730000,93100000,118460000,2.5e+09,33,31,75,139
442020000,1610620000,136220000,162610000,148530000,2.5e+09,42,42,97,181
326310000,1800820000,138770000,102100000,1.32e+08,2.5e+09,38,31,80,149
495840000,1683850000,165450000,78630000,76230000,2.5e+09,28,31,68,127
257760000,1714880000,398670000,44660000,84030000,2.5e+09,25,24,60,109
1029210000,811120000,140570000,361540000,157560000,2.5e+09,33,27,66,126
1495470000,378030000,143610000,315770000,167120000,2.5e+09,22,16,49,87
1824340000,193370000,79770000,306670000,95850000,2.5e+09,32,29,67,128
1501700000,106340000,1.05e+08,475650000,311310000,2.5e+09,24,24,47,95
1648410000,144360000,139160000,352180000,215890000,2.5e+09,32,26,56,114
499260000,1337270000,306650000,297220000,59600000,2.5e+09,22,26,54,102
1244010000,885690000,51230000,126310000,192760000,2.5e+09,41,41,99,181
652560000,133510000,18730000,22720000,1454880000,2282400000,35,36,91,162
745220000,1329390000,139230000,169910000,116250000,2.5e+09,34,38,85,157
460940000,1427260000,123020000,225130000,263650000,2.5e+09,46,43,111,200
459580000,658700000,119360000,43400000,1218960000,2.5e+09,43,41,100,184
296340000,221410000,29840000,33210000,1669820000,2250620000,37,35,84,156
425240000,1674620000,153810000,62430000,183900000,2.5e+09,36,36,92,164
400140000,1825160000,148050000,82820000,43830000,2.5e+09,30,29,71,130
195180000,1970670000,166060000,55740000,112350000,2.5e+09,29,29,67,125
39400000,2220120000,109510000,54300000,76670000,2.5e+09,26,24,47,97
158840000,1516760000,102670000,106860000,52720000,1937850000,42,34,85,161
581050000,1354180000,247970000,263520000,53280000,2.5e+09,21,22,49,92
356240000,1277510000,179490000,236680000,55140000,2105060000,26,27,56,109
121290000,939920000,101300000,275640000,78880000,1517030000,40,36,77,153
438050000,1212180000,246390000,437710000,128080000,2462410000,31,27,67,125
174900000,312850000,80010000,91780000,37780000,697320000,36,36,74,146
16180000,1028410000,65530000,85190000,1293560000,2488870000,38,34,80,152
557580000,1380180000,104310000,214750000,243180000,2.5e+09,33,33,91,157
58340000,256920000,26560000,63970000,2094210000,2.5e+09,31,27,88,146
213990000,443770000,60010000,32150000,179240000,929160000,36,30,82,148
123200000,358420000,22840000,69940000,997790000,1572190000,32,32,81,145
673530000,1314770000,125920000,115380000,270400000,2.5e+09,39,39,91,169
1087940000,1054540000,59840000,120170000,177510000,2.5e+09,36,37,83,156
758540000,1246680000,186560000,136490000,171730000,2.5e+09,34,37,80,151
1.055e+09,789250000,33880000,244990000,162330000,2285450000,37,38,86,161
717220000,1501540000,80500000,114210000,86530000,2.5e+09,32,32,72,136
725520000,1416470000,76780000,130720000,150510000,2.5e+09,32,36,79,147
712850000,1379040000,60610000,189510000,157990000,2.5e+09,37,37,82,156
535150000,1619680000,59900000,168430000,116840000,2.5e+09,35,37,82,154
333650000,1730000,580000,87800000,25580000,449340000,29,22,65,116
241540000,51400000,19140000,11640000,23880000,347600000,29,23,69,121
0,0,0,0,0,0,35,33,86,154
15380000,56840000,2310000,7730000,10090000,92350000,38,37,85,160
856320000,142160000,7190000,86170000,167890000,1259730000,37,38,80,155
757790000,383810000,32760000,93180000,121500000,1389040000,37,37,80,154
0,0,0,0,0,0,42,39,87,168
764330000,1324650000,4e+07,178110000,192910000,2.5e+09,37,35,82,154
1103070000,898010000,56620000,156040000,286260000,2.5e+09,40,37,85,162
712690000,629960000,60330000,256730000,281550000,1941260000,37,39,87,163
298810000,750940000,23200000,140860000,130210000,1344020000,37,37,85,159
129310000,1410370000,240050000,283770000,59950000,2123450000,36,32,75,143
237850000,252880000,8110000,118970000,47840000,665650000,43,39,82,164
8240000,234820000,26920000,46190000,50390000,366560000,37,35,69,141
1027660000,1044470000,23290000,232200000,172380000,2.5e+09,35,29,69,133
347090000,1985300000,74750000,44600000,48260000,2.5e+09,26,32,69,127
1281240000,562180000,24560000,316420000,315600000,2.5e+09,38,33,75,146
783190000,1351240000,39500000,211300000,114770000,2.5e+09,35,34,75,144
856970000,378610000,231610000,105050000,927760000,2.5e+09,36,38,87,161
1148750000,910700000,9840000,81650000,349060000,2.5e+09,35,34,79,148
1276280000,752890000,19720000,162430000,288680000,2.5e+09,37,36,78,151
1148940000,488510000,34900000,76510000,751140000,2.5e+09,46,39,92,177
1285070000,683820000,12430000,94960000,423720000,2.5e+09,42,40,92,174
881010000,772600000,175450000,177610000,493330000,2.5e+09,45,42,91,178
1284470000,737040000,28280000,88060000,362150000,2.5e+09,37,33,75,145
862330000,380120000,447060000,720000,809770000,2.5e+09,42,40,97,179
1442140000,518640000,73800000,380000,465040000,2.5e+09,41,39,87,167
1392240000,734210000,113790000,0,259760000,2.5e+09,40,36,85,161
1696610000,184080000,28850000,0,590460000,2.5e+09,38,36,73,147
1510720000,354850000,31030000,0,603400000,2.5e+09,38,37,81,156
1738620000,185200000,10160000,0,566020000,2.5e+09,39,33,77,149
1887840000,75710000,13860000,0,522590000,2.5e+09,37,31,71,139
1220560000,391930000,24060000,0,863450000,2.5e+09,39,28,74,141
1307470000,160250000,8330000,0,1023950000,2.5e+09,40,34,79,153
1101970000,551820000,27710000,491820000,326680000,2.5e+09,39,36,78,153
743930000,694280000,9110000,524980000,527700000,2.5e+09,44,42,92,178
1301540000,732100000,20830000,211730000,233800000,2.5e+09,38,34,76,148
1224370000,471020000,5840000,492530000,306240000,2.5e+09,35,32,70,137
1.338e+09,585670000,6900000,316720000,252710000,2.5e+09,37,35,81,153
1262780000,677800000,13510000,335700000,210210000,2.5e+09,36,36,80,152
1045510000,780710000,32010000,169460000,472310000,2.5e+09,40,38,82,160
1234080000,801680000,29240000,169040000,265960000,2.5e+09,36,35,80,151
923520000,923330000,57790000,243350000,352010000,2.5e+09,44,42,88,174
1081290000,988200000,30830000,273300000,126380000,2.5e+09,35,35,78,148
1228460000,617130000,27950000,145210000,481250000,2.5e+09,43,38,92,173
1136080000,840820000,43640000,198410000,281050000,2.5e+09,37,35,75,147
1075970000,732780000,43900000,238620000,408730000,2.5e+09,42,35,83,160
1327570000,734910000,35700000,146920000,254900000,2.5e+09,39,39,81,159
539490000,206220000,66590000,370000,1651120000,2463790000,38,38,91,167
197560000,33470000,5390000,13500000,1889350000,2139270000,38,36,81,155
142360000,11770000,10120000,0,2004790000,2169040000,33,32,76,141
1297090000,468500000,130740000,0,603670000,2.5e+09,44,38,92,174
1191370000,936650000,63510000,350000,308120000,2.5e+09,41,37,77,155
1590870000,267620000,55350000,0,586160000,2.5e+09,41,37,80,158
1322520000,754690000,101180000,0,321610000,2.5e+09,42,39,90,171
1576860000,201930000,50180000,0,671030000,2.5e+09,39,35,81,155
1371420000,212050000,14600000,350000,901580000,2.5e+09,37,35,73,145
1740410000,108970000,10840000,0,639780000,2.5e+09,37,36,74,147
1733680000,113320000,12730000,0,640270000,2.5e+09,37,33,71,141
1619700000,130280000,14150000,0,735870000,2.5e+09,39,34,78,151
1658220000,246080000,107690000,0,488010000,2.5e+09,39,32,83,154
1431050000,175460000,4690000,0,888800000,2.5e+09,40,34,81,155
1607960000,177360000,12250000,0,702430000,2.5e+09,38,33,86,157
1711090000,388920000,15190000,0,384800000,2.5e+09,37,32,73,142
1657020000,151880000,7360000,0,683740000,2.5e+09,38,34,74,146
1660200000,308140000,12560000,290000,518810000,2.5e+09,37,31,71,139
1716990000,192850000,5590000,0,584570000,2.5e+09,38,33,71,142
587730000,923280000,24320000,735380000,229290000,2.5e+09,32,36,68,136
777370000,858180000,12770000,457840000,389450000,2495610000,32,31,66,129
309090000,231600000,3300000,246390000,99680000,890060000,43,38,81,162
884480000,473540000,11370000,126600000,172360000,1668350000,36,36,76,148
921130000,749460000,10800000,352540000,293450000,2327380000,36,32,67,135
391580000,235150000,7120000,48850000,829540000,1512240000,35,38,77,150
842610000,648590000,33710000,159880000,278920000,1963710000,38,42,80,160
996940000,325600000,54430000,60870000,1062160000,2.5e+09,41,35,81,157
329720000,88440000,7370000,1.7e+07,1163380000,1605910000,40,34,75,149
1776350000,242370000,13230000,0,468050000,2.5e+09,38,34,76,148
1545230000,343950000,58650000,0,541800000,2489630000,42,39,97,178
998370000,313750000,103790000,0,821770000,2237680000,40,37,90,167
1709700000,189550000,12610000,0,588140000,2.5e+09,39,36,72,147
1740790000,128680000,36340000,0,594190000,2.5e+09,35,33,73,141
1430800000,153280000,12950000,0,902970000,2.5e+09,37,33,79,149
1655820000,60730000,3960000,0,779490000,2.5e+09,38,34,72,144
1362480000,227770000,64720000,0,845030000,2.5e+09,39,32,72,143
1734550000,141320000,44860000,0,579270000,2.5e+09,39,36,72,147
1566770000,201400000,11600000,0,720230000,2.5e+09,38,30,71,139
1668410000,62180000,13500000,0,755910000,2.5e+09,39,33,74,146
1505070000,208780000,5950000,0,780200000,2.5e+09,38,31,69,138
1483760000,423910000,26870000,0,565460000,2.5e+09,41,38,82,161
1713150000,91820000,2250000,0,692780000,2.5e+09,34,31,66,131
1692440000,130040000,8700000,0,668820000,2.5e+09,40,30,70,140
1383760000,134870000,22180000,0,959190000,2.5e+09,36,34,79,149
1098490000,190390000,14950000,0,446860000,1750690000,41,38,84,163
1541840000,210400000,39600000,5e+05,707660000,2.5e+09,40,35,77,152
1189920000,280870000,46700000,0,982510000,2.5e+09,41,36,83,160
1693160000,47980000,0,0,757790000,2498930000,35,31,69,135
1195550000,130370000,13320000,0,1160760000,2.5e+09,39,32,74,145
775500000,128310000,36080000,2860000,1547730000,2490480000,45,41,99,185
1473230000,434850000,45330000,0,546590000,2.5e+09,39,33,74,146
183140000,16460000,42200000,2050000,2237770000,2481620000,37,34,85,156
1436320000,33410000,2430000,70000,1027770000,2.5e+09,34,32,69,135
1376110000,220690000,56470000,12470000,834260000,2.5e+09,38,33,77,148
1126990000,582530000,36880000,16880000,736720000,2.5e+09,43,39,95,177
1638420000,296290000,12810000,0,552480000,2.5e+09,39,31,80,150
1274320000,138170000,10010000,0,1077500000,2.5e+09,39,32,78,149
1489340000,144800000,5360000,0,860500000,2.5e+09,40,32,78,150
1009210000,67430000,8270000,0,1415090000,2.5e+09,38,34,86,158
850680000,131650000,148250000,3390000,1366030000,2.5e+09,42,38,94,174
1084960000,40710000,360000,0,1373970000,2.5e+09,36,31,74,141
1260970000,51560000,2640000,330000,1184500000,2.5e+09,37,30,74,141
1435510000,22500000,45810000,0,996180000,2.5e+09,37,32,71,140
1159940000,68740000,3250000,0,1268070000,2.5e+09,34,28,70,132
1593830000,20790000,2450000,0,882930000,2.5e+09,33,30,68,131
1174910000,32720000,3600000,0,1288770000,2.5e+09,32,30,73,135
1640050000,9450000,3240000,410000,846850000,2.5e+09,27,27,58,112
1704580000,15280000,790000,0,779350000,2.5e+09,30,27,66,123
1428450000,26820000,9690000,0,1035040000,2.5e+09,30,31,65,126
1382660000,6310000,0,0,1111030000,2.5e+09,31,28,62,121
1495670000,620000,4e+05,0,1003310000,2.5e+09,27,22,54,103
1498570000,12200000,9990000,0,979240000,2.5e+09,31,27,63,121
1616300000,0,0,0,883700000,2.5e+09,29,25,61,115
1297770000,1630000,0,0,1200600000,2.5e+09,29,28,68,125
1677400000,620000,0,0,821980000,2.5e+09,18,17,36,71
1355580000,0,0,0,1144420000,2.5e+09,29,25,55,109
1040960000,0,0,0,1459040000,2.5e+09,31,27,60,118
1728410000,0,1180000,0,770410000,2.5e+09,33,28,67,128
418550000,13010000,4280000,0,2064160000,2.5e+09,29,29,61,119
1123080000,2340000,0,0,1374580000,2.5e+09,25,22,48,95
202080000,0,0,0,2297920000,2.5e+09,24,20,40,84
587200000,4880000,0,560000,1907360000,2.5e+09,32,26,64,122
1170000,0,6e+05,0,2498230000,2.5e+09,24,17,49,90
181240000,8300000,1120000,0,2309340000,2.5e+09,23,22,45,90
1457070000,30660000,3860000,0,1008410000,2.5e+09,35,28,69,132
1539020000,30700000,8670000,0,921610000,2.5e+09,33,30,67,130
1536780000,89970000,11900000,0,861350000,2.5e+09,36,30,72,138
1501250000,31940000,350000,0,966460000,2.5e+09,32,31,75,138
1159560000,21050000,0,0,1319390000,2.5e+09,36,34,76,146
1255110000,24910000,5420000,0,1214560000,2.5e+09,32,29,65,126
1547830000,21600000,13840000,0,916730000,2.5e+09,31,29,67,127
1323090000,18790000,2050000,0,1156070000,2.5e+09,31,32,71,134
1371980000,27100000,390000,970000,1099470000,2499910000,29,29,61,119
1523230000,7620000,440000,350000,968360000,2.5e+09,31,29,62,122
1656440000,20660000,8480000,670000,813750000,2.5e+09,31,29,67,127
1689360000,5310000,1980000,0,803350000,2.5e+09,32,28,59,119
1737250000,0,2430000,0,760320000,2.5e+09,30,29,66,125
1118800000,650000,0,0,1380550000,2.5e+09,31,28,66,125
1619580000,0,0,0,875170000,2494750000,27,26,56,109
1114860000,0,0,0,1385140000,2.5e+09,29,28,67,124
1578720000,4920000,10610000,0,905750000,2.5e+09,33,32,76,141
802650000,33190000,2360000,0,1661800000,2.5e+09,27,24,55,106
332060000,0,0,0,2167940000,2.5e+09,32,23,57,112
410600000,22560000,5050000,0,2061790000,2.5e+09,17,21,60,98
991020000,3080000,1160000,0,1504740000,2.5e+09,29,25,62,116
304480000,18440000,0,0,2177080000,2.5e+09,20,17,44,81
86550000,7430000,2100000,0,2403920000,2.5e+09,22,16,47,85
1205580000,2.2e+07,0,0,1081960000,2309540000,34,30,63,127
1455100000,34380000,6960000,0,997770000,2494210000,34,30,68,132
1224550000,11730000,280000,0,680500000,1917060000,34,34,71,139
9.72e+08,8860000,370000,0,681020000,1662250000,33,26,61,120
1344420000,57820000,15380000,0,753710000,2171330000,40,33,83,156
602290000,1632990000,170660000,79060000,1.5e+07,2.5e+09,35,33,80,148
1672600000,44160000,9410000,0,773830000,2.5e+09,41,34,75,150
1772720000,99950000,9130000,0,523570000,2405370000,39,34,77,150
1363470000,29410000,11240000,0,649150000,2053270000,39,35,72,146
6740000,685940000,76440000,77960000,1497460000,2344540000,38,30,77,145
748810000,487220000,36420000,347590000,879960000,2.5e+09,37,34,80,151
0,6450000,280000,0,2238680000,2245410000,16,18,38,72
1166640000,6715910000,1542240000,541460000,109430000,10075680000,36,32,71,139
6607560000,2680660000,543240000,1206340000,634150000,11671950000,39,35,91,165
2381950000,35910000,7490000,0,1957370000,4382720000,42,35,91,168
2517020000,4133180000,946690000,2494470000,355030000,10446390000,40,33,86,159
3384340000,3197450000,864370000,1554070000,311650000,9311880000,38,30,78,146
4726530000,1720000,19380000,2570000,2664600000,7414800000,38,34,91,163
496800000,964090000,101540000,454160000,2949020000,4965610000,42,39,94,175
2884280000,4672540000,779060000,632800000,1102290000,10070970000,35,33,76,144
1118210000,2358320000,1523300000,3222520000,2461270000,10683620000,42,36,84,162
7107170000,1261750000,57340000,290000,2682390000,11108940000,43,37,96,176
1687700000,2334330000,468140000,442360000,182560000,5115090000,36,37,79,152
9114590000,121410000,47700000,1990000,5525270000,14810960000,43,38,97,178
6523030000,417460000,88810000,13080000,5469520000,12511900000,45,40,96,181
6812710000,3461280000,375180000,135140000,7182840000,17967150000,44,37,90,171
2697150000,3900560000,40160000,154880000,3959260000,10752010000,42,36,92,170
5422060000,2831970000,925040000,124190000,4731330000,14034590000,36,28,71,135
842230000,6575230000,257340000,432100000,2192810000,10299710000,41,36,88,165
2499490000,651130000,59160000,9920000,11079180000,14298880000,41,30,86,157
4529670000,375070000,28220000,82100000,7598080000,12613140000,36,32,77,145
3312840000,7264840000,358700000,2125780000,246070000,13308230000,42,34,95,171
5308640000,3408830000,439360000,651290000,534380000,10342500000,38,33,72,143
1914990000,6882150000,379020000,1168220000,117030000,10461410000,41,40,91,172
3429250000,5144160000,601920000,1030290000,492660000,10698280000,45,39,98,182
9201320000,1617060000,209020000,322540000,7583270000,18933210000,37,30,72,139
3396230000,5204400000,592350000,862670000,286230000,10341880000,42,37,91,170
4428380000,812310000,213100000,21150000,13397120000,18872060000,46,36,89,171
3681490000,6368410000,302310000,1036070000,3139510000,14527790000,45,42,101,188
200710000,3325770000,254820000,1182920000,381440000,5345660000,44,36,92,172
2385490000,4440720000,851340000,927420000,190130000,8795100000,32,31,80,143
658970000,3370750000,2.2e+08,193600000,4772970000,9216290000,49,43,103,195
3511940000,4509310000,149190000,1624190000,3017740000,12812370000,41,39,93,173
2179470000,7243480000,176610000,807030000,306080000,10712670000,42,31,78,151
2199330000,260470000,50190000,4170000,6281770000,8795930000,37,29,52,118
730550000,2503910000,528940000,4719160000,643910000,9126470000,47,42,106,195
1170560000,7569290000,458130000,1804560000,108700000,11111240000,34,28,67,129
1994190000,6475040000,711850000,919100000,202080000,10302260000,43,43,104,190
2744180000,410500000,483110000,933480000,3619460000,8190730000,38,34,87,159
437200000,8439460000,633600000,911340000,266830000,10688430000,37,33,89,159
1321490000,5521950000,963640000,836660000,437240000,9080980000,41,35,88,164
3133570000,6138020000,368910000,552560000,631850000,10824910000,36,35,83,154
1801200000,8263780000,356310000,1131370000,1310310000,12862970000,44,38,94,176
7137010000,2598950000,721990000,1772560000,691870000,12922380000,46,44,108,198
7635480000,1544390000,135850000,1450000,2385050000,11702220000,47,43,92,182
10240140000,86910000,19060000,51490000,8063730000,18461330000,38,34,68,140
8384860000,7074700000,1629470000,2171420000,840550000,2.0101e+10,45,42,107,194
7439630000,277750000,44350000,22090000,2989460000,10773280000,40,39,89,168
3716140000,6.359e+09,1279070000,594720000,9033550000,20982480000,39,39,91,169
2703710000,7027830000,766920000,222390000,221440000,10942290000,37,34,81,152
178680000,695290000,45660000,1348850000,6914980000,9183460000,39,37,99,175
318620000,894020000,122530000,2535650000,9318570000,13189390000,46,44,99,189
6650440000,3761390000,551180000,1050850000,6763540000,18777400000,45,42,104,191
1106220000,2464900000,88780000,352320000,4535450000,8547670000,40,35,82,157
4125600000,2271290000,1662870000,1851380000,164480000,10075620000,36,21,56,113
1779400000,603150000,174390000,792340000,356910000,3706190000,33,28,58,119
7478940000,351380000,72930000,11420000,2447690000,10362360000,36,39,86,161
5593120000,391750000,16320000,0,2506120000,8507310000,40,30,87,157
2562130000,3505250000,142400000,592860000,780400000,7583040000,35,37,75,147
8597920000,147270000,71030000,32190000,4834970000,13683380000,42,38,96,176
1030840000,1021620000,71910000,420070000,336630000,2881070000,45,37,92,174
3509690000,2530610000,339610000,358610000,3225860000,9964380000,45,32,80,157
2067220000,5299430000,267850000,472180000,566180000,8672860000,41,31,81,153
1841820000,2830470000,326270000,81670000,3475020000,8555250000,32,34,70,136
6778920000,1214830000,237260000,350000,2857500000,11088860000,42,43,100,185
366820000,2567220000,662690000,822270000,2753250000,7172250000,43,44,95,182
3298900000,2857900000,433760000,1881180000,714530000,9186270000,41,37,93,171
649340000,891910000,686240000,4151630000,4439240000,10818360000,31,32,77,140
6556580000,3381670000,601500000,1834500000,442650000,12816900000,39,33,85,157
3927770000,913030000,275600000,2170000,4306960000,9425530000,37,27,85,149
4323600000,3542610000,318420000,1799810000,352460000,10336900000,40,38,91,169
3110410000,4902860000,268910000,203690000,590370000,9076240000,39,35,93,167
335040000,8215410000,818400000,34940000,1503660000,10907450000,45,42,91,178
2885240000,5918860000,365140000,913650000,264050000,10346940000,41,32,92,165
1936780000,9896240000,888160000,1591120000,1414010000,15726310000,38,34,80,152
6118970000,4966800000,1182570000,1227460000,335950000,13831750000,37,32,72,141
284690000,5383430000,734730000,1795880000,2588560000,10787290000,34,21,69,124
2203320000,2.35e+08,33210000,6340000,6442920000,8920790000,40,30,86,156
5209670000,2227400000,193480000,5973780000,579710000,14184040000,37,28,78,143
3623050000,4707870000,214630000,935850000,1251840000,10733240000,44,33,90,167
2760090000,73240000,15660000,0,1579260000,4428250000,26,21,55,102
4451310000,1094370000,134540000,52910000,4462510000,10195640000,43,35,84,162
3605940000,4308030000,856860000,997270000,579310000,10347410000,40,32,82,154
7231120000,724550000,33160000,0,3115150000,11103980000,40,32,84,156
3565590000,470610000,76090000,0,1679710000,5.792e+09,44,48,115,207
1524390000,7380880000,45690000,2488840000,3602290000,15042090000,42,35,89,166
4828880000,569830000,16920000,0,8691330000,14106960000,34,24,57,115
2760210000,5690900000,408930000,440460000,699810000,10000310000,37,35,72,144
1767440000,7658310000,37390000,362300000,961600000,10787040000,37,30,81,148
1349910000,989840000,42480000,239250000,1120790000,3742270000,37,36,81,154
2454020000,7040990000,682670000,544490000,180650000,10902820000,40,29,80,149
3052510000,439080000,230510000,2086630000,4272350000,10081080000,33,31,78,142
7952710000,7485580000,233910000,1447010000,994810000,18114020000,43,39,83,165
3376160000,4643520000,1201560000,681590000,178910000,10081740000,36,30,77,143
6121750000,5.51e+08,370840000,1145350000,727290000,8916230000,36,31,80,147
464750000,4572300000,1662380000,3206230000,927300000,10832960000,39,34,81,154
1035710000,4077340000,200200000,714880000,132640000,6160770000,41,37,87,165
8908740000,1610950000,186600000,31570000,6303370000,17041230000,40,39,88,167
993830000,4972870000,300380000,246560000,2527340000,9040980000,48,38,97,183
3112140000,4900090000,675660000,625160000,294900000,9607950000,40,38,93,171
315650000,517610000,48870000,3530330000,1148640000,5561100000,40,37,98,175
4034020000,890770000,27750000,1834380000,3659370000,10446290000,42,36,87,165
2695080000,5147890000,41850000,791560000,3104270000,11780650000,42,39,100,181
172440000,1331470000,148270000,364720000,127220000,2144120000,38,39,87,164
2790820000,1531810000,231320000,456190000,495850000,5505990000,45,32,88,165
2175110000,273330000,33790000,20120000,11145970000,13648320000,39,32,85,156
4342160000,3433950000,445490000,1773220000,86760000,10081580000,38,42,84,164
1852810000,5242820000,165140000,25600000,4630670000,11917040000,41,37,95,173
4980570000,3187770000,290340000,676380000,1948380000,11083440000,45,40,104,189
5218600000,484870000,85520000,11570000,4971290000,10771850000,40,43,93,176
7483140000,216490000,35590000,41060000,6337650000,14113930000,41,36,81,158
4870370000,1988290000,638900000,420000,2010760000,9508740000,38,27,75,140
2342200000,4992360000,808940000,569220000,83160000,8795880000,48,44,100,192
2586240000,6771610000,432520000,702090000,215180000,10707640000,35,31,77,143
1963250000,1314290000,22190000,530900000,485890000,4316520000,40,39,92,171
1120130000,7253160000,240020000,311890000,5624020000,14549220000,36,32,86,154
3051750000,4442600000,513100000,764430000,372670000,9144550000,43,35,84,162
1530870000,458080000,64950000,1654540000,14120130000,17828570000,42,37,100,179
3133610000,7475010000,404150000,469100000,969110000,12450980000,42,31,81,154
1358520000,10099910000,827810000,310180000,11628170000,24224590000,40,30,85,155
3286930000,9642200000,6.04e+08,1334820000,277870000,15145820000,35,34,74,143
1287060000,8487090000,143270000,119640000,1631880000,11668940000,34,28,64,126
1072330000,2886480000,474960000,555200000,122080000,5111050000,42,38,93,173
2129080000,1693420000,87540000,847330000,117440000,4874810000,43,36,91,170
3488590000,4346670000,22190000,461360000,2444440000,10763250000,45,42,100,187
985690000,6329640000,366290000,645440000,3850850000,12177910000,46,34,93,173
2277460000,4437970000,626680000,865880000,707810000,8915800000,37,31,68,136
6757750000,106160000,24090000,3620000,3475970000,10367590000,40,36,93,169
1986260000,7214160000,303880000,1459240000,6320880000,17284420000,40,43,94,177
1947760000,2261800000,41510000,1652920000,893400000,6797390000,38,31,80,149
708100000,4011220000,383960000,196790000,3558210000,8858280000,44,43,95,182
130140000,1496150000,225270000,1532740000,5955300000,9339600000,38,37,90,165
5373780000,820140000,410250000,1626990000,955490000,9186650000,33,30,66,129
4313240000,2581610000,93450000,1800360000,1983350000,10772010000,44,40,100,184
2124480000,11055510000,1063460000,2445810000,4072390000,20761650000,34,29,81,144
4769820000,2713800000,253650000,3119470000,2793160000,13649900000,29,30,67,126
5619040000,302930000,29910000,330000,5162250000,11114460000,40,36,97,173
537400000,6853730000,111530000,18740000,1574020000,9095420000,40,33,79,152
5177180000,4569220000,443160000,1449920000,194610000,11834090000,38,39,95,172
543170000,3945980000,370740000,72520000,8.7e+07,5019410000,39,39,92,170
4027450000,3464660000,221560000,517900000,1649540000,9881110000,38,27,63,128
807170000,4999370000,853160000,3097430000,3080110000,12837240000,43,31,88,162
6843830000,3111340000,204920000,864120000,5353020000,16377230000,34,24,75,133
4207030000,181690000,67740000,0,3993200000,8449660000,43,33,91,167
4777670000,7349980000,338840000,516430000,4246590000,17229510000,41,36,92,169
3886730000,115150000,18820000,0,18992130000,23012830000,41,32,73,146
976200000,2635990000,231390000,428170000,3970580000,8242330000,31,29,66,126
2032460000,2276750000,235930000,409230000,367120000,5321490000,36,21,56,113
3040480000,889210000,218340000,29480000,4743670000,8921180000,43,37,92,172
2086710000,6281580000,571780000,302610000,3677400000,12920080000,37,30,76,143
9620080000,2488810000,551520000,168720000,6288650000,19117780000,42,41,92,175
4552660000,4621630000,602990000,860520000,80340000,10718140000,46,43,112,201
1283530000,5826010000,748750000,1861090000,362480000,10081860000,46,33,87,166
1963660000,4912370000,130650000,410090000,489300000,7906070000,43,30,82,155
6340250000,7437280000,809290000,4236140000,376700000,19199660000,44,34,75,153
14203210000,5171870000,461650000,371440000,3551540000,23759710000,33,28,57,118
3704910000,45910000,3640000,74560000,6548420000,10377440000,44,42,108,194
209250000,482960000,88890000,4154240000,615730000,5551070000,41,40,101,182
3211560000,5830630000,438860000,871060000,361210000,10713320000,40,37,94,171
2422770000,1811160000,153380000,532630000,510890000,5430830000,38,35,84,157
5776510000,917120000,122200000,68860000,11711980000,18596670000,36,34,72,142
3790330000,4131330000,342020000,602820000,204940000,9071440000,44,39,85,168
3371390000,5249040000,477070000,1271970000,338260000,10707730000,37,35,80,152
3716440000,5019680000,445390000,962460000,192910000,10336880000,39,34,85,158
3951520000,2542070000,89190000,1469500000,4304860000,12357140000,31,22,55,108
800900000,4870250000,634650000,3210180000,3040910000,12556890000,37,34,79,150
7036550000,22940000,16130000,13410000,5247760000,12336790000,38,26,67,131
3325120000,4190410000,56720000,473220000,2722780000,10768250000,42,30,84,156
6897480000,2572080000,385460000,380000,2229620000,12085020000,41,38,96,175
162140000,681200000,97880000,1962850000,2647010000,5551080000,37,38,77,152
2307480000,7248150000,193530000,567440000,406180000,10722780000,47,41,95,183
2473300000,6555890000,864840000,279060000,169430000,10342520000,33,24,54,111
3513700000,5009300000,183380000,825820000,713090000,10245290000,35,30,69,134
3189180000,10223340000,626930000,390030000,830520000,1.526e+10,39,32,84,155
525920000,4497540000,482880000,439810000,7619690000,13565840000,46,38,105,189
5167990000,4418450000,520770000,3213710000,416040000,13736960000,44,40,105,189
1735530000,3883880000,169060000,560320000,5013290000,11362080000,44,40,97,181
3837670000,6896170000,423970000,937040000,487310000,12582160000,33,36,73,142
3598790000,3302720000,142750000,678140000,714580000,8436980000,45,43,98,186
1249330000,2776610000,485960000,7523870000,2502390000,14538160000,46,41,104,191
2668980000,1129480000,174910000,842010000,530270000,5345650000,40,36,94,170
622570000,1673370000,76970000,132250000,3050920000,5556080000,41,35,94,170
4248920000,87410000,24050000,560000,20781360000,25142300000,43,45,100,188
3186160000,665090000,139130000,819930000,359340000,5169650000,39,36,92,167
4757390000,3894170000,162050000,963750000,1296490000,11073850000,36,38,77,151
8870620000,3340520000,386730000,74270000,2867840000,15539980000,32,21,54,107
374340000,7184170000,5.04e+08,338250000,353250000,8754010000,35,36,85,156
3697180000,35700000,7880000,358120000,8568330000,12667210000,42,33,93,168
2943930000,5588450000,324810000,2139530000,435580000,11432300000,41,33,80,154
4017650000,2027370000,143540000,485170000,3327930000,10001660000,44,44,102,190
617410000,10090830000,2207410000,1358430000,3504980000,17779060000,38,28,73,139
1955650000,7460840000,38880000,1408590000,3911670000,14775630000,44,44,103,191
4329100000,6725160000,301920000,1081410000,279340000,12716930000,46,37,91,174
4882070000,4257210000,139800000,636810000,430980000,10346870000,39,41,87,167
1211500000,4023550000,78150000,1154010000,13179610000,19646820000,39,41,96,176
518600000,9642030000,2392190000,3519780000,281120000,16353720000,35,31,71,137
7857590000,144900000,85750000,15440000,4573470000,12677150000,40,37,92,169
2358610000,5251100000,224840000,545530000,418390000,8798470000,41,35,86,162
3362480000,2325580000,933730000,338180000,6335680000,13295650000,40,34,92,166
5608240000,2786910000,79220000,1501050000,1093500000,11068920000,34,30,68,132
6616300000,1466100000,112190000,0,2891080000,11085670000,44,35,94,173
304500000,337990000,60730000,4232430000,5285730000,10221380000,36,31,71,138
5145530000,193740000,33180000,0,8470160000,13842610000,41,38,86,165
1227920000,5306830000,502890000,85810000,6113440000,13236890000,38,41,90,169
2363850000,2527120000,286490000,409940000,235470000,5822870000,42,33,94,169
2021440000,605220000,83530000,1980000,7171470000,9883640000,33,28,69,130
3764440000,6279730000,68450000,960750000,3401760000,14475130000,41,36,88,165
2659730000,8405530000,782010000,500500000,530300000,12878070000,44,31,97,172
4068610000,4596630000,262970000,207290000,940950000,10076450000,40,39,90,169
3259300000,4919460000,438850000,811820000,901590000,10331020000,38,35,95,168
502520000,2861690000,261390000,360290000,988900000,4974790000,43,40,100,183
4232840000,6049610000,145570000,1822840000,821820000,13072680000,35,29,78,142
4313430000,2665130000,736610000,1735830000,1229200000,10680200000,33,24,63,120
3000730000,4054910000,700080000,319130000,4671430000,12746280000,36,32,75,143
3740460000,425460000,54690000,4110000,4089820000,8314540000,42,38,97,177
2584070000,1829830000,262100000,324480000,350200000,5350680000,44,46,120,210
2460900000,1007540000,328210000,1262260000,1333940000,6392850000,41,43,100,184
3208050000,5297680000,483140000,151250000,404920000,9545040000,45,44,101,190
3684210000,3581470000,610450000,1082280000,1468890000,10427300000,37,31,89,157
605790000,4345380000,1197380000,1011580000,3737230000,10897360000,41,39,91,171
88020000,3394880000,338910000,281240000,2124230000,6227280000,46,41,89,176
1802700000,5864220000,416530000,796270000,201630000,9081350000,47,43,104,194
6124130000,190670000,30300000,0,4021190000,10366290000,41,39,106,186
4292700000,4606290000,343820000,803960000,300180000,10346950000,40,31,86,157
5027620000,2909920000,1046490000,4827530000,1305860000,15117420000,39,35,83,157
8018350000,4461150000,1054370000,1840000,8106790000,21642500000,30,29,70,129
3735420000,323820000,28790000,0,1478080000,5566110000,35,34,70,139
10259190000,49070000,33910000,5760000,6482740000,16830670000,44,46,103,193
4842980000,8967650000,615350000,794160000,294840000,15514980000,48,45,104,197
2762130000,137200000,178480000,2945310000,4053020000,10076140000,39,31,83,153
2862650000,2843340000,226360000,4188620000,336200000,10457170000,42,39,97,178
6686530000,453720000,77930000,5e+05,3670170000,10888850000,47,44,97,188
4346240000,6515930000,1213110000,1533330000,233910000,13842520000,39,35,91,165
3544270000,1058950000,80540000,1797430000,3088750000,9569940000,42,36,93,171
4147380000,3354950000,200960000,1465980000,1146860000,10316130000,41,43,93,177
2044790000,396510000,25500000,640000,7229030000,9696470000,37,31,74,142
3016790000,284620000,96670000,1247320000,524920000,5170320000,35,21,56,112
269510000,977840000,129870000,1833230000,6086640000,9297090000,42,38,103,183
994640000,5904390000,574700000,606570000,621940000,8702240000,42,32,84,158
1765210000,5395580000,854240000,577800000,511210000,9104040000,37,31,80,148
794130000,2.16e+08,33710000,1768120000,15131050000,17943010000,40,32,80,152
932710000,2478160000,173660000,3288800000,3816770000,10690100000,48,45,114,207
4632250000,4837820000,761720000,974740000,4447920000,15654450000,41,40,112,193
1580680000,4378780000,245160000,2022070000,111900000,8338590000,47,42,91,180
1336590000,8484370000,111450000,201110000,643460000,10776980000,37,34,86,157
2270280000,391660000,12800000,7e+05,10118090000,12793530000,47,42,92,181
3205540000,1061480000,308850000,1910020000,2334770000,8820660000,40,37,100,177
1106900000,2623220000,89200000,550690000,6291820000,10661830000,42,38,95,175
4415150000,2272180000,529070000,1846360000,1269110000,10331870000,42,40,95,177
1747420000,4152090000,89020000,835230000,4228850000,11052610000,43,37,93,173
5510860000,7608190000,501640000,980950000,5912590000,20514230000,38,39,87,164
2603710000,7622460000,702040000,1088230000,1217470000,13233910000,44,35,90,169
598110000,4724820000,429460000,868420000,3830330000,10451140000,31,28,54,113
1005690000,5959590000,76640000,174480000,1874540000,9090940000,42,41,93,176
3135130000,3e+05,620000,159290000,7380830000,10676170000,41,32,81,154
8611820000,2605450000,271560000,984040000,3017260000,15490130000,40,44,99,183
697370000,3011930000,612520000,643510000,142810000,5108140000,32,30,69,131
636260000,4102680000,415950000,1942410000,482860000,7580160000,34,35,82,151
2093470000,6853710000,327480000,628440000,1082790000,10985890000,41,45,97,183
3925860000,4507860000,129860000,1839070000,310580000,10713230000,41,41,101,183
216620000,7.03e+08,426170000,5984870000,6506910000,13837570000,45,38,95,178
1947940000,571520000,101860000,1070820000,4453980000,8146120000,46,44,99,189
59470000,719770000,204390000,1971580000,6029920000,8985130000,35,28,64,127
7058530000,3245130000,523180000,1330000,5308190000,16136360000,40,36,85,161
5558340000,3638670000,664640000,952350000,1261970000,12075970000,47,41,98,186
2705010000,1643460000,401410000,2234110000,3101640000,10085630000,38,27,77,142
3903750000,5109330000,538970000,716260000,715420000,10983730000,40,34,88,162
2140770000,1026950000,574650000,330810000,6073370000,10146550000,45,35,92,172
1892330000,2475890000,526960000,221700000,48410000,5165290000,42,34,85,161
4038480000,9085410000,73910000,1551640000,4320680000,19070120000,43,32,91,166
2505460000,6725780000,680370000,207150000,266510000,10385270000,42,35,95,172
4408940000,4495740000,357250000,814740000,260720000,10337390000,46,39,103,188
2759100000,6117300000,594580000,518600000,91770000,10081350000,40,37,88,165
7484980000,1152820000,229730000,0,3106660000,11974190000,36,28,77,141
13223820000,2047950000,373640000,257920000,4899650000,20802980000,48,42,112,202
5675560000,69330000,17060000,4950000,4188540000,9955440000,39,40,94,173
3711550000,3950050000,1315660000,928160000,446580000,1.0352e+10,43,42,99,184
703010000,9228950000,2323830000,2464670000,141910000,14862370000,41,31,90,162
775520000,6270210000,522390000,5307160000,2350530000,15225810000,39,32,78,149
75930000,1010070000,128930000,51340000,3368280000,4634550000,43,38,96,177
2235250000,100600000,69610000,25480000,2954790000,5385730000,40,33,83,156
1448700000,5965900000,1877310000,1351450000,516150000,11159510000,41,37,83,161
304830000,1205320000,90080000,1985900000,1954910000,5541040000,34,34,90,158
6166720000,2874680000,195900000,1485260000,2041540000,12764100000,31,31,65,127
2071260000,5497990000,286600000,2450370000,156520000,10462740000,37,36,83,156
1468220000,5658080000,620340000,986400000,338030000,9071070000,34,27,66,127
500430000,10477500000,716320000,680240000,5951740000,18326230000,41,35,84,160
2774280000,2160940000,416140000,117950000,2988530000,8457840000,42,35,90,167
1667270000,353380000,22350000,3330000,8040590000,10086920000,44,45,100,189
1992500000,7492820000,80700000,109730000,2899410000,12575160000,41,37,92,170
3330350000,6454480000,137300000,144540000,4592660000,14659330000,52,47,121,220
552070000,2773800000,479710000,3728500000,2547570000,10081650000,39,32,89,160
97650000,843320000,55730000,93320000,3834700000,4924720000,42,39,97,178
2833490000,5829340000,1101930000,555860000,382050000,10702670000,37,34,75,146
2059310000,958060000,31190000,550190000,1756920000,5355670000,42,32,80,154
2748990000,3.314e+09,282870000,812760000,2641080000,9799700000,41,34,85,160
770130000,5195680000,2520850000,1946600000,3454530000,13887790000,43,38,99,180
3303330000,4698480000,419180000,757570000,1153290000,10331850000,35,33,81,149
3650530000,3767290000,191470000,2711220000,137150000,10457660000,36,31,72,139
3428520000,3917250000,187160000,1791180000,13134280000,22458390000,41,33,89,163
8206730000,5943160000,1215090000,3034460000,463190000,18862630000,36,35,82,153
2028820000,1398340000,47050000,1109130000,937680000,5521020000,43,40,101,184
3124450000,7337910000,69410000,70920000,440710000,11043400000,35,33,82,150
5337810000,479790000,56960000,0,2874920000,8749480000,36,34,75,145
2300610000,7807420000,554040000,3437640000,137850000,14237560000,37,29,71,137
2788790000,4372630000,143670000,705480000,905290000,8915860000,35,32,74,141
3524570000,2982180000,110090000,2952950000,872830000,10442620000,47,41,104,192
6038880000,230500000,23260000,7950000,2546320000,8846910000,36,33,76,145
1822220000,91940000,20780000,2844410000,10616710000,15396060000,44,36,97,177
2530670000,195820000,25270000,66690000,12579920000,15398370000,36,33,69,138
671890000,5077900000,310220000,51460000,3003940000,9115410000,41,37,95,173
3767170000,4989920000,232240000,1082600000,275610000,10347540000,43,40,109,192
3281870000,2908330000,747260000,2051750000,1091810000,10081020000,35,27,62,124
8484970000,3982240000,384530000,170220000,5912970000,18934930000,34,28,61,123
3794950000,4047580000,478570000,446790000,148080000,8915970000,40,42,92,174
7909130000,507520000,211060000,16350000,4220070000,12864130000,34,36,78,148
4183480000,4062820000,210620000,1789820000,204540000,10451280000,32,32,70,134
146470000,315400000,29680000,993030000,6029010000,7513590000,42,35,84,161
6064310000,10550000,13240000,89210000,17967240000,24144550000,42,44,102,188
3746420000,2147960000,347110000,17430000,7059740000,13318660000,46,43,104,193
2428220000,4036990000,120620000,393610000,6465440000,13444880000,41,40,102,183
446570000,3697120000,554830000,2830340000,2584420000,10113280000,43,34,90,167
4645080000,4123620000,404860000,1061460000,102480000,10337500000,40,37,88,165
5182500000,6722040000,613430000,1032320000,3807210000,17357500000,38,31,78,147
2573920000,3155850000,311830000,464630000,3240630000,9746860000,39,31,73,143
3836880000,345080000,106500000,16610000,6079550000,10384620000,42,34,87,163
538670000,1396580000,316870000,3831110000,2799280000,8882510000,31,27,66,124
2296650000,3692390000,799930000,34400000,3587980000,10411350000,41,38,92,171
4301220000,5236750000,708500000,9791410000,413850000,20451730000,34,31,66,131
4691670000,1479570000,128220000,3e+05,12514540000,18814300000,45,44,107,196
4348340000,1963920000,479110000,2669020000,766610000,1.0227e+10,43,40,99,182
4039490000,3727700000,544250000,1618180000,516810000,10446430000,35,35,77,147
11431180000,2.4e+07,15380000,560000,10459990000,21931110000,35,29,77,141
1436630000,1807490000,125250000,350780000,2689240000,6409390000,39,36,94,169
5289420000,5917100000,1609850000,728230000,288220000,13832820000,42,39,89,170
1114730000,8843350000,547080000,1557280000,745120000,12807560000,41,36,82,159
1316680000,160070000,22310000,460000,5984190000,7483710000,42,31,79,152
3454360000,2189880000,283040000,381840000,2139550000,8448670000,39,34,77,150
5719370000,11929770000,1396980000,1029970000,380400000,20456490000,41,35,85,161
4939560000,223190000,209010000,2764210000,2190080000,10326050000,40,33,79,152
2348680000,9400690000,1436970000,2213060000,295990000,15695390000,36,34,88,158
1655390000,6648810000,925310000,405850000,700820000,10336180000,43,41,97,181
62040000,2089690000,129930000,0,3395890000,5677550000,38,35,87,160
913210000,4466290000,664330000,2655300000,279320000,8978450000,43,39,95,177
1183940000,4345150000,153110000,390890000,240250000,6313340000,31,25,70,126
1681970000,9062170000,1004570000,498470000,626140000,12873320000,38,31,69,138
3885640000,3188630000,231200000,1261340000,2211470000,10778280000,41,34,88,163
3559950000,1796510000,67230000,307440000,5129530000,10860660000,41,39,86,166
5800750000,14290000,2420000,350000,3380800000,9198610000,38,31,80,149
4015070000,2234830000,187120000,3348860000,661670000,10447550000,42,40,96,178
1973840000,440590000,207340000,9842360000,6538620000,19002750000,37,30,80,147
2608720000,7874630000,83230000,41130000,8844890000,19452600000,44,41,101,186
124810000,679030000,647080000,2088260000,6123450000,9662630000,37,38,81,156
2837170000,6436010000,583650000,634580000,206660000,10698070000,40,38,85,163
6836140000,1026130000,111080000,0,3130630000,11103980000,45,34,100,179
5546170000,13010000,15780000,23850000,5179410000,10778220000,43,38,86,167
1778620000,7809290000,406510000,256700000,206490000,10457610000,43,37,98,178
3376420000,8946200000,671350000,784990000,110580000,13889540000,32,29,71,132
2044610000,4041330000,393600000,343660000,3395980000,10219180000,43,38,89,170
2031390000,2044040000,336840000,384620000,242930000,5039820000,43,45,119,207
1919590000,8131160000,99140000,2449350000,3934870000,16534110000,38,35,98,171
7734390000,803970000,201270000,0,2685690000,11425320000,36,28,68,132
3085800000,2858030000,232860000,447460000,3645730000,10269880000,46,34,89,169
3810880000,4894980000,340290000,293600000,2125850000,11465600000,40,36,80,156
10093350000,483220000,148030000,15020000,5023960000,15763580000,42,36,92,170
1820710000,4847760000,135440000,509920000,8632280000,15946110000,31,31,69,131
3745380000,1.058e+09,35520000,2170000,8564250000,13405320000,43,40,105,188
2824110000,4094680000,530010000,315600000,1145820000,8910220000,41,34,85,160
241990000,4802700000,364510000,1006830000,3665510000,10081540000,41,39,91,171
1052910000,6890910000,513440000,58700000,274240000,8790200000,43,38,96,177
2836270000,5496230000,218530000,1486980000,414130000,10452140000,43,32,85,160
5634850000,138250000,14300000,0,5336600000,1.1124e+10,40,31,88,159
899030000,468160000,35380000,107820000,146120000,1656510000,42,29,82,153
2825120000,927700000,557640000,3138670000,2627280000,10076410000,39,33,81,153
3689020000,383110000,25840000,51730000,8412750000,12562450000,38,28,81,147
6429600000,187930000,51650000,2600000,4561360000,11233140000,49,48,123,220
4939200000,6603030000,413680000,430960000,12584720000,24971590000,41,32,81,154
5482800000,1077020000,992900000,1705860000,3298810000,12557390000,44,42,95,181
1122040000,2302760000,1.253e+09,1454560000,3183800000,9316160000,36,32,73,141
2834200000,3248960000,260950000,636970000,3177640000,10158720000,41,33,83,157
4294420000,1954680000,190940000,68560000,5491720000,12000320000,44,42,93,179
1297040000,7822900000,157640000,592460000,146700000,10016740000,47,41,92,180
4967300000,3931730000,428090000,936200000,429320000,10692640000,34,41,91,166
699430000,1728440000,353970000,582980000,182690000,3547510000,33,35,88,156
1429910000,7646020000,441560000,458950000,700420000,10676860000,41,34,92,167
8725460000,29690000,13180000,0,6018010000,14786340000,32,29,66,127
604160000,1610280000,162800000,524140000,142550000,3043930000,44,40,97,181
4082460000,7337550000,1233910000,847440000,642580000,14143940000,42,27,82,151
3915670000,2655430000,92840000,92270000,2430320000,9186530000,43,43,102,188
655370000,82060000,20740000,101970000,52990000,913130000,38,39,89,166
1881900000,7252520000,628380000,815220000,134660000,10712680000,42,37,85,164
450690000,5868990000,97370000,1804560000,1279840000,9501450000,45,37,98,180
2679050000,5945930000,268510000,1666110000,153090000,10712690000,36,37,96,169
4862810000,5994060000,1193240000,2590140000,304830000,14945080000,38,25,62,125
2253730000,6399070000,537480000,943660000,318200000,10452140000,35,30,72,137
62340000,42500000,3810000,49770000,1273120000,1431540000,45,41,111,197
3620160000,4813870000,530580000,818140000,559580000,10342330000,45,36,92,173
4139310000,6289460000,751440000,845450000,650940000,12676600000,41,38,94,173
8886450000,1232650000,284170000,1400000,3438260000,13842930000,40,33,86,159
9116200000,7253280000,531190000,2268400000,1477320000,20646390000,40,39,91,170
1636620000,8962030000,738640000,4604870000,165710000,16107870000,45,44,103,192
6341730000,1808810000,372120000,1016780000,792870000,10332310000,39,37,96,172
1493290000,3616210000,734630000,101460000,3226280000,9171870000,36,27,73,136
86530000,1047480000,439790000,2922410000,1044850000,5541060000,42,40,95,177
4836280000,1483750000,194390000,450000,6568190000,13083060000,42,42,102,186
2138130000,2239130000,78370000,319550000,4236180000,9011360000,44,34,82,160
7762920000,3567950000,194910000,2844980000,11700550000,26071310000,46,46,121,213
198340000,471940000,65960000,3790140000,1059770000,5586150000,40,36,83,159
9314420000,249310000,24900000,44410000,5911880000,15544920000,39,36,86,161
1286340000,2843790000,169590000,637490000,238120000,5175330000,42,38,89,169
469370000,3315650000,17440000,208730000,1399610000,5410800000,42,40,86,168
2242160000,4561110000,304240000,1259290000,403640000,8770440000,39,30,80,149
4837030000,2618670000,287130000,3481440000,6443880000,17668150000,44,39,92,175
566230000,1954650000,78430000,106670000,2674780000,5380760000,35,30,74,139
3598700000,5342020000,576590000,453490000,110460000,10081260000,44,44,110,198
2452420000,1080390000,92450000,422250000,74870000,4122380000,49,43,113,205
2613670000,6038550000,862990000,964150000,233930000,10713290000,43,34,89,166
2449120000,556480000,104740000,1389960000,4122120000,8622420000,39,33,76,148
1108880000,481720000,26830000,253510000,5264910000,7135850000,29,30,67,126
5045230000,5670850000,1951020000,2108970000,270380000,15046450000,33,39,75,147
3838680000,5239110000,232580000,814890000,4472870000,14598130000,36,31,77,144
2973370000,4020380000,259320000,1249950000,1849570000,10352590000,39,39,87,165
588250000,11231460000,962880000,801910000,810260000,14394760000,31,22,50,103
2448060000,1370240000,84580000,322710000,5800240000,10025830000,37,29,77,143
2033500000,7355820000,339830000,625140000,425260000,10779550000,43,39,98,180
2232420000,6404610000,327690000,1273610000,2.18e+08,10456330000,43,37,95,175
1275720000,3.081e+09,475270000,160250000,47820000,5040060000,34,32,75,141
7307090000,603600000,78660000,0,3104510000,11093860000,46,42,102,190
9575240000,2452080000,179870000,0,4260590000,16467780000,42,30,99,171
4041020000,5249800000,158040000,560600000,330110000,10339570000,39,38,95,172
4614070000,757270000,94310000,5490000,4620580000,10091720000,41,37,92,170
1836700000,1416540000,168480000,2610200000,8553190000,14585110000,43,38,94,175
355120000,1178500000,125540000,3004210000,1764100000,6427470000,34,24,56,114
1495430000,8553590000,846390000,1623070000,6044220000,18562700000,36,34,86,156
1270260000,6720490000,601330000,1738980000,362050000,10693110000,37,32,79,148
2578960000,1529010000,1052200000,7598240000,6316030000,19074440000,46,35,81,162
3522960000,4729560000,337630000,1840640000,6196890000,16627680000,42,38,98,178
3848560000,6015480000,125360000,1017990000,3717950000,14725340000,37,27,72,136
2490920000,4738880000,302530000,836680000,1487470000,9856480000,45,38,95,178
1597640000,3569160000,23490000,858840000,3335570000,9384700000,39,36,86,161
1294080000,9726100000,629590000,215960000,6014490000,17880220000,46,39,95,180
3779930000,2846060000,368420000,504250000,2744730000,10243390000,47,35,104,186
1218550000,4687900000,374690000,1197460000,2654600000,10133200000,44,43,111,198
1425170000,4640240000,659310000,1918850000,2497290000,11140860000,33,32,74,139
731300000,6574500000,143750000,422380000,2455410000,10327340000,32,31,77,140
1843190000,1268950000,198100000,173710000,9202370000,12686320000,33,31,75,139
3682370000,10381510000,2058320000,436070000,965420000,17523690000,42,36,89,167
2433050000,3560410000,267030000,635270000,141180000,7036940000,43,29,89,161
77600000,223170000,9790000,757220000,4518370000,5586150000,38,35,98,171
3445810000,3358420000,452410000,2474550000,512030000,10243220000,41,36,90,167
3954890000,396660000,215910000,2537630000,3309470000,10414560000,37,34,87,158
3860430000,3222140000,560600000,1079640000,77940000,8800750000,38,34,82,154
3.977e+09,1994930000,234160000,290000,4551870000,10758250000,43,36,91,170
12979720000,47056190000,3940390000,3673340000,15861610000,83511250000,49,41,111,201
18252390000,44370000,74430000,71380000,22391040000,40833610000,46,41,107,194
7889940000,17757640000,1158070000,3140380000,673180000,30619210000,43,41,96,180
11249550000,25950490000,2179620000,3140070000,19627740000,62147470000,46,41,108,195
14467220000,16073880000,889780000,5761140000,7276870000,44468890000,34,30,72,136
6624020000,3910230000,701050000,2530270000,966510000,14732080000,47,41,109,197
26602940000,3328490000,389940000,17370000,25220230000,55558970000,40,37,98,175
14453680000,12247990000,1511530000,3734980000,16746550000,48694730000,52,45,107,204
23701170000,29695050000,3491340000,6606400000,1308610000,64802570000,44,41,107,192
2629180000,17832220000,1703660000,2465690000,20455610000,45086360000,42,42,103,187
7046920000,23899250000,585360000,603430000,15256210000,47391170000,46,43,102,191
6234370000,22840420000,266060000,7838680000,12884070000,50063600000,39,42,90,171
1327190000,12482570000,3609990000,10865700000,10308760000,38594210000,45,46,111,202
42138920000,1911300000,464080000,104780000,27167820000,71786900000,45,37,93,175
12553310000,21040810000,1049280000,3421950000,2856220000,40921570000,58,54,140,252
6057670000,90150000,25880000,0,18960830000,25134530000,47,45,109,201
18192600000,33952200000,4296330000,4746320000,1021120000,62208570000,47,39,102,188
14308710000,17455830000,470130000,3614500000,10264720000,46113890000,39,32,76,147
19438930000,17723870000,3474940000,7686710000,16075140000,64399590000,47,47,112,206
14545070000,24278100000,1089230000,6188150000,27235840000,73336390000,47,38,99,184
16096090000,17989540000,1355830000,9545250000,5144950000,50131660000,46,37,96,179
1886260000,6203470000,316010000,702740000,8989940000,18098420000,48,34,94,176
10668150000,25332160000,2570810000,6417620000,12682610000,57671350000,50,45,110,205
3948370000,4481880000,1551320000,17403390000,15409960000,42794920000,51,46,107,204
19836150000,386380000,84690000,1990000,14415360000,34724570000,46,44,104,194
1073990000,18470920000,3654780000,5724590000,382360000,29306640000,40,39,91,170
14612230000,26394920000,1295870000,2278810000,2692530000,47274360000,44,42,104,190
5526010000,24089840000,2113010000,14369010000,8065630000,54163500000,43,37,101,181
15953320000,3064300000,215240000,217130000,39525390000,58975380000,41,37,91,169
8399540000,16675520000,935210000,2831400000,13659910000,42501580000,45,47,112,204
9971240000,20754870000,443670000,4315910000,13260070000,48745760000,46,38,104,188
23061440000,4780810000,868370000,1070000,13556330000,42268020000,46,43,112,201
6023320000,15542750000,324220000,340870000,8485340000,30716500000,44,40,100,184
18666140000,34312680000,3847020000,4151940000,1.784e+09,62761780000,52,46,116,214
20165620000,24365510000,2298490000,5248050000,7105670000,59183340000,36,36,83,155
12999100000,20629010000,1389910000,16914900000,1247280000,53180200000,38,38,93,169
3795160000,16105500000,2501030000,2976560000,2196550000,27574800000,47,42,110,199
15004570000,30559100000,4133580000,2318430000,2064720000,54080400000,46,36,87,169
15615720000,30357400000,1869260000,8239470000,1328400000,57410250000,45,41,106,192
16683600000,26444690000,1698980000,1912490000,11568400000,58308160000,50,48,123,221
28208530000,10173810000,1799730000,367480000,20096220000,60645770000,51,43,99,193
22307950000,27631250000,4480510000,5140540000,2851540000,62411790000,46,40,97,183
16244370000,24172920000,1530330000,3756810000,13283380000,58987810000,44,33,91,168
11127530000,17491890000,1390060000,2733840000,9299920000,42043240000,48,40,91,179
11522930000,24662670000,1265740000,1990870000,28498250000,67940460000,53,47,124,224
9532030000,15367950000,823280000,2502490000,2236170000,30461920000,49,41,108,198
11227150000,23299910000,863040000,2922140000,7984480000,46296720000,43,49,122,214
24398510000,789190000,312040000,137190000,20286750000,45923680000,46,41,111,198
5143110000,30835850000,2692220000,9768630000,5579020000,54018830000,51,50,126,227
21614780000,1132580000,110460000,330000,15244080000,38102230000,47,45,116,208
24062490000,71310000,41600000,1020000,15027550000,39203970000,48,40,111,199
19367610000,11821650000,724910000,2738380000,27069440000,61721990000,51,50,130,231
946490000,4264410000,698250000,13878200000,5084150000,24871500000,55,58,138,251
19777700000,39362580000,3024430000,5155700000,4283450000,71603860000,41,41,100,182
25546650000,22279460000,5883520000,7645010000,1096880000,62451520000,43,40,102,185
2966460000,26907550000,2116550000,3292600000,28246330000,63529490000,41,41,113,195
21586990000,4462550000,509650000,30220000,17864600000,44454010000,45,42,99,186
16179410000,30772460000,3567210000,2132730000,10737070000,63388880000,50,46,118,214
1276820000,2119030000,579690000,13058740000,19672990000,36707270000,46,38,100,184
21552640000,12029700000,3379650000,14789150000,13418350000,65169490000,52,46,117,215
16627900000,18587190000,811210000,3932640000,8962320000,48921260000,42,40,95,177
21772800000,9771240000,1793880000,3100000,16482200000,49823220000,46,42,106,194
29864940000,11203960000,2007690000,1206240000,27216730000,71499560000,43,43,101,187
15918290000,34298520000,3793310000,4768710000,1770850000,60549680000,50,34,89,173
8075620000,805460000,97050000,236620000,32697440000,41912190000,43,45,102,190
19060550000,456430000,72350000,761540000,44800650000,65151520000,43,39,97,179
9971630000,13475950000,1197210000,383040000,9971890000,34999720000,43,34,91,168
18243090000,8465980000,649550000,8483160000,21327630000,57169410000,50,43,117,210
1965900000,904430000,126160000,2773730000,20102250000,25872470000,51,47,104,202
1006670000,2837930000,327310000,11666160000,15662950000,31501020000,51,40,93,184
27743330000,6427710000,695210000,290000,14311470000,49178010000,51,42,108,201
5109820000,28199990000,4089620000,14187770000,12736810000,64324010000,49,44,112,205
17511980000,11016250000,2277040000,5493510000,20758970000,57057750000,49,46,115,210
9678410000,31058240000,1189870000,4025860000,10534520000,56486900000,48,38,105,191
1892460000,8482190000,1711810000,11343920000,25373350000,48803730000,47,43,116,206
2603870000,16210430000,351920000,371770000,10771500000,30309490000,44,42,109,195
4818220000,17016120000,384890000,534870000,9681290000,32435390000,51,46,118,215
5487780000,24976210000,334580000,2905740000,8420860000,42125170000,50,46,112,208
29003380000,10538400000,1304320000,648680000,17233560000,58728340000,42,30,68,140
494770000,2007290000,88150000,3611740000,16983110000,23185060000,49,45,109,203
20818760000,18720210000,2169340000,4562170000,2090870000,48361350000,48,43,100,191
15756920000,20860120000,1227760000,3630680000,16677950000,58153430000,46,43,115,204
20957190000,21745070000,1939520000,3866540000,3424540000,51932860000,48,35,103,186
2401850000,20757480000,4700510000,3398490000,17055880000,48314210000,52,50,131,233
32526800000,3544540000,406750000,510000,15651530000,52130130000,45,41,101,187
10510480000,12606960000,610620000,3662940000,18024210000,45415210000,48,45,106,199
27796470000,10338920000,1817210000,6969270000,13964670000,60886540000,51,45,108,204
8334610000,14123820000,615350000,830350000,15477600000,39381730000,50,43,109,202
2627060000,6579160000,2109450000,19047530000,17405450000,47768650000,48,43,117,208
6872930000,24355710000,10495870000,12290110000,11253680000,65268300000,45,39,103,187
16631810000,17319190000,1945560000,5030990000,2537300000,43464850000,46,37,105,188
20155200000,1170100000,64880000,355020000,43868300000,65613500000,48,46,112,206
24040380000,18338880000,3892840000,10450220000,4042030000,60764350000,49,47,109,205
8349740000,27509790000,3032490000,3939560000,3208200000,46039780000,43,47,111,201
10258580000,2203550000,254900000,29740000,43262530000,56009300000,43,37,94,174
11073160000,26780540000,2593080000,7457960000,1791740000,49696480000,48,46,111,205
8186130000,127830000,19440000,560000,27170910000,35504870000,51,47,108,206
4116840000,2265930000,354820000,7037670000,27040160000,40815420000,45,40,92,177
23490330000,12519600000,2564320000,8886350000,3599920000,51060520000,44,41,100,185
44931500000,1572280000,310170000,92580000,33222990000,80129520000,52,46,122,220
13212780000,16819460000,1601150000,2477610000,965910000,35076910000,45,44,111,200
17143640000,32308040000,2534070000,8903230000,1037800000,61926780000,44,36,95,175
19055020000,13165990000,346420000,6118090000,5465560000,44151080000,45,40,85,170
31584820000,4025710000,514280000,54310000,11533680000,47712800000,50,44,106,200
20160910000,17514780000,3250850000,16730480000,3400910000,61057930000,46,40,99,185
11309220000,2318810000,450330000,199730000,35015910000,4.9294e+10,49,42,101,192
13383090000,34166150000,2100580000,4293560000,1472970000,55416350000,48,49,124,221
16598840000,2979900000,906170000,16980000,13291890000,33793780000,44,39,93,176
5568480000,14887780000,698930000,2688830000,41545900000,65389920000,46,40,113,199
18163120000,16179160000,2603620000,9842680000,4785960000,51574540000,50,44,102,196
8.839e+09,37772830000,6911710000,6486970000,3943360000,63953870000,51,46,107,204
20103740000,21198650000,3012370000,10343670000,1533640000,56192070000,49,43,109,201
45552010000,76964660000,5114450000,12979250000,113810800000,254421170000,39,32,76,147
25752790000,76401600000,2405620000,9072170000,45963220000,159595400000,53,48,123,224
63636040000,77643910000,7551010000,11156040000,110166770000,270153770000,54,49,128,231
10726140000,12892840000,2930920000,34294920000,89032200000,149877020000,55,48,121,224
50690410000,66128600000,3032810000,14661870000,24989870000,159503560000,55,52,138,245
71803050000,137212210000,10094180000,22984150000,12625160000,254718750000,55,53,141,249
78848280000,117358830000,13163640000,19204110000,7835760000,236410620000,56,51,122,229
27938680000,64761570000,1886590000,9764200000,33957570000,138308610000,47,48,119,214
64005330000,103331530000,19494320000,29079820000,8002310000,223913310000,51,52,128,231
146348330000,29746700000,4147420000,885140000,171013460000,352141050000,56,50,131,237
111171220000,2017630000,519540000,1329840000,177210270000,292248500000,44,51,124,219
3426540000,12250980000,1757610000,46023050000,54336140000,117794320000,60,58,142,260
35707130000,60230100000,3391310000,10567640000,43006130000,152902310000,53,49,126,228
83509560000,82463140000,14033650000,32092930000,43483200000,255582480000,59,54,137,250
71776630000,137392540000,12046110000,17242780000,40761780000,279219840000,61,53,135,249
116393540000,15440570000,1931690000,82510000,86277610000,220125920000,56,55,134,245
8855940000,63060090000,14482920000,45636040000,64211670000,196246660000,56,54,141,251
40015580000,62672780000,4038890000,30256190000,15098860000,152082300000,52,50,120,222
22064890000,42266530000,1920400000,9162460000,79390140000,154804420000,53,43,100,196
58695850000,48150900000,9369650000,29433930000,42942210000,188592540000,60,54,144,258
70643160000,29715890000,4271470000,3200150000,97838050000,205668720000,47,34,76,157
117118450000,6961840000,912120000,974730000,158796340000,284763480000,56,49,132,237
16416220000,74881850000,7069730000,24592340000,42695990000,165656130000,52,45,124,221
52150140000,105182090000,21305670000,34496930000,26555380000,239690210000,55,43,103,201
13484400000,60171910000,1661450000,1636980000,46311300000,123266040000,57,53,142,252
82989450000,102693540000,13498080000,31558210000,12629410000,243368690000,56,46,120,222
25640220000,41443270000,1791280000,9993570000,41198980000,120067320000,55,53,125,233
85783680000,117453870000,11665590000,17811370000,15942080000,248656590000,53,45,119,217
224854720000,358063880000,31267010000,63833200000,110523690000,788542500000,68,65,164,297
314414020000,369098820000,58055750000,136642910000,139369270000,1017580770000,61,59,148,268
154548050000,353508480000,14451970000,55427320000,243148770000,821084590000,63,55,143,261
224359170000,86572970000,11116500000,8285710000,319994520000,650328870000,66,66,165,297
265348140000,434952650000,37549460000,86335080000,314102970000,1138288300000,64,58,156,278
361810540000,43721750000,6.134e+09,4195510000,431872950000,847734750000,63,59,150,272
45518440000,199947750000,38280870000,163805950000,299891630000,747444640000,66,56,146,268
1547170170000,1789055420000,186008970000,503170950000,1976576460000,6001981970000,92,90,235,417
