"Forest","Agriculture","Other","Area_Total","natural_sp","human_dominated_sp","Sp_Total"
147070000,292150000,2050920000,2490140000,26,85,111
172980000,395020000,1630040000,2198040000,29,76,105
175890000,1257450000,1066660000,2.5e+09,32,88,120
619460000,781250000,1099290000,2.5e+09,25,79,104
565210000,517030000,1417760000,2.5e+09,31,92,123
248050000,1979790000,272160000,2.5e+09,27,81,108
991010000,445190000,1063800000,2.5e+09,31,80,111
597140000,1807380000,95480000,2.5e+09,29,88,117
469440000,1897980000,132580000,2.5e+09,29,86,115
597850000,1300620000,601530000,2.5e+09,32,80,112
719640000,1444340000,336020000,2.5e+09,34,86,120
1221380000,659120000,619500000,2.5e+09,25,74,99
1340190000,1046150000,113660000,2.5e+09,32,86,118
922150000,855170000,722680000,2.5e+09,31,78,109
1456990000,358370000,684640000,2.5e+09,27,74,101
148730000,854620000,1496650000,2.5e+09,32,95,127
845680000,604670000,1049650000,2.5e+09,30,93,123
414280000,744400000,1341320000,2.5e+09,36,92,128
439840000,1858190000,201970000,2.5e+09,30,83,113
466820000,1356390000,676790000,2.5e+09,33,95,128
380550000,2010980000,108470000,2.5e+09,28,81,109
122230000,1766120000,611650000,2.5e+09,36,104,140
786170000,983310000,730520000,2.5e+09,30,86,116
484080000,1091590000,924330000,2.5e+09,33,111,144
50250000,783370000,1666380000,2.5e+09,45,109,154
15130000,55280000,1668920000,1739330000,33,95,128
688730000,741300000,1069970000,2.5e+09,32,98,130
505860000,1099070000,895070000,2.5e+09,20,62,82
283010000,1637100000,579890000,2.5e+09,30,84,114
64010000,904160000,1531830000,2.5e+09,35,99,134
133870000,1985160000,380970000,2.5e+09,33,102,135
96380000,1353660000,1049960000,2.5e+09,34,103,137
219170000,163890000,1886850000,2269910000,17,52,69
462900000,289980000,1631840000,2384720000,27,63,90
594330000,1031150000,874520000,2.5e+09,20,63,83
1017820000,635340000,846840000,2.5e+09,26,66,92
748630000,529020000,1222350000,2.5e+09,27,78,105
616790000,665380000,1217830000,2.5e+09,33,75,108
602590000,694890000,1202520000,2.5e+09,27,86,113
445530000,474580000,1579890000,2.5e+09,33,92,125
771040000,1126010000,602950000,2.5e+09,23,75,98
993420000,751790000,754790000,2.5e+09,27,76,103
632550000,1133560000,733890000,2.5e+09,25,63,88
481470000,784390000,1234140000,2.5e+09,26,77,103
5.1e+08,769190000,1220810000,2.5e+09,35,107,142
367300000,1209360000,923340000,2.5e+09,27,71,98
401060000,9.86e+08,1112940000,2.5e+09,26,77,103
240340000,1373610000,886050000,2.5e+09,33,95,128
117380000,1164760000,1217860000,2.5e+09,38,107,145
398500000,721480000,1380020000,2.5e+09,29,93,122
363420000,1231180000,905400000,2.5e+09,32,99,131
286230000,1301070000,912700000,2.5e+09,33,97,130
443140000,1173540000,883320000,2.5e+09,25,78,103
932070000,543190000,1024740000,2.5e+09,31,91,122
858840000,549600000,1091560000,2.5e+09,23,65,88
606810000,682430000,1210760000,2.5e+09,34,109,143
303540000,1296320000,900140000,2.5e+09,31,99,130
220280000,1427780000,851940000,2.5e+09,38,118,156
666910000,1084110000,748980000,2.5e+09,32,95,127
582370000,136120000,1781510000,2.5e+09,27,79,106
1120680000,441330000,937990000,2.5e+09,30,87,117
5310000,35110000,1799620000,1840040000,30,73,103
58030000,57560000,2221560000,2337150000,29,71,100
37110000,112050000,2350840000,2.5e+09,34,77,111
27670000,84540000,2387790000,2.5e+09,21,60,81
119890000,190870000,2189240000,2.5e+09,23,49,72
32620000,163980000,2303400000,2.5e+09,32,70,102
23120000,113910000,2356180000,2493210000,31,62,93
112360000,353130000,2034510000,2.5e+09,29,69,98
36010000,117270000,2282530000,2435810000,34,78,112
70190000,171530000,2258280000,2.5e+09,28,72,100
173250000,328050000,1998700000,2.5e+09,29,69,98
184890000,326790000,1988320000,2.5e+09,31,72,103
10730000,71200000,2256140000,2338070000,33,81,114
185500000,543890000,1770610000,2.5e+09,29,64,93
35240000,442590000,2022170000,2.5e+09,23,54,77
86140000,3.86e+08,2007460000,2479600000,30,61,91
39890000,143120000,2316990000,2.5e+09,28,58,86
134840000,317640000,2047520000,2.5e+09,26,56,82
121150000,308250000,2070600000,2.5e+09,28,58,86
28230000,101980000,2369790000,2.5e+09,27,69,96
106350000,117800000,2275850000,2.5e+09,25,59,84
33710000,159810000,2306480000,2.5e+09,28,72,100
41040000,161160000,2247530000,2449730000,31,77,108
64280000,106160000,2329560000,2.5e+09,33,73,106
365890000,1479860000,654250000,2.5e+09,37,101,138
239430000,421440000,1839130000,2.5e+09,32,76,108
70130000,664930000,1764940000,2.5e+09,29,71,100
53260000,288930000,2157810000,2.5e+09,27,65,92
25630000,615480000,1858890000,2.5e+09,31,74,105
131530000,2240000,2366230000,2.5e+09,32,78,110
279420000,1510530000,710050000,2.5e+09,37,114,151
177720000,1765650000,556630000,2.5e+09,27,85,112
350550000,1022860000,1126590000,2.5e+09,31,101,132
48390000,1637350000,814260000,2.5e+09,35,106,141
314940000,1306160000,878900000,2.5e+09,34,115,149
305690000,1269610000,924700000,2.5e+09,27,98,125
104330000,64350000,1905610000,2074290000,23,73,96
114180000,1325100000,1060720000,2.5e+09,31,106,137
20010000,2390150000,89840000,2.5e+09,31,90,121
98340000,1959360000,442300000,2.5e+09,31,100,131
484810000,1199410000,815780000,2.5e+09,29,72,101
461670000,762440000,1275890000,2.5e+09,30,90,120
316930000,922020000,1261050000,2.5e+09,33,100,133
182410000,1916400000,401190000,2.5e+09,34,100,134
225940000,778480000,1495580000,2.5e+09,32,97,129
136790000,750710000,1612500000,2.5e+09,31,90,121
243730000,1931720000,324550000,2.5e+09,26,76,102
177050000,1994850000,328100000,2.5e+09,32,90,122
244300000,1492620000,763080000,2.5e+09,29,96,125
486270000,918480000,1095250000,2.5e+09,26,93,119
115310000,1762410000,622280000,2.5e+09,34,87,121
16930000,2052630000,430440000,2.5e+09,30,90,120
58830000,457090000,1984080000,2.5e+09,34,98,132
498960000,1372050000,628990000,2.5e+09,27,94,121
580420000,709350000,1210230000,2.5e+09,23,79,102
333500000,1458870000,707630000,2.5e+09,23,76,99
310490000,1387510000,8.02e+08,2.5e+09,29,84,113
729220000,196780000,1.574e+09,2.5e+09,30,86,116
73210000,1241440000,1185350000,2.5e+09,30,98,128
307800000,1374150000,818050000,2.5e+09,25,77,102
135390000,1658220000,706390000,2.5e+09,39,108,147
527380000,1449160000,523460000,2.5e+09,28,81,109
538780000,1018480000,942740000,2.5e+09,29,86,115
465950000,762500000,1271550000,2.5e+09,28,80,108
772010000,471320000,1256670000,2.5e+09,30,76,106
739550000,581680000,1178770000,2.5e+09,32,93,125
209990000,901850000,1388160000,2.5e+09,28,88,116
56430000,987090000,1456480000,2.5e+09,41,102,143
46080000,1244970000,1208950000,2.5e+09,37,96,133
457390000,956260000,1086350000,2.5e+09,39,103,142
378300000,508300000,1613400000,2.5e+09,32,114,146
201010000,1774140000,524850000,2.5e+09,37,118,155
626350000,1255410000,618240000,2.5e+09,37,108,145
363600000,386730000,1749670000,2.5e+09,35,110,145
568290000,406610000,1525100000,2.5e+09,36,110,146
143580000,2241420000,1.15e+08,2.5e+09,37,96,133
147220000,1940430000,412350000,2.5e+09,34,103,137
770250000,1411350000,318400000,2.5e+09,36,87,123
383340000,1412210000,704450000,2.5e+09,37,106,143
46580000,2372500000,80920000,2.5e+09,29,90,119
103080000,2300680000,96240000,2.5e+09,33,96,129
119490000,2226540000,153970000,2.5e+09,35,102,137
256750000,1871490000,371760000,2.5e+09,36,98,134
1131830000,125560000,1242610000,2.5e+09,32,93,125
849210000,1068750000,582040000,2.5e+09,36,105,141
982080000,73350000,1444570000,2.5e+09,32,99,131
585080000,1475130000,439790000,2.5e+09,36,109,145
294280000,141930000,1803590000,2239800000,27,73,100
55750000,47410000,1576970000,1680130000,30,81,111
206050000,970110000,1323840000,2.5e+09,37,110,147
410630000,1336870000,752500000,2.5e+09,32,97,129
507360000,279410000,1713230000,2.5e+09,36,114,150
572850000,865400000,1061750000,2.5e+09,35,97,132
345510000,1177800000,976690000,2.5e+09,38,108,146
126200000,2127250000,246550000,2.5e+09,32,101,133
215360000,2062410000,222230000,2.5e+09,30,101,131
1226790000,681080000,592130000,2.5e+09,34,109,143
824830000,1161830000,513340000,2.5e+09,32,113,145
713600000,232730000,1553670000,2.5e+09,32,96,128
484210000,1076310000,939480000,2.5e+09,37,101,138
925920000,477670000,1096410000,2.5e+09,35,93,128
527230000,1293730000,679040000,2.5e+09,36,108,144
12350000,94040000,1891610000,1.998e+09,30,79,109
150350000,519740000,1824840000,2494930000,39,94,133
404410000,1610740000,484850000,2.5e+09,33,92,125
1179840000,563530000,756630000,2.5e+09,33,93,126
405160000,1218250000,876590000,2.5e+09,30,90,120
690450000,1197540000,612010000,2.5e+09,32,94,126
1091690000,611850000,796460000,2.5e+09,29,80,109
1170060000,519070000,810870000,2.5e+09,34,112,146
1165950000,632560000,701490000,2.5e+09,34,106,140
383700000,1356340000,759960000,2.5e+09,41,121,162
373670000,1367310000,759020000,2.5e+09,32,100,132
1174710000,66370000,1258920000,2.5e+09,32,96,128
631160000,1491310000,377530000,2.5e+09,38,116,154
1275870000,27680000,1196450000,2.5e+09,37,101,138
693310000,1299470000,507220000,2.5e+09,39,121,160
43680000,639190000,1817130000,2.5e+09,38,98,136
2.37e+08,1144870000,1118130000,2.5e+09,42,104,146
4690000,88740000,2022620000,2116050000,33,85,118
263480000,1636930000,599590000,2.5e+09,40,97,137
40760000,926270000,1532970000,2.5e+09,35,103,138
487610000,954170000,1058220000,2.5e+09,26,79,105
179570000,1788640000,531790000,2.5e+09,31,96,127
131700000,1965880000,402420000,2.5e+09,41,112,153
196100000,1695170000,608730000,2.5e+09,36,105,141
499460000,1443880000,556660000,2.5e+09,35,111,146
1164500000,229800000,1105700000,2.5e+09,41,110,151
625470000,1248390000,626140000,2.5e+09,38,118,156
1044700000,457090000,998210000,2.5e+09,38,104,142
1237830000,364860000,897310000,2.5e+09,34,105,139
650180000,53060000,1487660000,2190900000,27,72,99
595070000,510110000,1361560000,2466740000,37,90,127
1710380000,455660000,333960000,2.5e+09,28,71,99
595790000,1609260000,294950000,2.5e+09,33,91,124
268400000,2860000,1473440000,1744700000,30,74,104
271530000,12310000,1603620000,1887460000,32,70,102
711380000,499790000,1288830000,2.5e+09,39,95,134
95670000,131240000,1948770000,2175680000,37,96,133
67030000,11850000,1508570000,1587450000,31,70,101
293760000,1712970000,493270000,2.5e+09,39,101,140
334950000,1135200000,1029850000,2.5e+09,35,88,123
102240000,1881020000,516740000,2.5e+09,37,99,136
40580000,625090000,1834330000,2.5e+09,43,110,153
144570000,1729910000,625520000,2.5e+09,34,92,126
122150000,1965140000,412710000,2.5e+09,38,93,131
172030000,1724640000,603330000,2.5e+09,38,95,133
86690000,1586510000,826800000,2.5e+09,40,104,144
135830000,1352160000,1012010000,2.5e+09,40,96,136
129650000,1703280000,667070000,2.5e+09,37,88,125
810760000,523760000,1165480000,2.5e+09,30,91,121
105690000,2070470000,323840000,2.5e+09,30,90,120
476550000,1254270000,769180000,2.5e+09,45,129,174
181910000,1949230000,368860000,2.5e+09,34,105,139
832090000,589140000,1078770000,2.5e+09,38,105,143
873500000,159330000,1467170000,2.5e+09,34,114,148
449870000,1535440000,514690000,2.5e+09,29,76,105
1371640000,761720000,366640000,2.5e+09,30,72,102
261140000,2068690000,170170000,2.5e+09,33,96,129
536380000,1595500000,368120000,2.5e+09,30,85,115
274950000,1777050000,4.48e+08,2.5e+09,33,86,119
586180000,1239560000,674260000,2.5e+09,40,99,139
524930000,1607940000,367130000,2.5e+09,42,100,142
29850000,260420000,2209730000,2.5e+09,30,72,102
158680000,443870000,1897450000,2.5e+09,36,84,120
48050000,147670000,2044810000,2240530000,29,78,107
5370000,75550000,1704520000,1785440000,31,65,96
1890000,78430000,2264330000,2344650000,36,88,124
41330000,115520000,2343150000,2.5e+09,27,66,93
22110000,225070000,2252490000,2499670000,27,64,91
323120000,29270000,2147610000,2.5e+09,25,72,97
199420000,68520000,2232060000,2.5e+09,32,79,111
248470000,44640000,2206890000,2.5e+09,40,93,133
29600000,653710000,1816690000,2.5e+09,37,83,120
20640000,319350000,2157660000,2497650000,36,86,122
89290000,317310000,2092380000,2498980000,36,92,128
59970000,94990000,2345040000,2.5e+09,26,63,89
238490000,391710000,1869800000,2.5e+09,32,79,111
127850000,348440000,2023710000,2.5e+09,29,84,113
1.63e+08,622920000,1714080000,2.5e+09,31,89,120
234730000,43550000,2221720000,2.5e+09,35,91,126
98800000,148360000,2252840000,2.5e+09,36,85,121
181070000,142980000,2175950000,2.5e+09,33,79,112
345770000,249810000,1904420000,2.5e+09,34,84,118
40370000,86040000,2373590000,2.5e+09,39,97,136
251040000,21230000,2226700000,2498970000,33,88,121
255310000,200550000,2044140000,2.5e+09,33,79,112
279510000,238040000,1982450000,2.5e+09,36,79,115
31280000,92960000,2133260000,2257500000,26,84,110
239010000,48330000,2212660000,2.5e+09,39,99,138
99170000,85770000,2315060000,2.5e+09,33,87,120
127920000,41760000,2330320000,2.5e+09,48,107,155
2.24e+08,185240000,2090760000,2.5e+09,30,74,104
575620000,31050000,1893330000,2.5e+09,29,66,95
250110000,354660000,1895230000,2.5e+09,38,93,131
572300000,84040000,1843660000,2.5e+09,35,85,120
248590000,1450540000,800870000,2.5e+09,35,88,123
179460000,1777030000,543510000,2.5e+09,31,78,109
275310000,1923330000,301360000,2.5e+09,32,83,115
414640000,1735990000,349370000,2.5e+09,26,70,96
20580000,251810000,1733900000,2006290000,30,73,103
50220000,886460000,1563320000,2.5e+09,37,98,135
133680000,1431710000,934610000,2.5e+09,31,83,114
546400000,796600000,1.157e+09,2.5e+09,32,77,109
274340000,803340000,1422320000,2.5e+09,36,98,134
144350000,1518890000,836760000,2.5e+09,30,78,108
242580000,596450000,1660970000,2.5e+09,34,86,120
67990000,1693800000,738210000,2.5e+09,30,76,106
91710000,1563310000,844980000,2.5e+09,29,80,109
82590000,746650000,1670760000,2.5e+09,30,82,112
165690000,1306140000,1028170000,2.5e+09,36,81,117
111030000,300620000,2088350000,2.5e+09,37,90,127
84830000,1081890000,1333280000,2.5e+09,34,82,116
19100000,116490000,2364410000,2.5e+09,36,90,126
99950000,173440000,2226610000,2.5e+09,33,82,115
161150000,180450000,2158400000,2.5e+09,35,83,118
126330000,117510000,2256160000,2.5e+09,34,83,117
128390000,11990000,2359620000,2.5e+09,34,85,119
68440000,907180000,1524380000,2.5e+09,37,89,126
70810000,1202010000,1227180000,2.5e+09,33,91,124
617570000,208680000,1673750000,2.5e+09,33,84,117
32470000,520130000,1681270000,2233870000,39,91,130
152250000,1353300000,994450000,2.5e+09,37,88,125
220320000,1882950000,396730000,2.5e+09,29,73,102
137100000,1356850000,1006050000,2.5e+09,38,93,131
300490000,1704090000,495420000,2.5e+09,29,79,108
18270000,218650000,2263080000,2.5e+09,39,99,138
211880000,560130000,1727990000,2.5e+09,37,97,134
100990000,445880000,1760260000,2307130000,30,81,111
41860000,1828100000,630040000,2.5e+09,30,76,106
178840000,1710420000,610740000,2.5e+09,28,76,104
214450000,899940000,1385610000,2.5e+09,33,85,118
109590000,1481330000,909080000,2.5e+09,33,86,119
36860000,1559950000,903190000,2.5e+09,30,78,108
48890000,2257940000,193170000,2.5e+09,29,72,101
74690000,2035210000,390100000,2.5e+09,31,83,114
52700000,2089500000,357800000,2.5e+09,34,78,112
118870000,1742210000,638920000,2.5e+09,34,94,128
74940000,2000780000,424280000,2.5e+09,28,65,93
222060000,982270000,1295670000,2.5e+09,35,90,125
104700000,1307400000,1087900000,2.5e+09,43,104,147
160620000,1698020000,641360000,2.5e+09,34,91,125
158520000,968580000,1372900000,2.5e+09,38,86,124
137920000,1237830000,1124250000,2.5e+09,38,90,128
41770000,298870000,2127400000,2468040000,42,98,140
71800000,784060000,1644140000,2.5e+09,38,93,131
18020000,478440000,1784580000,2281040000,37,104,141
189150000,1187060000,1123790000,2.5e+09,34,90,124
353710000,1031730000,1114560000,2.5e+09,39,89,128
334790000,1120310000,1044900000,2.5e+09,32,89,121
284210000,15030000,2200760000,2.5e+09,32,81,113
317960000,16760000,2165280000,2.5e+09,36,86,122
243870000,5100000,2251030000,2.5e+09,34,81,115
92800000,1880000,2405320000,2.5e+09,26,66,92
121610000,10600000,2367790000,2.5e+09,29,80,109
357390000,18840000,2123770000,2.5e+09,33,82,115
13100000,1550000,2441400000,2456050000,29,68,97
86400000,1910000,2411690000,2.5e+09,30,68,98
263370000,42880000,2193750000,2.5e+09,35,87,122
366320000,337580000,1796100000,2.5e+09,33,88,121
305960000,765190000,1428850000,2.5e+09,35,84,119
493280000,381280000,1625440000,2.5e+09,38,99,137
163570000,14880000,2321550000,2.5e+09,37,91,128
557430000,297160000,1645410000,2.5e+09,34,88,122
209010000,49380000,2241610000,2.5e+09,29,81,110
156150000,1840000,2342010000,2.5e+09,33,86,119
363840000,75840000,2060320000,2.5e+09,31,78,109
163200000,79670000,2257130000,2.5e+09,33,77,110
8440000,8e+06,2.279e+09,2295440000,28,77,105
0,3460000,2419160000,2422620000,29,73,102
498310000,1391960000,609730000,2.5e+09,29,99,128
87260000,927460000,1481540000,2496260000,36,101,137
432410000,1518100000,549490000,2.5e+09,35,103,138
721560000,1.181e+09,597440000,2.5e+09,38,96,134
787760000,788790000,923450000,2.5e+09,31,112,143
119500000,2124240000,256260000,2.5e+09,39,110,149
857570000,825600000,816830000,2.5e+09,34,94,128
799770000,56840000,1643390000,2.5e+09,32,105,137
588660000,1743570000,167770000,2.5e+09,29,71,100
335090000,1866830000,298080000,2.5e+09,25,65,90
753320000,1445200000,301480000,2.5e+09,28,81,109
494210000,1771290000,234500000,2.5e+09,27,69,96
524660000,1577950000,397390000,2.5e+09,38,98,136
789680000,1507410000,202910000,2.5e+09,32,78,110
571150000,1465850000,4.63e+08,2.5e+09,36,97,133
1230000,270240000,1773730000,2045200000,42,113,155
377830000,1082940000,1039230000,2.5e+09,28,91,119
851910000,435350000,1212740000,2.5e+09,37,111,148
192080000,1950050000,357870000,2.5e+09,36,103,139
1308340000,266900000,924760000,2.5e+09,30,107,137
952400000,976260000,571340000,2.5e+09,35,101,136
827670000,38910000,1633420000,2.5e+09,33,104,137
726960000,1221090000,551950000,2.5e+09,33,103,136
851500000,75740000,1572760000,2.5e+09,34,97,131
154910000,2159130000,185960000,2.5e+09,31,84,115
166470000,2096320000,237210000,2.5e+09,28,73,101
422080000,1818480000,259440000,2.5e+09,34,94,128
156220000,1899420000,444360000,2.5e+09,29,83,112
1129760000,995940000,374300000,2.5e+09,31,84,115
478240000,1709850000,311910000,2.5e+09,26,74,100
1102720000,807920000,589360000,2.5e+09,38,91,129
1042150000,875510000,582340000,2.5e+09,30,85,115
697500000,834140000,968360000,2.5e+09,37,95,132
1129970000,1054290000,315740000,2.5e+09,30,79,109
769590000,624260000,1106150000,2.5e+09,38,87,125
661150000,1034520000,804330000,2.5e+09,36,85,121
561200000,1688760000,250040000,2.5e+09,38,96,134
266730000,1233270000,1e+09,2.5e+09,36,88,124
540120000,1150530000,809350000,2.5e+09,45,110,155
351710000,942120000,1206170000,2.5e+09,37,93,130
521550000,1484550000,493900000,2.5e+09,40,98,138
491790000,1602110000,406100000,2.5e+09,33,96,129
634110000,1666350000,199540000,2.5e+09,40,101,141
542570000,1675510000,281920000,2.5e+09,38,101,139
276920000,254530000,1941410000,2472860000,38,101,139
1251520000,417660000,830820000,2.5e+09,36,112,148
983580000,418360000,1098060000,2.5e+09,39,114,153
1117860000,806570000,575570000,2.5e+09,30,99,129
1451260000,699010000,349730000,2.5e+09,38,115,153
1131530000,448860000,919610000,2.5e+09,32,104,136
685130000,1407390000,407480000,2.5e+09,32,99,131
1271600000,164910000,1063490000,2.5e+09,33,104,137
499850000,1188240000,811910000,2.5e+09,37,110,147
675100000,949320000,875580000,2.5e+09,46,129,175
556010000,1516970000,427020000,2.5e+09,34,91,125
547050000,1647520000,305430000,2.5e+09,34,92,126
723070000,1268450000,508480000,2.5e+09,34,92,126
1471600000,361560000,666840000,2.5e+09,33,97,130
1011580000,532610000,955810000,2.5e+09,33,79,112
698740000,1029040000,772220000,2.5e+09,33,87,120
639620000,466590000,1393790000,2.5e+09,35,89,124
710520000,748850000,1040630000,2.5e+09,34,87,121
1194440000,300530000,1005030000,2.5e+09,38,92,130
1394060000,236240000,869700000,2.5e+09,36,86,122
7.91e+08,502050000,1206950000,2.5e+09,35,89,124
661960000,214510000,1623530000,2.5e+09,36,84,120
322190000,1320190000,857620000,2.5e+09,40,95,135
461530000,856040000,1182430000,2.5e+09,45,100,145
466830000,915310000,1117860000,2.5e+09,40,96,136
347390000,6.9e+08,1462610000,2.5e+09,43,100,143
1414640000,834220000,251140000,2.5e+09,44,105,149
750100000,1489740000,260160000,2.5e+09,37,93,130
704190000,1274380000,521430000,2.5e+09,42,104,146
427590000,1546770000,525640000,2.5e+09,36,90,126
24940000,420900000,1916540000,2362380000,45,109,154
18690000,479480000,1723290000,2221460000,40,102,142
705660000,1168600000,625740000,2.5e+09,39,117,156
1151010000,648730000,700260000,2.5e+09,35,112,147
142980000,724790000,1632230000,2.5e+09,46,112,158
906950000,501840000,1091210000,2.5e+09,38,97,135
930900000,436570000,1132530000,2.5e+09,38,107,145
7.97e+08,494210000,1208790000,2.5e+09,37,101,138
1428620000,185730000,885650000,2.5e+09,37,103,140
598640000,1093220000,808140000,2.5e+09,40,103,143
1031490000,608620000,859890000,2.5e+09,38,102,140
841730000,414350000,1243920000,2.5e+09,44,109,153
1.119e+09,573430000,807570000,2.5e+09,37,98,135
512750000,629370000,1357880000,2.5e+09,40,101,141
341160000,940950000,1217890000,2.5e+09,37,104,141
535040000,418570000,1546390000,2.5e+09,39,101,140
365680000,389820000,1744500000,2.5e+09,33,89,122
764770000,1371370000,363860000,2.5e+09,40,102,142
822590000,805210000,872200000,2.5e+09,39,97,136
827590000,1166230000,506180000,2.5e+09,36,89,125
1132470000,213300000,1154230000,2.5e+09,36,93,129
684060000,1234460000,581480000,2.5e+09,36,104,140
74070000,1017520000,1408410000,2.5e+09,44,119,163
813500000,1239960000,446540000,2.5e+09,41,119,160
348420000,731130000,1420450000,2.5e+09,43,103,146
1204550000,559560000,735890000,2.5e+09,38,106,144
974390000,878890000,646720000,2.5e+09,37,108,145
1121080000,861760000,517160000,2.5e+09,44,113,157
1113230000,867100000,519670000,2.5e+09,38,106,144
412460000,900200000,1187340000,2.5e+09,40,106,146
844380000,824040000,831580000,2.5e+09,36,95,131
625400000,1261060000,613540000,2.5e+09,44,124,168
696810000,1372750000,430440000,2.5e+09,41,101,142
581700000,719750000,1198550000,2.5e+09,42,103,145
668570000,822040000,1009390000,2.5e+09,38,94,132
581990000,1267850000,650160000,2.5e+09,46,105,151
691320000,1033130000,775550000,2.5e+09,44,110,154
1069140000,1030120000,400740000,2.5e+09,36,92,128
788910000,781320000,929770000,2.5e+09,33,99,132
873450000,1160330000,466220000,2.5e+09,39,91,130
725310000,1288770000,485920000,2.5e+09,41,94,135
105270000,54640000,2012330000,2172240000,27,93,120
1088700000,811490000,599810000,2.5e+09,41,121,162
1177680000,717870000,604450000,2.5e+09,39,111,150
1182650000,266250000,1051100000,2.5e+09,37,112,149
1122500000,545770000,831730000,2.5e+09,39,110,149
1084700000,780220000,635080000,2.5e+09,47,110,157
1118820000,598190000,782990000,2.5e+09,43,110,153
1320280000,404490000,775230000,2.5e+09,46,105,151
1096980000,599850000,803170000,2.5e+09,45,103,148
982430000,918280000,599290000,2.5e+09,43,93,136
1078720000,745450000,675830000,2.5e+09,42,95,137
403720000,1217580000,878700000,2.5e+09,35,93,128
397580000,1367530000,734890000,2.5e+09,37,90,127
345130000,1932740000,222130000,2.5e+09,36,90,126
254060000,2117850000,128090000,2.5e+09,32,89,121
357080000,1041620000,1101300000,2.5e+09,42,113,155
412650000,969230000,1118120000,2.5e+09,34,86,120
581230000,1215880000,702890000,2.5e+09,36,97,133
5.27e+08,1657840000,315160000,2.5e+09,32,86,118
63380000,713050000,1522450000,2298880000,28,76,104
292750000,1121130000,1086120000,2.5e+09,35,100,135
335080000,1196660000,968260000,2.5e+09,36,100,136
125620000,283230000,1832060000,2240910000,38,101,139
111680000,935580000,1452740000,2.5e+09,39,99,138
53760000,2148770000,297470000,2.5e+09,37,96,133
80530000,1478900000,940570000,2.5e+09,32,96,128
45670000,899370000,1517670000,2462710000,42,107,149
9450000,335180000,2115680000,2460310000,25,75,100
162070000,2035810000,302120000,2.5e+09,40,108,148
49310000,7.21e+08,1479450000,2249760000,39,99,138
112570000,2108030000,279400000,2.5e+09,43,108,151
588180000,1571210000,340610000,2.5e+09,31,92,123
436710000,1811520000,251770000,2.5e+09,35,96,131
798960000,1148650000,552390000,2.5e+09,35,101,136
430230000,1820940000,248830000,2.5e+09,36,98,134
351160000,1592880000,555960000,2.5e+09,30,88,118
638260000,1519500000,342240000,2.5e+09,39,99,138
141090000,828340000,1526660000,2496090000,46,119,165
298590000,1753850000,447560000,2.5e+09,37,98,135
107860000,1820420000,571720000,2.5e+09,35,88,123
145440000,2112010000,242550000,2.5e+09,35,93,128
55830000,802280000,1627840000,2485950000,40,109,149
63180000,2062850000,373970000,2.5e+09,38,96,134
19350000,414310000,1552140000,1985800000,30,89,119
402680000,1918660000,178660000,2.5e+09,35,93,128
636840000,1672470000,190690000,2.5e+09,43,105,148
232160000,2074300000,193540000,2.5e+09,36,95,131
785700000,1412910000,301390000,2.5e+09,36,95,131
738790000,1431280000,329930000,2.5e+09,46,100,146
547500000,1700210000,252290000,2.5e+09,33,78,111
317550000,1916500000,265950000,2.5e+09,43,102,145
485860000,1806370000,207770000,2.5e+09,40,98,138
201650000,1555510000,742840000,2.5e+09,40,98,138
140740000,2025420000,333840000,2.5e+09,34,92,126
375320000,1069370000,1055310000,2.5e+09,39,87,126
476980000,939490000,1083530000,2.5e+09,41,93,134
59620000,1336750000,1103630000,2.5e+09,42,103,145
51250000,1557310000,891440000,2.5e+09,32,88,120
94560000,1310090000,1095350000,2.5e+09,45,104,149
23970000,124570000,2045710000,2194250000,38,103,141
34030000,1203980000,1261990000,2.5e+09,41,109,150
695660000,1363730000,440610000,2.5e+09,43,102,145
1118260000,1170420000,211320000,2.5e+09,36,90,126
985120000,1030260000,484620000,2.5e+09,41,93,134
882350000,826260000,791390000,2.5e+09,33,80,113
510540000,1246370000,743090000,2.5e+09,45,105,150
445990000,1624530000,429480000,2.5e+09,45,101,146
733190000,1028530000,738280000,2.5e+09,48,98,146
827950000,1089990000,582060000,2.5e+09,45,101,146
624160000,1186240000,689600000,2.5e+09,33,81,114
1369850000,394060000,736090000,2.5e+09,43,100,143
1131040000,677740000,691220000,2.5e+09,39,81,120
1172050000,697070000,630880000,2.5e+09,40,89,129
3.59e+08,930410000,1210590000,2.5e+09,41,91,132
491460000,1219960000,788580000,2.5e+09,44,106,150
237610000,1268880000,993510000,2.5e+09,43,100,143
37020000,398510000,2064470000,2.5e+09,42,109,151
209280000,1236130000,1054590000,2.5e+09,45,113,158
699640000,533300000,1267060000,2.5e+09,43,112,155
285040000,1334940000,880020000,2.5e+09,42,109,151
13320000,362980000,2123700000,2.5e+09,39,101,140
75610000,438160000,1986230000,2.5e+09,41,110,151
35510000,126060000,2338430000,2.5e+09,39,107,146
245640000,908860000,1345500000,2.5e+09,49,123,172
3500000,170320000,2324500000,2498320000,35,100,135
685710000,806860000,1007430000,2.5e+09,41,98,139
967030000,633440000,899530000,2.5e+09,38,89,127
108460000,282770000,1991250000,2382480000,42,111,153
3.3e+07,130950000,2.264e+09,2427950000,43,109,152
0,15670000,1463900000,1479570000,23,72,95
765180000,261830000,1472990000,2.5e+09,39,109,148
349260000,597940000,1552800000,2.5e+09,45,125,170
661800000,139270000,1698930000,2.5e+09,38,96,134
518910000,214960000,1766130000,2.5e+09,39,104,143
609790000,86350000,1803860000,2.5e+09,39,92,131
1154460000,431960000,913580000,2.5e+09,41,102,143
698210000,270610000,1531180000,2.5e+09,36,94,130
193330000,88850000,2217820000,2.5e+09,42,110,152
554400000,127030000,1818570000,2.5e+09,35,103,138
640000,19720000,1742450000,1762810000,43,110,153
428420000,252430000,1819150000,2.5e+09,35,86,121
985620000,500350000,1014030000,2.5e+09,39,119,158
1297450000,574060000,628490000,2.5e+09,37,103,140
403780000,91210000,2005010000,2.5e+09,37,97,134
885740000,441360000,1172900000,2.5e+09,38,103,141
975480000,236230000,1288290000,2.5e+09,31,92,123
1228220000,71980000,1199800000,2.5e+09,32,106,138
802800000,214440000,1482760000,2.5e+09,34,107,141
1150230000,123590000,1226180000,2.5e+09,31,105,136
68270000,37900000,1793650000,1899820000,25,75,100
811470000,34750000,1653780000,2.5e+09,35,99,134
607580000,63370000,1829050000,2.5e+09,35,96,131
674390000,1239160000,586450000,2.5e+09,38,115,153
924310000,1016870000,558820000,2.5e+09,33,97,130
658470000,68480000,1773050000,2.5e+09,37,100,137
547130000,51070000,1901800000,2.5e+09,31,92,123
566490000,110760000,1822750000,2.5e+09,32,98,130
658250000,307660000,1534090000,2.5e+09,37,110,147
648910000,1282890000,568200000,2.5e+09,51,121,172
979300000,219240000,1301460000,2.5e+09,46,119,165
702720000,729960000,1067320000,2.5e+09,44,107,151
730830000,166630000,1602540000,2.5e+09,40,115,155
1213880000,658020000,628100000,2.5e+09,46,105,151
974330000,654020000,871650000,2.5e+09,47,107,154
836480000,1177890000,485630000,2.5e+09,46,108,154
966290000,993740000,539970000,2.5e+09,48,108,156
945450000,242290000,1312260000,2.5e+09,32,97,129
540690000,1794640000,164670000,2.5e+09,32,84,116
1071490000,1169080000,259430000,2.5e+09,33,90,123
208420000,2096040000,195540000,2.5e+09,34,98,132
935500000,470460000,1094040000,2.5e+09,28,86,114
1063900000,86870000,1349230000,2.5e+09,34,99,133
397640000,1747120000,355240000,2.5e+09,41,113,154
1136500000,491590000,871910000,2.5e+09,38,105,143
194110000,1986570000,319320000,2.5e+09,33,90,123
787970000,60590000,1651440000,2.5e+09,40,90,130
662560000,70860000,1766580000,2.5e+09,34,103,137
413860000,11880000,2074260000,2.5e+09,37,86,123
1290410000,59780000,1149810000,2.5e+09,35,103,138
1322210000,644120000,533670000,2.5e+09,47,98,145
802090000,1107680000,590230000,2.5e+09,48,100,148
833730000,1194070000,472200000,2.5e+09,48,93,141
718900000,642860000,1138240000,2.5e+09,52,113,165
633040000,239710000,1584250000,2.457e+09,29,79,108
616460000,1637090000,246450000,2.5e+09,37,106,143
1559230000,279470000,661300000,2.5e+09,29,93,122
285200000,1986480000,228320000,2.5e+09,27,87,114
1590510000,654800000,254690000,2.5e+09,28,85,113
1053170000,552140000,894690000,2.5e+09,41,117,158
52900000,1770730000,676370000,2.5e+09,29,91,120
1277210000,399820000,822970000,2.5e+09,37,111,148
49690000,2154720000,295590000,2.5e+09,33,91,124
759180000,39900000,1700920000,2.5e+09,35,92,127
1053810000,92010000,1354180000,2.5e+09,37,105,142
479580000,2e+06,2018420000,2.5e+09,29,85,114
789380000,105240000,1605380000,2.5e+09,32,92,124
485610000,1.082e+09,932390000,2.5e+09,47,103,150
909120000,226340000,1364540000,2.5e+09,40,101,141
802060000,192800000,1505140000,2.5e+09,47,108,155
861340000,24890000,1613770000,2.5e+09,38,92,130
494860000,538850000,1466290000,2.5e+09,27,79,106
1207500000,964320000,328180000,2.5e+09,25,75,100
394610000,1067080000,1038310000,2.5e+09,32,83,115
1557750000,601810000,340440000,2.5e+09,35,93,128
569700000,1305830000,624470000,2.5e+09,29,88,117
1351520000,835750000,312730000,2.5e+09,31,85,116
886470000,1406740000,206790000,2.5e+09,30,79,109
114490000,2142240000,243270000,2.5e+09,32,93,125
803950000,1406940000,289110000,2.5e+09,26,93,119
35610000,2312270000,152120000,2.5e+09,30,74,104
484980000,1650710000,364310000,2.5e+09,32,107,139
1449110000,232330000,818560000,2.5e+09,34,102,136
90820000,1850150000,559030000,2.5e+09,38,100,138
1405460000,492890000,601650000,2.5e+09,34,104,138
216260000,1934910000,348830000,2.5e+09,30,83,113
564340000,81130000,1854530000,2.5e+09,32,97,129
1084080000,204220000,1211700000,2.5e+09,32,94,126
1522080000,409200000,568720000,2.5e+09,36,95,131
935430000,158390000,1406180000,2.5e+09,41,101,142
837530000,27260000,1635210000,2.5e+09,28,73,101
1238390000,101830000,1159780000,2.5e+09,42,106,148
852720000,69940000,1577340000,2.5e+09,33,85,118
200090000,888320000,1326750000,2415160000,24,76,100
561490000,1606090000,332420000,2.5e+09,30,83,113
682090000,1413310000,404600000,2.5e+09,23,81,104
1472740000,819490000,207770000,2.5e+09,26,82,108
1292030000,918490000,289480000,2.5e+09,30,85,115
11460000,2318450000,170090000,2.5e+09,21,65,86
72590000,2212650000,214760000,2.5e+09,37,100,137
807140000,1238870000,453990000,2.5e+09,38,109,147
104700000,2081430000,313870000,2.5e+09,25,66,91
1172300000,82050000,1245650000,2.5e+09,32,99,131
1371270000,265140000,863590000,2.5e+09,38,107,145
1475620000,42920000,981460000,2.5e+09,37,89,126
703450000,14270000,1782280000,2.5e+09,32,84,116
1035150000,343460000,1121390000,2.5e+09,38,85,123
898490000,973760000,627750000,2.5e+09,38,87,125
1120720000,1023250000,356030000,2.5e+09,38,89,127
1169780000,838360000,491860000,2.5e+09,37,81,118
255060000,1471790000,773150000,2.5e+09,40,93,133
630120000,1133510000,736370000,2.5e+09,40,95,135
659260000,693590000,1147150000,2.5e+09,37,78,115
768660000,735560000,995780000,2.5e+09,38,87,125
213850000,1154890000,1131260000,2.5e+09,46,107,153
260290000,1301050000,938660000,2.5e+09,41,97,138
244690000,1860950000,394360000,2.5e+09,37,92,129
374290000,1137200000,988510000,2.5e+09,36,83,119
256100000,713140000,1530760000,2.5e+09,41,111,152
205380000,617290000,1677330000,2.5e+09,45,107,152
146680000,1822910000,530410000,2.5e+09,40,109,149
336700000,1754690000,408610000,2.5e+09,40,101,141
14340000,4.42e+08,2043660000,2.5e+09,38,102,140
21410000,684620000,1793970000,2.5e+09,40,102,142
979240000,809170000,711590000,2.5e+09,44,100,144
1468660000,434310000,597030000,2.5e+09,39,94,133
1346700000,775110000,378190000,2.5e+09,45,102,147
1054230000,1030350000,415420000,2.5e+09,44,114,158
751020000,1047250000,701730000,2.5e+09,44,100,144
458810000,1247540000,793650000,2.5e+09,46,101,147
845030000,967420000,687550000,2.5e+09,36,88,124
975840000,835210000,688950000,2.5e+09,41,99,140
1105220000,909850000,484930000,2.5e+09,40,92,132
622670000,1521290000,356040000,2.5e+09,41,96,137
841310000,1085870000,572820000,2.5e+09,43,99,142
778450000,1093490000,628060000,2.5e+09,45,94,139
1432060000,515910000,552030000,2.5e+09,38,80,118
1233960000,308930000,957110000,2.5e+09,37,79,116
1270860000,760970000,468170000,2.5e+09,37,77,114
1109370000,798120000,592510000,2.5e+09,39,84,123
293310000,1884650000,322040000,2.5e+09,41,92,133
244440000,1.787e+09,468560000,2.5e+09,40,87,127
339810000,1667660000,492530000,2.5e+09,43,96,139
648670000,1368260000,483070000,2.5e+09,43,92,135
230750000,1513510000,755740000,2.5e+09,42,99,141
286230000,2028670000,185100000,2.5e+09,40,92,132
206640000,1233890000,1059470000,2.5e+09,41,103,144
169820000,1838430000,491750000,2.5e+09,43,98,141
112550000,521400000,1866050000,2.5e+09,43,101,144
23150000,294870000,2181980000,2.5e+09,40,102,142
158280000,399440000,1942280000,2.5e+09,44,111,155
29990000,659080000,1810930000,2.5e+09,43,113,156
33090000,4960000,1469240000,1507290000,31,73,104
174560000,1808910000,516530000,2.5e+09,42,103,145
29450000,961180000,1509370000,2.5e+09,44,113,157
967660000,9.34e+08,598340000,2.5e+09,48,108,156
1346090000,539680000,614230000,2.5e+09,42,90,132
1169920000,912170000,417910000,2.5e+09,38,76,114
1057760000,815930000,626310000,2.5e+09,43,83,126
1275230000,919680000,305090000,2.5e+09,35,86,121
1094300000,976420000,429280000,2.5e+09,42,103,145
857340000,990300000,652360000,2.5e+09,46,102,148
904080000,1080010000,515910000,2.5e+09,42,84,126
1191280000,6.31e+08,677720000,2.5e+09,41,91,132
1378510000,766010000,355480000,2.5e+09,41,98,139
1063980000,992740000,443280000,2.5e+09,40,89,129
541680000,1691070000,267250000,2.5e+09,45,101,146
947420000,1151850000,400730000,2.5e+09,36,80,116
1064460000,869980000,565560000,2.5e+09,35,72,107
9.66e+08,1278350000,255650000,2.5e+09,41,94,135
983990000,908950000,607060000,2.5e+09,43,97,140
746580000,1463550000,289870000,2.5e+09,39,88,127
977570000,1213720000,308710000,2.5e+09,40,89,129
520090000,1597020000,382890000,2.5e+09,47,103,150
887370000,1267930000,344700000,2.5e+09,41,98,139
413780000,1277330000,808890000,2.5e+09,44,96,140
479550000,1432540000,587910000,2.5e+09,47,104,151
1177440000,895180000,427380000,2.5e+09,41,98,139
835050000,1134070000,530880000,2.5e+09,46,100,146
142940000,942050000,1415010000,2.5e+09,44,108,152
219810000,1118490000,1161690000,2499990000,47,108,155
287800000,1417270000,794930000,2.5e+09,45,105,150
438130000,1034210000,1027660000,2.5e+09,48,118,166
132260000,1432780000,934960000,2.5e+09,43,106,149
141430000,694400000,1664170000,2.5e+09,41,94,135
28540000,538160000,1933300000,2.5e+09,44,102,146
158360000,1146350000,1195290000,2.5e+09,46,108,154
194500000,1885860000,419640000,2.5e+09,42,91,133
49460000,1721830000,728710000,2.5e+09,41,93,134
63860000,781160000,1654980000,2.5e+09,41,94,135
881520000,1019990000,598490000,2.5e+09,41,76,117
902030000,1108710000,489260000,2.5e+09,42,87,129
755640000,1285760000,458600000,2.5e+09,45,91,136
643510000,907530000,948960000,2.5e+09,43,87,130
919680000,1310580000,269740000,2.5e+09,38,73,111
752510000,1198790000,548700000,2.5e+09,37,75,112
513570000,1784010000,202420000,2.5e+09,41,84,125
851290000,995160000,653550000,2.5e+09,41,81,122
950030000,1235890000,314080000,2.5e+09,43,96,139
980960000,1258630000,260410000,2.5e+09,45,102,147
1076710000,1035460000,387830000,2.5e+09,43,90,133
1016560000,1022850000,460590000,2.5e+09,41,100,141
389080000,1868290000,242630000,2.5e+09,44,93,137
1171940000,879710000,448350000,2.5e+09,43,100,143
309900000,1938340000,251760000,2.5e+09,40,97,137
1046930000,1165400000,287670000,2.5e+09,42,93,135
372180000,1780540000,347280000,2.5e+09,47,101,148
1331540000,883590000,284870000,2.5e+09,44,101,145
234180000,1852650000,413170000,2.5e+09,49,100,149
232550000,1994020000,273430000,2.5e+09,49,112,161
752360000,1461770000,285870000,2.5e+09,47,104,151
646420000,1391810000,461770000,2.5e+09,53,110,163
663810000,1255600000,580590000,2.5e+09,49,110,159
676350000,1258740000,564910000,2.5e+09,49,109,158
191790000,1416260000,891950000,2.5e+09,46,105,151
619570000,1375910000,504520000,2.5e+09,51,113,164
309510000,1456060000,734430000,2.5e+09,51,118,169
665640000,1283240000,551120000,2.5e+09,44,86,130
85290000,764910000,1649800000,2.5e+09,44,106,150
12250000,80870000,2406880000,2.5e+09,38,79,117
644390000,1376570000,479040000,2.5e+09,46,96,142
621630000,779030000,1099340000,2.5e+09,44,90,134
507150000,1691080000,301770000,2.5e+09,41,90,131
733990000,739820000,1026190000,2.5e+09,47,99,146
696440000,1340210000,463350000,2.5e+09,39,93,132
708500000,1321960000,469540000,2.5e+09,46,103,149
1076330000,1006730000,416940000,2.5e+09,40,97,137
860230000,1379490000,260280000,2.5e+09,49,104,153
413070000,1822890000,264040000,2.5e+09,46,91,137
722130000,831580000,946290000,2.5e+09,46,92,138
1268330000,118920000,1112750000,2.5e+09,37,107,144
313450000,63830000,1737320000,2114600000,42,114,156
211710000,25770000,2262520000,2.5e+09,31,85,116
265740000,30500000,2203760000,2.5e+09,31,84,115
385040000,1.9e+07,2095960000,2.5e+09,28,86,114
607490000,70410000,1822100000,2.5e+09,32,86,118
672600000,110440000,1716960000,2.5e+09,34,88,122
720630000,129260000,1650110000,2.5e+09,30,89,119
43040000,85050000,2177820000,2305910000,36,85,121
655260000,146810000,1697930000,2.5e+09,38,104,142
9210000,68240000,1435250000,1512700000,29,73,102
111180000,1462330000,926490000,2.5e+09,41,97,138
241270000,1854450000,404280000,2.5e+09,40,92,132
2011630000,135500000,352870000,2.5e+09,37,100,137
575250000,52410000,1637120000,2264780000,43,103,146
1438550000,116900000,944550000,2.5e+09,42,102,144
38960000,5160000,1054830000,1098950000,28,68,96
1149330000,35780000,1314890000,2.5e+09,34,97,131
1088300000,23810000,1387890000,2.5e+09,33,92,125
1731270000,57200000,711530000,2.5e+09,34,88,122
2032020000,28910000,439070000,2.5e+09,34,88,122
572300000,21830000,1905870000,2.5e+09,33,95,128
1169340000,51710000,1278950000,2.5e+09,34,99,133
585020000,46890000,1868090000,2.5e+09,29,80,109
412060000,82080000,2005860000,2.5e+09,33,103,136
1110360000,127600000,1262040000,2.5e+09,33,103,136
433660000,98060000,1968280000,2.5e+09,40,101,141
690410000,271270000,1538320000,2.5e+09,38,108,146
619180000,99070000,1781750000,2.5e+09,37,92,129
810170000,146080000,1543750000,2.5e+09,39,104,143
273170000,50900000,2175930000,2.5e+09,34,96,130
549150000,95740000,1855110000,2.5e+09,38,97,135
159940000,1805690000,534370000,2.5e+09,36,88,124
449800000,1680670000,369530000,2.5e+09,37,85,122
218090000,1363860000,918050000,2.5e+09,39,89,128
184510000,1380580000,934910000,2.5e+09,41,92,133
110990000,1194890000,1194120000,2.5e+09,40,100,140
102910000,1316530000,1080560000,2.5e+09,38,92,130
24990000,910000,1034390000,1060290000,18,42,60
1855630000,221910000,422460000,2.5e+09,41,113,154
1176130000,61870000,1249810000,2487810000,39,108,147
785700000,554830000,1159470000,2.5e+09,47,120,167
82740000,71320000,1707580000,1861640000,37,85,122
1706260000,95650000,698090000,2.5e+09,37,94,131
1877630000,176150000,446220000,2.5e+09,43,107,150
1578250000,329080000,592670000,2.5e+09,41,103,144
1312090000,385010000,802900000,2.5e+09,43,104,147
1053120000,138540000,1308340000,2.5e+09,36,101,137
1535340000,94140000,870520000,2.5e+09,33,98,131
1293550000,361330000,845120000,2.5e+09,39,110,149
1399750000,360550000,739700000,2.5e+09,41,109,150
566170000,115730000,1818100000,2.5e+09,41,104,145
1141650000,137060000,1221290000,2.5e+09,38,114,152
1085970000,116910000,1297120000,2.5e+09,40,114,154
650890000,153010000,1696100000,2.5e+09,37,100,137
372150000,86710000,2041140000,2.5e+09,28,92,120
755270000,150440000,1594290000,2.5e+09,29,87,116
716500000,99690000,1683810000,2.5e+09,32,92,124
168180000,182210000,2149610000,2.5e+09,32,81,113
881070000,236120000,1382810000,2.5e+09,37,104,141
784490000,196080000,1519430000,2.5e+09,34,95,129
731730000,375600000,1392670000,2.5e+09,38,101,139
47840000,221750000,1954640000,2224230000,35,81,116
55250000,212250000,2196210000,2463710000,37,90,127
1129600000,408510000,961890000,2.5e+09,46,116,162
496090000,269210000,1721530000,2486830000,45,111,156
1362860000,600150000,536990000,2.5e+09,45,118,163
911910000,197120000,1390970000,2.5e+09,43,98,141
1881600000,148060000,470340000,2.5e+09,35,93,128
1774540000,329790000,395670000,2.5e+09,35,92,127
1380440000,704200000,415360000,2.5e+09,39,100,139
1553380000,572680000,373940000,2.5e+09,43,110,153
1489450000,115140000,895410000,2.5e+09,36,106,142
1362850000,404240000,732910000,2.5e+09,43,111,154
985140000,39260000,1475600000,2.5e+09,33,93,126
1493380000,29810000,976810000,2.5e+09,30,95,125
547770000,93740000,1858490000,2.5e+09,30,93,123
956190000,115510000,1428300000,2.5e+09,33,88,121
579040000,488130000,1432830000,2.5e+09,39,110,149
587990000,146840000,1765170000,2.5e+09,34,95,129
53310000,14980000,2377420000,2445710000,20,52,72
443900000,49290000,2006810000,2.5e+09,30,82,112
722750000,184070000,1593180000,2.5e+09,35,96,131
1052420000,233750000,1213830000,2.5e+09,31,90,121
242230000,53230000,2204540000,2.5e+09,31,82,113
338740000,430840000,1729150000,2498730000,24,63,87
558710000,338280000,1436810000,2333800000,19,54,73
264100000,252860000,1718800000,2235760000,25,78,103
1064400000,429150000,1006450000,2.5e+09,23,78,101
794990000,809590000,895420000,2.5e+09,23,67,90
833900000,1211450000,454650000,2.5e+09,29,82,111
1350550000,836960000,312490000,2.5e+09,27,84,111
191690000,1072380000,1235930000,2.5e+09,25,70,95
451330000,1775850000,272820000,2.5e+09,30,82,112
68380000,733310000,1657400000,2459090000,29,78,107
666930000,1424240000,408830000,2.5e+09,29,77,106
704870000,1613740000,181390000,2.5e+09,30,84,114
480060000,1582430000,437510000,2.5e+09,30,84,114
1221240000,879470000,399290000,2.5e+09,27,79,106
18720000,346510000,1935550000,2300780000,33,87,120
36890000,1217400000,1245710000,2.5e+09,39,90,129
344090000,1809060000,346850000,2.5e+09,42,113,155
6e+06,1147850000,1346150000,2.5e+09,30,74,104
73940000,767340000,1573310000,2414590000,27,74,101
326580000,748190000,1425230000,2.5e+09,20,74,94
1122880000,994850000,382270000,2.5e+09,32,101,133
573730000,1505110000,421160000,2.5e+09,31,91,122
613740000,699040000,1187220000,2.5e+09,29,91,120
990120000,980020000,529860000,2.5e+09,31,102,133
899910000,1175470000,424620000,2.5e+09,24,88,112
1185460000,792410000,522130000,2.5e+09,32,98,130
318660000,1831790000,349550000,2.5e+09,23,82,105
1126370000,693520000,680110000,2.5e+09,29,95,124
45470000,733090000,1503180000,2281740000,25,73,98
642320000,1508500000,349180000,2.5e+09,29,95,124
32410000,2080950000,386640000,2.5e+09,41,96,137
269080000,1.125e+09,1105920000,2.5e+09,43,116,159
163320000,294860000,1706310000,2164490000,29,89,118
1384340000,61130000,1054530000,2.5e+09,29,80,109
1326560000,528250000,645190000,2.5e+09,36,99,135
1556350000,133570000,810080000,2.5e+09,33,88,121
1320670000,561140000,618190000,2.5e+09,34,105,139
1435280000,27850000,1036870000,2.5e+09,38,93,131
790910000,18640000,1690450000,2.5e+09,33,87,120
1440540000,15140000,1044320000,2.5e+09,40,92,132
1029010000,7900000,1463090000,2.5e+09,30,72,102
47090000,221370000,1905390000,2173850000,16,57,73
742610000,1296450000,460940000,2.5e+09,31,89,120
782390000,1180500000,537110000,2.5e+09,27,79,106
475190000,1434510000,590300000,2.5e+09,34,106,140
1189600000,525870000,784530000,2.5e+09,36,106,142
52710000,720500000,1510110000,2283320000,22,70,92
444480000,1770640000,284880000,2.5e+09,26,82,108
11790000,182630000,1356040000,1550460000,16,52,68
57420000,899590000,1350380000,2307390000,24,79,103
388400000,131720000,1979880000,2.5e+09,30,91,121
1580920000,483830000,435250000,2.5e+09,37,118,155
1369790000,540300000,589910000,2.5e+09,40,107,147
1647020000,496550000,356430000,2.5e+09,49,116,165
1817530000,71630000,610840000,2.5e+09,38,106,144
1484560000,336610000,678830000,2.5e+09,37,100,137
1661640000,321400000,516960000,2.5e+09,40,100,140
1396820000,644850000,458330000,2.5e+09,39,98,137
1599750000,477510000,422740000,2.5e+09,34,104,138
1467270000,20930000,1011800000,2.5e+09,35,91,126
1342730000,58450000,1098820000,2.5e+09,31,80,111
1828320000,6700000,664980000,2.5e+09,35,88,123
1582320000,216890000,700790000,2.5e+09,34,86,120
961620000,1077960000,460420000,2.5e+09,31,95,126
1135760000,877040000,487200000,2.5e+09,31,90,121
224830000,2106940000,168230000,2.5e+09,24,75,99
782150000,1364950000,352900000,2.5e+09,33,94,127
7720000,2010190000,482090000,2.5e+09,22,63,85
403880000,1936990000,159130000,2.5e+09,30,80,110
51410000,1741410000,707180000,2.5e+09,31,88,119
426820000,582430000,1490750000,2.5e+09,38,105,143
1.21e+08,458690000,1920310000,2.5e+09,30,88,118
4.33e+08,551640000,1515360000,2.5e+09,27,91,118
1663290000,2.83e+08,553710000,2.5e+09,32,73,105
1378660000,910360000,210980000,2.5e+09,37,92,129
1462770000,623880000,413350000,2.5e+09,44,89,133
715600000,1149360000,635040000,2.5e+09,44,97,141
1019260000,949540000,531200000,2.5e+09,28,78,106
1384560000,661670000,453770000,2.5e+09,41,90,131
1260210000,908490000,331300000,2.5e+09,39,97,136
795630000,1507300000,197070000,2.5e+09,46,102,148
835040000,1272270000,392690000,2.5e+09,51,106,157
1906750000,42220000,551030000,2.5e+09,36,88,124
1500950000,373980000,625070000,2.5e+09,37,84,121
1529900000,520150000,449950000,2.5e+09,36,86,122
997770000,1292530000,209700000,2.5e+09,44,95,139
386210000,1733650000,380140000,2.5e+09,28,72,100
67380000,810720000,1606540000,2484640000,23,65,88
152490000,1969450000,378060000,2.5e+09,25,56,81
189410000,1900740000,409850000,2.5e+09,22,48,70
445680000,289630000,1764690000,2.5e+09,22,64,86
634780000,448820000,1416400000,2.5e+09,29,89,118
1079590000,1087590000,332820000,2.5e+09,35,70,105
1629980000,328970000,541050000,2.5e+09,22,58,80
893110000,1476290000,130600000,2.5e+09,40,85,125
691840000,1386110000,422050000,2.5e+09,34,77,111
7.98e+08,1039400000,662600000,2.5e+09,40,88,128
891540000,1242970000,365490000,2.5e+09,46,102,148
1152230000,919150000,428620000,2.5e+09,47,89,136
1026270000,1097670000,376060000,2.5e+09,44,96,140
641340000,1366070000,492590000,2.5e+09,42,82,124
620770000,1009200000,870030000,2.5e+09,46,105,151
889520000,1256440000,354040000,2.5e+09,38,93,131
630480000,1345450000,524070000,2.5e+09,54,109,163
735330000,1485160000,279510000,2.5e+09,38,87,125
307740000,1714920000,477340000,2.5e+09,42,86,128
639070000,1398610000,462320000,2.5e+09,36,78,114
560870000,1416850000,522280000,2.5e+09,49,106,155
327360000,600320000,1572320000,2.5e+09,28,91,119
955290000,320260000,1224450000,2.5e+09,24,91,115
805290000,1455850000,238860000,2.5e+09,35,74,109
1476570000,564260000,459170000,2.5e+09,26,59,85
668050000,1506210000,325740000,2.5e+09,36,79,115
1101400000,1090920000,307680000,2.5e+09,43,87,130
429420000,1624920000,445660000,2.5e+09,41,97,138
770370000,1301200000,428430000,2.5e+09,40,89,129
400910000,1755300000,343790000,2.5e+09,50,102,152
740630000,962160000,797210000,2.5e+09,46,102,148
287830000,4.51e+08,1761170000,2.5e+09,46,104,150
238330000,1041340000,1220330000,2.5e+09,51,117,168
78040000,1141280000,1280680000,2.5e+09,41,108,149
2500000,347710000,1753070000,2103280000,38,101,139
462810000,1839250000,197940000,2.5e+09,40,88,128
630830000,1011090000,858080000,2.5e+09,47,95,142
551650000,1623700000,324650000,2.5e+09,42,94,136
802430000,709150000,988420000,2.5e+09,41,91,132
1096310000,1015470000,388220000,2.5e+09,48,108,156
647160000,1515040000,337800000,2.5e+09,43,106,149
820950000,1173220000,505830000,2.5e+09,50,112,162
1529540000,216080000,754380000,2.5e+09,48,108,156
1233960000,607760000,658280000,2.5e+09,48,104,152
1105570000,870890000,523540000,2.5e+09,50,106,156
684710000,972890000,842400000,2.5e+09,47,110,157
917230000,1281200000,301570000,2.5e+09,47,109,156
421060000,1669120000,409820000,2.5e+09,45,97,142
270660000,1960760000,268580000,2.5e+09,44,95,139
685850000,1216160000,597990000,2.5e+09,43,95,138
1048590000,1083770000,367640000,2.5e+09,48,96,144
960260000,1035590000,504150000,2.5e+09,47,95,142
798090000,1330970000,370940000,2.5e+09,43,94,137
1135490000,833530000,530980000,2.5e+09,48,104,152
577550000,802270000,1120180000,2.5e+09,47,109,156
367360000,1532350000,600290000,2.5e+09,45,102,147
623710000,1281760000,594530000,2.5e+09,48,112,160
323810000,1627330000,548860000,2.5e+09,45,109,154
780930000,1225410000,493660000,2.5e+09,46,100,146
89860000,122690000,2096650000,2309200000,44,101,145
424040000,838960000,1.237e+09,2.5e+09,46,115,161
17340000,402440000,1421900000,1841680000,37,88,125
984990000,847490000,667520000,2.5e+09,40,83,123
579430000,1431470000,489100000,2.5e+09,47,87,134
1233250000,908710000,358040000,2.5e+09,42,92,134
877040000,1055840000,567120000,2.5e+09,43,90,133
748530000,1358980000,392490000,2.5e+09,48,111,159
1159600000,675490000,664910000,2.5e+09,52,118,170
721890000,1501070000,277040000,2.5e+09,45,111,156
952120000,1071670000,476210000,2.5e+09,54,125,179
401740000,1808710000,289550000,2.5e+09,47,107,154
1131070000,1028600000,340330000,2.5e+09,45,103,148
514880000,1659470000,325650000,2.5e+09,46,101,147
686550000,1364310000,449140000,2.5e+09,47,105,152
759730000,1253020000,487250000,2.5e+09,48,102,150
975520000,826410000,698070000,2.5e+09,46,110,156
713860000,1272320000,513820000,2.5e+09,49,111,160
1044210000,792180000,663610000,2.5e+09,45,110,155
1245900000,768780000,485320000,2.5e+09,49,106,155
844830000,1011590000,643580000,2.5e+09,45,95,140
1417930000,728060000,354010000,2.5e+09,45,99,144
1166060000,742350000,591590000,2.5e+09,46,107,153
954360000,1083980000,461660000,2.5e+09,49,111,160
902660000,1085680000,511660000,2.5e+09,48,105,153
707290000,1409890000,382820000,2.5e+09,51,120,171
771820000,1320860000,407320000,2.5e+09,51,121,172
396810000,798920000,1304270000,2.5e+09,44,104,148
470720000,1504650000,524630000,2.5e+09,50,111,161
481450000,414930000,1603620000,2.5e+09,52,122,174
940360000,802930000,756710000,2.5e+09,52,121,173
26910000,48260000,1305350000,1380520000,40,95,135
303340000,547180000,1437500000,2288020000,48,111,159
1175990000,1144690000,179320000,2.5e+09,44,93,137
1219550000,875910000,404540000,2.5e+09,43,89,132
508650000,1785710000,205640000,2.5e+09,44,89,133
1347340000,594400000,558260000,2.5e+09,44,94,138
744350000,1508520000,247130000,2.5e+09,44,101,145
846560000,1434700000,218740000,2.5e+09,46,111,157
778450000,1453120000,268430000,2.5e+09,45,97,142
645430000,1686730000,167840000,2.5e+09,45,109,154
552820000,1673560000,273620000,2.5e+09,49,108,157
625080000,1659810000,215110000,2.5e+09,48,111,159
736290000,1346200000,417510000,2.5e+09,51,118,169
649810000,1464810000,385380000,2.5e+09,48,113,161
1085010000,1115300000,299690000,2.5e+09,46,102,148
905390000,842290000,752320000,2.5e+09,46,110,156
606260000,1598190000,295550000,2.5e+09,48,108,156
913200000,1129700000,457100000,2.5e+09,44,111,155
1393090000,820680000,286230000,2.5e+09,48,100,148
1151740000,1010470000,337790000,2.5e+09,45,106,151
902510000,1176980000,420510000,2.5e+09,46,113,159
846610000,1254360000,399030000,2.5e+09,49,110,159
945420000,1242350000,312230000,2.5e+09,46,114,160
1232260000,850810000,416930000,2.5e+09,47,109,156
1491740000,638410000,369850000,2.5e+09,49,113,162
1191390000,1104440000,204170000,2.5e+09,48,107,155
748540000,1274120000,477340000,2.5e+09,43,100,143
711220000,1414790000,373990000,2.5e+09,47,110,157
1061200000,1163840000,274960000,2.5e+09,42,96,138
1221180000,927480000,351340000,2.5e+09,44,99,143
1036530000,1126700000,336770000,2.5e+09,47,106,153
447120000,467760000,1500660000,2415540000,43,111,154
1116890000,1135980000,247130000,2.5e+09,42,106,148
440050000,1820730000,239220000,2.5e+09,44,100,144
358990000,1586850000,554160000,2.5e+09,53,108,161
920690000,1328590000,250720000,2.5e+09,54,118,172
282480000,1784560000,432960000,2.5e+09,52,115,167
1047340000,1145170000,307490000,2.5e+09,42,103,145
335840000,1891350000,272810000,2.5e+09,55,121,176
604300000,1546570000,349130000,2.5e+09,49,117,166
788690000,1370670000,340640000,2.5e+09,51,123,174
987820000,1037720000,474460000,2.5e+09,47,105,152
901640000,1197400000,400960000,2.5e+09,46,106,152
609910000,1508790000,381300000,2.5e+09,47,107,154
835290000,974730000,689980000,2.5e+09,49,121,170
489270000,1579190000,431540000,2.5e+09,48,112,160
397580000,1915600000,186820000,2.5e+09,41,96,137
736620000,1396260000,367120000,2.5e+09,47,113,160
671700000,1501820000,326480000,2.5e+09,47,110,157
473430000,1678280000,348290000,2.5e+09,48,121,169
559710000,1607430000,332860000,2.5e+09,47,111,158
434450000,1771360000,294190000,2.5e+09,48,112,160
722570000,1387060000,390370000,2.5e+09,50,113,163
810550000,1250830000,438620000,2.5e+09,45,116,161
684970000,1426680000,388350000,2.5e+09,47,107,154
498470000,1552870000,448660000,2.5e+09,47,106,153
431960000,1870130000,197910000,2.5e+09,44,95,139
1347760000,891710000,260530000,2.5e+09,42,99,141
1121690000,1088930000,289380000,2.5e+09,45,105,150
1473270000,712420000,314310000,2.5e+09,47,110,157
653100000,1627380000,219520000,2.5e+09,47,114,161
506120000,1707090000,286790000,2.5e+09,42,101,143
63070000,2200120000,236810000,2.5e+09,44,100,144
155710000,508210000,1825370000,2489290000,41,89,130
939720000,672550000,887730000,2.5e+09,43,110,153
810540000,1058520000,630940000,2.5e+09,46,113,159
789060000,240560000,1470380000,2.5e+09,45,107,152
69880000,224830000,1898830000,2193540000,42,110,152
1942520000,275580000,281900000,2.5e+09,42,97,139
1903880000,394760000,201360000,2.5e+09,41,101,142
525120000,1269920000,704960000,2.5e+09,42,104,146
1669220000,560640000,270140000,2.5e+09,40,98,138
1654110000,323370000,522520000,2.5e+09,41,94,135
578970000,216530000,1704500000,2.5e+09,39,94,133
2048220000,7.4e+07,377780000,2.5e+09,33,88,121
1823980000,201250000,474770000,2.5e+09,39,92,131
1599500000,12450000,888050000,2.5e+09,33,91,124
1756030000,20230000,723740000,2.5e+09,33,88,121
1157870000,15480000,1326650000,2.5e+09,38,108,146
613260000,10970000,1875770000,2.5e+09,30,91,121
827840000,7620000,1664540000,2.5e+09,34,94,128
1936070000,233170000,330760000,2.5e+09,43,100,143
1563460000,598690000,337850000,2.5e+09,46,111,157
1815990000,232420000,451590000,2.5e+09,43,100,143
1233130000,380890000,885980000,2.5e+09,47,122,169
1974630000,209110000,316260000,2.5e+09,42,100,142
1711250000,241290000,547460000,2.5e+09,42,106,148
1812470000,355850000,331680000,2.5e+09,39,93,132
1848180000,238120000,413700000,2.5e+09,41,98,139
1062240000,1111890000,325870000,2.5e+09,42,107,149
1498710000,653540000,347750000,2.5e+09,39,99,138
703010000,518140000,1278850000,2.5e+09,41,111,152
1258270000,365710000,876020000,2.5e+09,40,94,134
673120000,290640000,1536240000,2.5e+09,42,99,141
425450000,230580000,1843970000,2.5e+09,39,99,138
1670410000,317630000,511960000,2.5e+09,42,100,142
1515300000,280200000,704500000,2.5e+09,41,103,144
1836590000,60790000,602620000,2.5e+09,32,90,122
1791100000,192840000,516060000,2.5e+09,39,93,132
1839410000,13260000,647330000,2.5e+09,33,91,124
1799030000,39780000,661190000,2.5e+09,32,92,124
1658500000,32800000,808700000,2.5e+09,33,91,124
1402390000,33120000,1064490000,2.5e+09,33,89,122
1691520000,64370000,744110000,2.5e+09,34,106,140
1197130000,4840000,1298030000,2.5e+09,32,91,123
1390800000,1700000,1107500000,2.5e+09,32,88,120
1466380000,23720000,1009900000,2.5e+09,34,89,123
1511140000,650000,988210000,2.5e+09,33,87,120
1051080000,2090000,1446830000,2.5e+09,33,93,126
1480860000,10690000,1008450000,2.5e+09,34,94,128
1464460000,161120000,874420000,2.5e+09,34,96,130
1414800000,22910000,1062290000,2.5e+09,32,89,121
1510190000,57460000,932350000,2.5e+09,37,99,136
2087810000,139460000,272730000,2.5e+09,43,97,140
738990000,174080000,1586860000,2499930000,43,119,162
183480000,396900000,1918190000,2498570000,45,125,170
1904130000,262440000,333430000,2.5e+09,39,92,131
2094550000,105140000,300310000,2.5e+09,41,95,136
1813840000,180980000,505180000,2.5e+09,44,110,154
1504440000,194180000,801380000,2.5e+09,43,111,154
1000500000,1078880000,420620000,2.5e+09,40,104,144
1764510000,207740000,527750000,2.5e+09,37,96,133
908960000,479080000,1111960000,2.5e+09,45,114,159
999790000,890860000,609350000,2.5e+09,41,107,148
1785880000,340310000,373810000,2.5e+09,41,96,137
1134820000,761400000,603780000,2.5e+09,41,98,139
1514610000,493190000,492200000,2.5e+09,41,98,139
1720050000,198690000,581260000,2.5e+09,37,101,138
1759840000,207740000,532420000,2.5e+09,39,100,139
1627540000,422160000,450300000,2.5e+09,39,100,139
1301830000,733580000,464590000,2.5e+09,42,109,151
1795700000,43210000,661090000,2.5e+09,33,97,130
1820550000,155420000,524030000,2.5e+09,34,102,136
1865070000,154500000,480430000,2.5e+09,36,93,129
1772620000,36530000,690850000,2.5e+09,33,100,133
1788690000,37080000,674230000,2.5e+09,38,104,142
1621970000,95290000,782740000,2.5e+09,37,101,138
1803090000,212870000,484040000,2.5e+09,40,101,141
1704720000,25060000,770220000,2.5e+09,33,90,123
1533930000,31010000,935060000,2.5e+09,34,96,130
1655810000,51550000,792640000,2.5e+09,33,94,127
1736580000,83900000,679520000,2.5e+09,34,95,129
1353770000,39850000,1106380000,2.5e+09,33,91,124
1566190000,45420000,888390000,2.5e+09,33,93,126
1597610000,36130000,866260000,2.5e+09,34,97,131
1621320000,64840000,813840000,2.5e+09,36,99,135
104540000,80390000,2299710000,2484640000,39,110,149
1171320000,510830000,817850000,2.5e+09,41,98,139
1138680000,583190000,778130000,2.5e+09,45,107,152
932960000,314560000,1252480000,2.5e+09,42,109,151
364040000,114280000,1951160000,2429480000,43,108,151
1466160000,537450000,496390000,2.5e+09,42,108,150
967870000,1086690000,445440000,2.5e+09,41,105,146
452690000,14490000,1761180000,2228360000,40,112,152
1150010000,104200000,1245790000,2.5e+09,43,118,161
845850000,89510000,1564640000,2.5e+09,38,105,143
473020000,43130000,1944380000,2460530000,40,106,146
1739860000,94600000,665540000,2.5e+09,38,103,141
1234750000,180650000,1084600000,2.5e+09,45,121,166
1524840000,18740000,956420000,2.5e+09,33,98,131
1784670000,105810000,609520000,2.5e+09,34,98,132
773040000,105850000,1621110000,2.5e+09,27,76,103
769470000,80910000,1649620000,2.5e+09,30,85,115
315160000,120480000,2064360000,2.5e+09,30,77,107
648070000,70510000,1781420000,2.5e+09,28,74,102
171640000,112140000,2216220000,2.5e+09,30,81,111
764820000,22700000,1712480000,2.5e+09,31,86,117
511310000,13540000,1975150000,2.5e+09,32,87,119
1052880000,5260000,1441860000,2.5e+09,29,90,119
1220820000,4500000,1274680000,2.5e+09,32,92,124
787050000,31470000,1681480000,2.5e+09,24,56,80
821970000,21260000,1656770000,2.5e+09,25,81,106
499160000,6270000,1994570000,2.5e+09,26,87,113
317080000,46520000,2136400000,2.5e+09,25,75,100
784940000,143330000,1571730000,2.5e+09,35,96,131
643610000,29570000,1826820000,2.5e+09,39,103,142
171270000,32040000,2118230000,2321540000,29,86,115
268340000,56470000,2175190000,2.5e+09,32,87,119
562980000,54830000,1882190000,2.5e+09,29,83,112
1356410000,8100000,1135490000,2.5e+09,33,96,129
1413540000,30410000,1056050000,2.5e+09,32,87,119
1274440000,23140000,1202420000,2.5e+09,32,97,129
1429480000,24440000,1046080000,2.5e+09,33,98,131
1258690000,3950000,1237360000,2.5e+09,32,96,128
1426130000,3350000,1070520000,2.5e+09,32,95,127
1690200000,6840000,802960000,2.5e+09,33,98,131
1399610000,4280000,1096110000,2.5e+09,34,96,130
148460000,1660000,2349880000,2.5e+09,25,77,102
354140000,470000,2145390000,2.5e+09,29,84,113
1105960000,0,1394040000,2.5e+09,31,90,121
611390000,28410000,1860200000,2.5e+09,33,96,129
483610000,30130000,1986260000,2.5e+09,25,64,89
675420000,60090000,1764490000,2.5e+09,28,78,106
622240000,48290000,1829470000,2.5e+09,28,79,107
453710000,37060000,2009230000,2.5e+09,26,78,104
762160000,127330000,1610510000,2.5e+09,28,80,108
1234010000,16100000,1249890000,2.5e+09,32,94,126
1414330000,19920000,1065750000,2.5e+09,34,97,131
1359360000,1.9e+07,1121640000,2.5e+09,32,94,126
259890000,0,2240110000,2.5e+09,25,76,101
982890000,3e+05,1516810000,2.5e+09,32,90,122
795250000,71440000,1633310000,2.5e+09,21,59,80
34950000,283470000,2181580000,2.5e+09,15,59,74
100620000,493410000,1905970000,2.5e+09,31,96,127
422240000,724990000,1352770000,2.5e+09,34,104,138
39840000,691870000,1768290000,2.5e+09,39,107,146
1196180000,286930000,1016890000,2.5e+09,36,103,139
56600000,570090000,1873310000,2.5e+09,20,63,83
11900000,922240000,1565860000,2.5e+09,12,54,66
377580000,1116990000,1005430000,2.5e+09,24,73,97
298880000,1203720000,997400000,2.5e+09,22,60,82
181920000,937670000,1380410000,2.5e+09,32,97,129
30660000,595930000,1873410000,2.5e+09,28,78,106
883700000,359880000,1256420000,2.5e+09,26,90,116
229470000,769150000,1501380000,2.5e+09,27,78,105
376250000,558220000,1565530000,2.5e+09,35,96,131
149010000,1422780000,928210000,2.5e+09,34,97,131
408950000,905840000,1185210000,2.5e+09,32,89,121
163610000,616830000,1719560000,2.5e+09,27,83,110
0,51800000,2004920000,2056720000,12,41,53
44010000,457430000,1998560000,2.5e+09,16,60,76
366990000,732820000,1400190000,2.5e+09,27,82,109
561910000,683870000,1254220000,2.5e+09,25,81,106
138940000,812830000,1548230000,2.5e+09,20,58,78
77020000,250160000,2172820000,2.5e+09,16,63,79
558970000,564710000,1376320000,2.5e+09,33,104,137
289440000,408200000,1802360000,2.5e+09,25,67,92
107520000,1027640000,1364840000,2.5e+09,27,80,107
279290000,538380000,1682330000,2.5e+09,18,59,77
6150000,1977790000,516060000,2.5e+09,19,77,96
141420000,1224570000,1134010000,2.5e+09,34,93,127
366770000,464700000,1619290000,2450760000,29,74,103
327970000,513490000,1658540000,2.5e+09,20,62,82
672140000,353890000,1473970000,2.5e+09,21,67,88
268580000,284550000,1946870000,2.5e+09,29,100,129
700540000,1495230000,304230000,2.5e+09,38,81,119
447160000,1736750000,316090000,2.5e+09,47,106,153
673110000,1516710000,310180000,2.5e+09,35,82,117
1198400000,502580000,799020000,2.5e+09,30,94,124
333800000,1914430000,251770000,2.5e+09,41,83,124
363420000,1666190000,470390000,2.5e+09,46,96,142
340460000,1805110000,354430000,2.5e+09,31,67,98
7500000,2273400000,219100000,2.5e+09,39,90,129
260860000,1939780000,299360000,2.5e+09,42,90,132
286440000,1823370000,390190000,2.5e+09,40,97,137
501870000,1672630000,325500000,2.5e+09,41,91,132
284460000,1311750000,903790000,2.5e+09,40,97,137
492600000,1521050000,486350000,2.5e+09,40,90,130
813450000,1112470000,574080000,2.5e+09,49,107,156
169420000,1769570000,561010000,2.5e+09,43,108,151
498510000,1229280000,772210000,2.5e+09,40,90,130
455620000,1344500000,699880000,2.5e+09,41,92,133
779960000,1555340000,164700000,2.5e+09,28,79,107
1214020000,772020000,513960000,2.5e+09,28,80,108
245090000,1919640000,335270000,2.5e+09,46,93,139
111300000,1878300000,510400000,2.5e+09,43,94,137
18280000,2031620000,450100000,2.5e+09,46,104,150
118610000,1845840000,535550000,2.5e+09,51,116,167
4420000,2205220000,290360000,2.5e+09,37,86,123
13350000,1943900000,542750000,2.5e+09,50,114,164
206050000,1753170000,540780000,2.5e+09,42,101,143
217600000,1715230000,567170000,2.5e+09,47,105,152
30660000,2200640000,268700000,2.5e+09,32,88,120
33740000,2123600000,342660000,2.5e+09,36,88,124
183020000,1898240000,418740000,2.5e+09,38,90,128
98670000,1627860000,773470000,2.5e+09,45,111,156
557150000,1067240000,875610000,2.5e+09,41,120,161
771510000,897340000,831150000,2.5e+09,48,132,180
904590000,523770000,1071640000,2.5e+09,34,90,124
803310000,798660000,898030000,2.5e+09,44,129,173
680050000,1547450000,272500000,2.5e+09,30,71,101
448790000,1535330000,515880000,2.5e+09,48,111,159
1698430000,360480000,441090000,2.5e+09,35,79,114
1689470000,414450000,396080000,2.5e+09,30,79,109
222730000,1718550000,558720000,2.5e+09,34,81,115
146580000,1935010000,418410000,2.5e+09,27,74,101
871980000,979670000,648350000,2.5e+09,27,81,108
1213840000,703960000,582200000,2.5e+09,33,74,107
134290000,1664970000,700740000,2.5e+09,39,97,136
89840000,1905540000,504620000,2.5e+09,31,83,114
707150000,1166510000,626340000,2.5e+09,38,89,127
1181020000,802580000,516400000,2.5e+09,33,77,110
97510000,1451940000,950550000,2.5e+09,41,102,143
53070000,1811230000,635700000,2.5e+09,35,93,128
705900000,1323250000,470850000,2.5e+09,40,85,125
262660000,1634620000,602720000,2.5e+09,32,88,120
440070000,1335980000,723950000,2.5e+09,45,128,173
98020000,926560000,1475420000,2.5e+09,33,94,127
840710000,767920000,891370000,2.5e+09,37,106,143
355020000,1830740000,314240000,2.5e+09,34,99,133
902830000,980490000,616680000,2.5e+09,50,130,180
298380000,1402340000,799280000,2.5e+09,35,102,137
1185440000,596370000,718190000,2.5e+09,30,98,128
893120000,799700000,807180000,2.5e+09,47,123,170
1224340000,527870000,747790000,2.5e+09,42,130,172
996820000,577090000,926090000,2.5e+09,39,114,153
453890000,1171720000,874390000,2.5e+09,42,126,168
177350000,1800300000,522350000,2.5e+09,32,92,124
1351580000,471380000,677040000,2.5e+09,27,68,95
438380000,1612300000,449320000,2.5e+09,19,70,89
1531850000,247660000,720490000,2.5e+09,23,70,93
1468860000,429790000,601350000,2.5e+09,30,81,111
1593940000,428560000,477500000,2.5e+09,24,66,90
1263160000,337930000,898910000,2.5e+09,30,79,109
229170000,1684820000,586010000,2.5e+09,34,78,112
865330000,657180000,977490000,2.5e+09,37,103,140
372390000,1343980000,783630000,2.5e+09,37,103,140
1589580000,433600000,476820000,2.5e+09,35,114,149
906210000,864230000,729560000,2.5e+09,43,105,148
1190460000,721460000,588080000,2.5e+09,36,107,143
248420000,1703620000,547960000,2.5e+09,36,83,119
369140000,1312980000,817880000,2.5e+09,41,99,140
1185710000,386310000,927980000,2.5e+09,35,88,123
702430000,1202440000,595130000,2.5e+09,45,106,151
370240000,1466240000,663520000,2.5e+09,49,122,171
853930000,747360000,898710000,2.5e+09,50,113,163
746410000,1282040000,471550000,2.5e+09,52,119,171
533790000,1665820000,300390000,2.5e+09,46,104,150
1231500000,919040000,349460000,2.5e+09,47,107,154
688300000,1245920000,565780000,2.5e+09,48,105,153
791850000,1187790000,520360000,2.5e+09,44,112,156
516050000,1473500000,510450000,2.5e+09,46,106,152
425550000,1691230000,383220000,2.5e+09,46,114,160
226490000,1916270000,357240000,2.5e+09,46,115,161
521870000,1476130000,5.02e+08,2.5e+09,44,114,158
700690000,1409180000,390130000,2.5e+09,43,105,148
232120000,1996750000,271130000,2.5e+09,45,105,150
558640000,1757300000,184060000,2.5e+09,47,110,157
553380000,1685170000,261450000,2.5e+09,48,117,165
1045030000,1216210000,238760000,2.5e+09,49,106,155
779930000,1469030000,251040000,2.5e+09,46,109,155
350640000,1861170000,288190000,2.5e+09,49,106,155
440010000,1833380000,226610000,2.5e+09,48,112,160
425100000,358770000,1687460000,2471330000,46,111,157
727670000,1243680000,528650000,2.5e+09,47,107,154
74770000,918940000,1506290000,2.5e+09,54,117,171
1319450000,802100000,378450000,2.5e+09,39,87,126
487390000,1808690000,203920000,2.5e+09,57,112,169
1226820000,765830000,507350000,2.5e+09,44,108,152
904780000,1228320000,366900000,2.5e+09,51,107,158
1530960000,568530000,400510000,2.5e+09,46,114,160
911100000,1104210000,484690000,2.5e+09,48,112,160
1414160000,705360000,380480000,2.5e+09,48,117,165
1289370000,557880000,652750000,2.5e+09,38,102,140
1594340000,338710000,566950000,2.5e+09,46,117,163
375680000,1910940000,213380000,2.5e+09,47,105,152
630020000,1528510000,341470000,2.5e+09,40,108,148
199950000,1818670000,481380000,2.5e+09,47,112,159
710840000,1517690000,271470000,2.5e+09,45,109,154
816940000,1231790000,451270000,2.5e+09,44,108,152
843080000,1196760000,460160000,2.5e+09,46,108,154
1079600000,955180000,465220000,2.5e+09,47,111,158
737710000,1296230000,466060000,2.5e+09,50,114,164
315240000,1850460000,334300000,2.5e+09,46,109,155
633180000,1549430000,317390000,2.5e+09,47,112,159
536630000,1415140000,548230000,2.5e+09,44,109,153
506880000,1707440000,285680000,2.5e+09,47,111,158
605200000,1359610000,535190000,2.5e+09,41,105,146
382180000,1891170000,226650000,2.5e+09,48,114,162
456110000,1679560000,364330000,2.5e+09,38,100,138
471290000,1679530000,349180000,2.5e+09,48,112,160
730090000,1506290000,263620000,2.5e+09,47,106,153
639830000,1566610000,293560000,2.5e+09,44,105,149
703650000,1507490000,288860000,2.5e+09,47,119,166
1267440000,825580000,406980000,2.5e+09,48,112,160
0,0,2.24e+08,2.24e+08,48,117,165
443040000,913790000,597620000,1954450000,51,107,158
313450000,922230000,93390000,1329070000,50,115,165
11570000,0,919730000,931300000,35,84,119
1252450000,950200000,297350000,2.5e+09,46,117,163
1319740000,671990000,508270000,2.5e+09,45,96,141
1207450000,788870000,503680000,2.5e+09,48,115,163
867190000,1146370000,486440000,2.5e+09,42,90,132
1042100000,680430000,777470000,2.5e+09,38,98,136
1425360000,379670000,694970000,2.5e+09,37,98,135
1247410000,860550000,392040000,2.5e+09,46,111,157
1238780000,726180000,535040000,2.5e+09,47,104,151
631150000,1540310000,328540000,2.5e+09,47,109,156
565450000,1733140000,201410000,2.5e+09,44,104,148
626140000,1484930000,388930000,2.5e+09,47,109,156
520050000,1713140000,266810000,2.5e+09,48,108,156
407870000,1836090000,256040000,2.5e+09,46,118,164
851470000,1307490000,341040000,2.5e+09,53,120,173
703670000,1165590000,630740000,2.5e+09,47,113,160
791880000,1294010000,414110000,2.5e+09,48,115,163
534300000,1453720000,511980000,2.5e+09,46,107,153
537160000,1517830000,445010000,2.5e+09,46,115,161
787990000,1105310000,606700000,2.5e+09,46,110,156
771560000,1262770000,465670000,2.5e+09,48,114,162
547710000,1476760000,475530000,2.5e+09,49,118,167
682270000,1400500000,417230000,2.5e+09,47,113,160
614390000,1426460000,459150000,2.5e+09,52,116,168
1216060000,542850000,741090000,2.5e+09,49,107,156
701200000,1344380000,454420000,2.5e+09,50,109,159
683420000,1254510000,562070000,2.5e+09,55,122,177
181460000,776390000,121460000,1079310000,46,109,155
26920000,43920000,35050000,105890000,41,98,139
364990000,689060000,90470000,1144520000,48,116,164
630340000,1255350000,614310000,2.5e+09,50,115,165
258570000,618690000,904070000,1781330000,52,131,183
761730000,1367100000,371170000,2.5e+09,52,117,169
723580000,1255760000,501760000,2481100000,46,108,154
896910000,1208050000,395040000,2.5e+09,48,105,153
216220000,1720120000,563660000,2.5e+09,48,110,158
193820000,1496450000,414540000,2104810000,53,115,168
367770000,1644500000,487700000,2499970000,38,98,136
1396830000,761790000,341380000,2.5e+09,39,91,130
1165500000,1019750000,314750000,2.5e+09,36,102,138
1349150000,798470000,352380000,2.5e+09,48,104,152
1320380000,828760000,350860000,2.5e+09,50,116,166
1017300000,1100390000,382310000,2.5e+09,45,112,157
523830000,1312600000,322550000,2158980000,48,119,167
554770000,789550000,201900000,1546220000,58,122,180
7250000,4110000,2810000,14170000,59,127,186
352880000,1773600000,373520000,2.5e+09,49,107,156
764110000,1484130000,251760000,2.5e+09,48,110,158
455320000,1193170000,424390000,2072880000,57,125,182
325550000,1.801e+09,373450000,2.5e+09,54,123,177
579880000,1418530000,489040000,2487450000,47,112,159
584770000,1332140000,583090000,2.5e+09,54,123,177
289950000,480990000,255580000,1026520000,48,114,162
540160000,550720000,279570000,1370450000,58,130,188
556110000,1350240000,593650000,2.5e+09,51,115,166
694730000,1365530000,439740000,2.5e+09,47,109,156
1149760000,677360000,493780000,2320900000,56,128,184
576420000,360070000,216180000,1152670000,52,124,176
863220000,1285910000,350870000,2.5e+09,49,118,167
636770000,9.84e+08,879230000,2.5e+09,54,126,180
1105530000,461150000,288270000,1854950000,54,117,171
528550000,833620000,250230000,1612400000,48,113,161
267160000,1590780000,267180000,2125120000,48,115,163
3.77e+08,1742990000,270280000,2390270000,51,114,165
823010000,1197500000,479490000,2.5e+09,48,105,153
402090000,1487300000,610610000,2.5e+09,54,121,175
658920000,1334750000,506330000,2.5e+09,48,105,153
522450000,1683660000,293890000,2.5e+09,40,93,133
560200000,1667950000,271850000,2.5e+09,38,91,129
0,5e+05,3850000,4350000,43,100,143
123790000,1063210000,437890000,1624890000,46,102,148
451600000,445180000,344660000,1241440000,44,97,141
897980000,194850000,205530000,1298360000,45,111,156
670040000,45610000,119360000,835010000,38,91,129
354330000,186320000,326320000,866970000,42,96,138
437920000,47670000,2014410000,2.5e+09,42,106,148
926780000,224530000,1348690000,2.5e+09,44,113,157
1311300000,452610000,736090000,2.5e+09,45,115,160
1739890000,26770000,733340000,2.5e+09,34,97,131
1825860000,163810000,510330000,2.5e+09,38,119,157
568640000,37780000,1678900000,2285320000,38,111,149
1080220000,109480000,1310300000,2.5e+09,41,122,163
915250000,864830000,719920000,2.5e+09,48,113,161
773870000,1170880000,555250000,2.5e+09,51,125,176
1018930000,941400000,539670000,2.5e+09,45,108,153
698640000,1452900000,348460000,2.5e+09,47,118,165
712720000,276250000,1511030000,2.5e+09,44,101,145
1210520000,570140000,719340000,2.5e+09,46,103,149
151450000,44100000,2304450000,2.5e+09,38,91,129
861590000,399700000,1238710000,2.5e+09,47,127,174
932950000,306700000,1260350000,2.5e+09,45,124,169
877230000,4.02e+08,1220770000,2.5e+09,42,126,168
1240590000,771980000,487430000,2.5e+09,42,119,161
1201990000,929880000,368130000,2.5e+09,43,120,163
1156850000,150090000,1193060000,2.5e+09,50,135,185
662130000,209640000,1628230000,2.5e+09,49,136,185
1618670000,419010000,462320000,2.5e+09,38,106,144
1793820000,394780000,311400000,2.5e+09,43,117,160
1055200000,389270000,1055530000,2.5e+09,47,133,180
1.303e+09,430390000,766610000,2.5e+09,47,129,176
1098850000,921600000,479550000,2.5e+09,40,107,147
1378610000,628570000,492820000,2.5e+09,37,105,142
482740000,70110000,1947150000,2.5e+09,44,118,162
337280000,127190000,1903130000,2367600000,43,121,164
1109290000,524120000,866590000,2.5e+09,42,115,157
798020000,1180520000,521460000,2.5e+09,43,96,139
710690000,1350150000,439160000,2.5e+09,44,104,148
685300000,1.468e+09,346700000,2.5e+09,43,107,150
815680000,702340000,981980000,2.5e+09,49,121,170
394090000,141770000,1926450000,2462310000,48,121,169
401230000,245840000,1793260000,2440330000,42,123,165
645290000,311460000,1543250000,2.5e+09,50,131,181
31250000,44950000,2150320000,2226520000,41,104,145
62400000,10730000,2078470000,2151600000,37,99,136
346870000,214930000,1938200000,2.5e+09,44,132,176
770270000,320260000,1409470000,2.5e+09,44,119,163
1066260000,700450000,733290000,2.5e+09,47,129,176
1455440000,590310000,454250000,2.5e+09,45,128,173
281930000,21660000,1928830000,2232420000,48,120,168
1347750000,892990000,259260000,2.5e+09,41,118,159
1149560000,1.107e+09,243440000,2.5e+09,39,115,154
1777700000,190710000,531590000,2.5e+09,40,108,148
1219970000,502050000,777980000,2.5e+09,42,116,158
1482580000,500900000,516520000,2.5e+09,38,115,153
1550290000,387440000,562270000,2.5e+09,38,109,147
1176720000,396110000,927170000,2.5e+09,43,122,165
1445240000,426180000,628580000,2.5e+09,37,117,154
1445040000,18280000,1036680000,2.5e+09,33,98,131
1572100000,18570000,909330000,2.5e+09,34,95,129
1071120000,7470000,1421410000,2.5e+09,32,92,124
794880000,0,1705120000,2.5e+09,26,92,118
1210260000,148130000,1141610000,2.5e+09,34,87,121
404730000,14670000,2080600000,2.5e+09,26,71,97
352140000,21930000,2125930000,2.5e+09,25,83,108
148620000,0,2351380000,2.5e+09,20,65,85
480260000,63220000,1956520000,2.5e+09,29,80,109
127350000,13430000,2359220000,2.5e+09,21,54,75
387090000,65370000,2047540000,2.5e+09,26,65,91
1688360000,10750000,800890000,2.5e+09,34,100,134
1842980000,49960000,607060000,2.5e+09,34,96,130
1861100000,195150000,443750000,2.5e+09,36,103,139
1905540000,155550000,438910000,2.5e+09,35,111,146
1415610000,6080000,1078310000,2.5e+09,32,94,126
1587840000,19350000,892810000,2.5e+09,32,99,131
1802860000,30120000,667020000,2.5e+09,33,98,131
1477590000,470000,1021940000,2.5e+09,31,90,121
1614960000,5420000,879620000,2.5e+09,31,93,124
1708680000,0,791320000,2.5e+09,28,91,119
1675810000,1720000,822470000,2.5e+09,31,93,124
743770000,0,1756230000,2.5e+09,28,93,121
1273920000,490000,1225590000,2.5e+09,27,84,111
1298070000,820000,1201110000,2.5e+09,27,87,114
229370000,0,2270630000,2.5e+09,24,84,108
836070000,7250000,1656680000,2.5e+09,20,70,90
881040000,1990000,1616970000,2.5e+09,20,76,96
459920000,1930000,2038150000,2.5e+09,11,54,65
504560000,53940000,1713010000,2271510000,32,107,139
469480000,56170000,1569250000,2094900000,35,107,142
472770000,22720000,2004510000,2.5e+09,37,110,147
1521060000,59400000,919540000,2.5e+09,35,109,144
1389370000,2600000,1108030000,2.5e+09,28,86,114
1205530000,7930000,1286540000,2.5e+09,29,87,116
1292880000,3840000,1203280000,2.5e+09,32,94,126
1560310000,1650000,938040000,2.5e+09,33,90,123
451070000,0,2048930000,2.5e+09,22,74,96
428230000,137730000,1737120000,2303080000,42,121,163
1486880000,60800000,952320000,2.5e+09,33,108,141
1704540000,17770000,777690000,2.5e+09,33,98,131
1620160000,16400000,863440000,2.5e+09,33,105,138
1302620000,369700000,827680000,2.5e+09,35,113,148
173300000,586690000,1740010000,2.5e+09,44,126,170
1838600000,279560000,381840000,2.5e+09,36,94,130
816020000,1147490000,536490000,2.5e+09,30,82,112
1398640000,534560000,566800000,2.5e+09,38,101,139
904750000,753770000,841480000,2.5e+09,32,87,119
1294550000,432290000,773160000,2.5e+09,37,111,148
92390000,680760000,1625830000,2398980000,54,135,189
901460000,794650000,803890000,2.5e+09,38,105,143
179210000,691900000,1607440000,2478550000,45,111,156
1627990000,385290000,486720000,2.5e+09,41,114,155
688090000,1071880000,740030000,2.5e+09,45,112,157
1146430000,726910000,626660000,2.5e+09,44,126,170
1424630000,637570000,437800000,2.5e+09,41,114,155
1486310000,391980000,621710000,2.5e+09,26,84,110
625370000,1203680000,670950000,2.5e+09,44,106,150
1318660000,389220000,792120000,2.5e+09,38,103,141
848700000,659260000,992040000,2.5e+09,39,103,142
1452630000,248700000,738030000,2439360000,25,75,100
1551030000,360400000,494370000,2405800000,21,61,82
1547850000,176790000,775360000,2.5e+09,25,74,99
992550000,865870000,641580000,2.5e+09,37,104,141
452590000,1034510000,1012900000,2.5e+09,57,137,194
109370000,1983990000,406640000,2.5e+09,23,64,87
549160000,1283590000,667250000,2.5e+09,43,110,153
357650000,1614160000,528190000,2.5e+09,35,94,129
136380000,1770960000,592660000,2.5e+09,30,81,111
941140000,1086940000,471920000,2.5e+09,29,87,116
1109650000,867060000,523290000,2.5e+09,40,119,159
861150000,1239830000,399020000,2.5e+09,42,106,148
662030000,1410800000,427170000,2.5e+09,41,108,149
252310000,1857400000,390290000,2.5e+09,36,103,139
442020000,1610620000,447360000,2.5e+09,52,129,181
326310000,1800820000,372870000,2.5e+09,42,107,149
495840000,1683850000,320310000,2.5e+09,35,92,127
257760000,1714880000,527360000,2.5e+09,29,80,109
1029210000,811120000,659670000,2.5e+09,33,93,126
1495470000,378030000,626500000,2.5e+09,22,65,87
1824340000,193370000,482290000,2.5e+09,37,91,128
1501700000,106340000,891960000,2.5e+09,25,70,95
1648410000,144360000,707230000,2.5e+09,31,83,114
499260000,1337270000,663470000,2.5e+09,30,72,102
1244010000,885690000,370300000,2.5e+09,51,130,181
652560000,133510000,1496330000,2282400000,47,115,162
745220000,1329390000,425390000,2.5e+09,46,111,157
460940000,1427260000,611800000,2.5e+09,59,141,200
459580000,658700000,1381720000,2.5e+09,56,128,184
296340000,221410000,1732870000,2250620000,46,110,156
425240000,1674620000,400140000,2.5e+09,45,119,164
400140000,1825160000,274700000,2.5e+09,36,94,130
195180000,1970670000,334150000,2.5e+09,35,90,125
39400000,2220120000,240480000,2.5e+09,22,75,97
158840000,1516760000,262250000,1937850000,46,115,161
581050000,1354180000,564770000,2.5e+09,25,67,92
356240000,1277510000,471310000,2105060000,29,80,109
121290000,939920000,455820000,1517030000,47,106,153
438050000,1212180000,812180000,2462410000,35,90,125
174900000,312850000,209570000,697320000,44,102,146
16180000,1028410000,1444280000,2488870000,44,108,152
557580000,1380180000,562240000,2.5e+09,48,109,157
58340000,256920000,2184740000,2.5e+09,44,102,146
213990000,443770000,271400000,929160000,38,110,148
123200000,358420000,1090570000,1572190000,40,105,145
673530000,1314770000,511700000,2.5e+09,50,119,169
1087940000,1054540000,357520000,2.5e+09,48,108,156
758540000,1246680000,494780000,2.5e+09,47,104,151
1.055e+09,789250000,441200000,2285450000,49,112,161
717220000,1501540000,281240000,2.5e+09,40,96,136
725520000,1416470000,358010000,2.5e+09,45,102,147
712850000,1379040000,408110000,2.5e+09,48,108,156
535150000,1619680000,345170000,2.5e+09,48,106,154
333650000,1730000,113960000,449340000,34,82,116
241540000,51400000,54660000,347600000,36,85,121
15380000,56840000,20130000,92350000,49,111,160
856320000,142160000,261250000,1259730000,47,108,155
757790000,383810000,247440000,1389040000,47,107,154
764330000,1324650000,411020000,2.5e+09,49,105,154
1103070000,898010000,498920000,2.5e+09,47,115,162
712690000,629960000,598610000,1941260000,50,113,163
298810000,750940000,294270000,1344020000,46,113,159
129310000,1410370000,583770000,2123450000,44,99,143
237850000,252880000,174920000,665650000,45,119,164
8240000,234820000,123500000,366560000,43,98,141
1027660000,1044470000,427870000,2.5e+09,38,95,133
347090000,1985300000,167610000,2.5e+09,37,90,127
1281240000,562180000,656580000,2.5e+09,41,105,146
783190000,1351240000,365570000,2.5e+09,42,102,144
856970000,378610000,1264420000,2.5e+09,46,115,161
1148750000,910700000,440550000,2.5e+09,39,109,148
1276280000,752890000,470830000,2.5e+09,43,108,151
1148940000,488510000,862550000,2.5e+09,46,131,177
1285070000,683820000,531110000,2.5e+09,47,127,174
881010000,772600000,846390000,2.5e+09,49,129,178
1284470000,737040000,478490000,2.5e+09,42,103,145
862330000,380120000,1257550000,2.5e+09,49,130,179
1442140000,518640000,539220000,2.5e+09,44,123,167
1392240000,734210000,373550000,2.5e+09,42,119,161
1696610000,184080000,619310000,2.5e+09,38,109,147
1510720000,354850000,634430000,2.5e+09,40,116,156
1738620000,185200000,576180000,2.5e+09,38,111,149
1887840000,75710000,536450000,2.5e+09,38,101,139
1220560000,391930000,887510000,2.5e+09,37,104,141
1307470000,160250000,1032280000,2.5e+09,41,112,153
1101970000,551820000,846210000,2.5e+09,44,109,153
743930000,694280000,1061790000,2.5e+09,48,130,178
1301540000,732100000,466360000,2.5e+09,39,109,148
1224370000,471020000,804610000,2.5e+09,39,98,137
1.338e+09,585670000,576330000,2.5e+09,42,111,153
1262780000,677800000,559420000,2.5e+09,41,111,152
1045510000,780710000,673780000,2.5e+09,41,119,160
1234080000,801680000,464240000,2.5e+09,41,110,151
923520000,923330000,653150000,2.5e+09,46,128,174
1081290000,988200000,430510000,2.5e+09,39,109,148
1228460000,617130000,654410000,2.5e+09,45,128,173
1136080000,840820000,523100000,2.5e+09,38,109,147
1075970000,732780000,691250000,2.5e+09,42,118,160
1327570000,734910000,437520000,2.5e+09,43,116,159
539490000,206220000,1718080000,2463790000,46,121,167
197560000,33470000,1908240000,2139270000,38,117,155
142360000,11770000,2014910000,2169040000,38,103,141
1297090000,468500000,734410000,2.5e+09,49,125,174
1191370000,936650000,371980000,2.5e+09,39,116,155
1590870000,267620000,641510000,2.5e+09,40,118,158
1322520000,754690000,422790000,2.5e+09,45,126,171
1576860000,201930000,721210000,2.5e+09,40,115,155
1371420000,212050000,916530000,2.5e+09,38,107,145
1740410000,108970000,650620000,2.5e+09,36,111,147
1733680000,113320000,6.53e+08,2.5e+09,38,103,141
1619700000,130280000,750020000,2.5e+09,44,107,151
1658220000,246080000,595700000,2.5e+09,40,114,154
1431050000,175460000,893490000,2.5e+09,41,114,155
1607960000,177360000,714680000,2.5e+09,44,113,157
1711090000,388920000,399990000,2.5e+09,36,106,142
1657020000,151880000,691100000,2.5e+09,39,107,146
1660200000,308140000,531660000,2.5e+09,36,103,139
1716990000,192850000,590160000,2.5e+09,36,106,142
587730000,923280000,988990000,2.5e+09,35,101,136
777370000,858180000,860060000,2495610000,37,92,129
309090000,231600000,349370000,890060000,46,116,162
884480000,473540000,310330000,1668350000,43,105,148
921130000,749460000,656790000,2327380000,39,96,135
391580000,235150000,885510000,1512240000,39,111,150
842610000,648590000,472510000,1963710000,39,121,160
996940000,325600000,1177460000,2.5e+09,41,116,157
329720000,88440000,1187750000,1605910000,37,112,149
1776350000,242370000,481280000,2.5e+09,38,110,148
1545230000,343950000,600450000,2489630000,48,130,178
998370000,313750000,925560000,2237680000,39,128,167
1709700000,189550000,600750000,2.5e+09,39,108,147
1740790000,128680000,630530000,2.5e+09,37,104,141
1430800000,153280000,915920000,2.5e+09,41,108,149
1655820000,60730000,783450000,2.5e+09,36,108,144
1362480000,227770000,909750000,2.5e+09,41,102,143
1734550000,141320000,624130000,2.5e+09,40,107,147
1566770000,201400000,731830000,2.5e+09,36,103,139
1668410000,62180000,769410000,2.5e+09,39,107,146
1505070000,208780000,786150000,2.5e+09,35,103,138
1483760000,423910000,592330000,2.5e+09,41,120,161
1713150000,91820000,695030000,2.5e+09,35,96,131
1692440000,130040000,677520000,2.5e+09,38,102,140
1383760000,134870000,981370000,2.5e+09,40,109,149
1098490000,190390000,461810000,1750690000,45,118,163
1541840000,210400000,747760000,2.5e+09,40,112,152
1189920000,280870000,1029210000,2.5e+09,41,119,160
1693160000,47980000,757790000,2498930000,37,98,135
1195550000,130370000,1174080000,2.5e+09,41,104,145
775500000,128310000,1586670000,2490480000,48,137,185
1473230000,434850000,591920000,2.5e+09,37,109,146
183140000,16460000,2282020000,2481620000,41,115,156
1436320000,33410000,1030270000,2.5e+09,31,104,135
1376110000,220690000,903200000,2.5e+09,37,111,148
1126990000,582530000,790480000,2.5e+09,45,132,177
1638420000,296290000,565290000,2.5e+09,37,113,150
1274320000,138170000,1087510000,2.5e+09,38,111,149
1489340000,144800000,865860000,2.5e+09,38,112,150
1009210000,67430000,1423360000,2.5e+09,38,120,158
850680000,131650000,1517670000,2.5e+09,46,128,174
1084960000,40710000,1374330000,2.5e+09,35,106,141
1260970000,51560000,1187470000,2.5e+09,37,104,141
1435510000,22500000,1041990000,2.5e+09,35,105,140
1159940000,68740000,1271320000,2.5e+09,30,102,132
1593830000,20790000,885380000,2.5e+09,32,99,131
1174910000,32720000,1292370000,2.5e+09,33,102,135
1640050000,9450000,850500000,2.5e+09,29,83,112
1704580000,15280000,780140000,2.5e+09,31,92,123
1428450000,26820000,1044730000,2.5e+09,33,93,126
1382660000,6310000,1111030000,2.5e+09,31,90,121
1495670000,620000,1003710000,2.5e+09,27,76,103
1498570000,12200000,989230000,2.5e+09,32,89,121
1616300000,0,883700000,2.5e+09,30,85,115
1297770000,1630000,1200600000,2.5e+09,32,93,125
1677400000,620000,821980000,2.5e+09,15,56,71
1355580000,0,1144420000,2.5e+09,25,84,109
1040960000,0,1459040000,2.5e+09,28,90,118
1728410000,0,771590000,2.5e+09,34,94,128
418550000,13010000,2068440000,2.5e+09,29,90,119
1123080000,2340000,1374580000,2.5e+09,22,73,95
202080000,0,2297920000,2.5e+09,21,63,84
587200000,4880000,1907920000,2.5e+09,29,93,122
1170000,0,2498830000,2.5e+09,21,69,90
181240000,8300000,2310460000,2.5e+09,22,68,90
1457070000,30660000,1012270000,2.5e+09,34,98,132
1539020000,30700000,930280000,2.5e+09,32,98,130
1536780000,89970000,873250000,2.5e+09,35,103,138
1501250000,31940000,966810000,2.5e+09,34,104,138
1159560000,21050000,1319390000,2.5e+09,35,111,146
1255110000,24910000,1219980000,2.5e+09,30,96,126
1547830000,21600000,930570000,2.5e+09,32,95,127
1323090000,18790000,1158120000,2.5e+09,32,102,134
1371980000,27100000,1100830000,2499910000,29,90,119
1523230000,7620000,969150000,2.5e+09,31,91,122
1656440000,20660000,822900000,2.5e+09,33,94,127
1689360000,5310000,805330000,2.5e+09,31,88,119
1737250000,0,762750000,2.5e+09,32,93,125
1118800000,650000,1380550000,2.5e+09,31,94,125
1619580000,0,875170000,2494750000,27,82,109
1114860000,0,1385140000,2.5e+09,30,94,124
1578720000,4920000,916360000,2.5e+09,35,106,141
802650000,33190000,1664160000,2.5e+09,26,80,106
332060000,0,2167940000,2.5e+09,26,86,112
410600000,22560000,2066840000,2.5e+09,22,76,98
991020000,3080000,1505900000,2.5e+09,28,88,116
304480000,18440000,2177080000,2.5e+09,20,61,81
86550000,7430000,2406020000,2.5e+09,21,64,85
1205580000,2.2e+07,1081960000,2309540000,31,96,127
1455100000,34380000,1004730000,2494210000,35,97,132
1224550000,11730000,680780000,1917060000,33,106,139
9.72e+08,8860000,681390000,1662250000,31,89,120
1344420000,57820000,769090000,2171330000,44,112,156
602290000,1632990000,264720000,2.5e+09,44,104,148
1672600000,44160000,783240000,2.5e+09,40,110,150
1772720000,99950000,532700000,2405370000,41,109,150
1363470000,29410000,660390000,2053270000,40,106,146
6740000,685940000,1651860000,2344540000,40,105,145
748810000,487220000,1263970000,2.5e+09,39,112,151
0,6450000,2238960000,2245410000,13,59,72
602660000,4104990000,547820000,5255470000,47,114,161
3412670000,70340000,1697320000,5180330000,34,101,135
1785230000,7169770000,1497130000,10452130000,38,105,143
129110000,3460000,5247440000,5380010000,32,76,108
2235250000,100600000,3049880000,5385730000,39,117,156
1470180000,1486900000,1504730000,4461810000,48,131,179
2017950000,6005900000,3458400000,11482250000,61,142,203
1253640000,72120000,7469650000,8795410000,37,110,147
3270660000,6273130000,793630000,10337420000,50,122,172
1187010000,6663920000,2842130000,10693060000,48,114,162
3214320000,4939310000,2193710000,10347340000,53,127,180
5485230000,1483200000,1952530000,8920960000,46,115,161
6686530000,453720000,3748600000,10888850000,46,119,165
3549600000,2743970000,6211460000,12505030000,54,144,198
1985880000,5843580000,1093420000,8922880000,40,101,141
3587550000,2253510000,10764930000,16605990000,38,126,164
4784410000,358080000,3901570000,9044060000,44,124,168
5160160000,1358740000,4051970000,10570870000,48,123,171
1901780000,4094370000,1646330000,7642480000,60,136,196
59680000,1400140000,3445390000,4905210000,41,117,158
2350660000,4220900000,2224450000,8796010000,49,114,163
1141450000,2859590000,1419770000,5420810000,50,107,157
1166640000,6715910000,2193130000,10075680000,43,103,146
7231120000,724550000,3148310000,11103980000,47,121,168
4924150000,988010000,2350290000,8262450000,49,138,187
482540000,3749030000,6601760000,10833330000,41,99,140
502150000,1033760000,9538250000,11074160000,38,92,130
3085690000,2419910000,4580010000,10085610000,51,139,190
2433050000,3560410000,1043480000,7036940000,60,143,203
2760090000,73240000,1594920000,4428250000,44,116,160
8880340000,935810000,4292050000,14108200000,43,113,156
6699600000,4869040000,2100500000,13669140000,42,109,151
2665580000,1825720000,854370000,5345670000,49,121,170
3559950000,1796510000,5504200000,10860660000,53,145,198
2691440000,4378570000,3011360000,10081370000,51,105,156
3610420000,6345940000,1453790000,11410150000,32,86,118
4652100000,2758840000,1820500000,9231440000,44,122,166
5021640000,3827920000,1503050000,10352610000,53,125,178
1929760000,4884100000,3684590000,10498450000,46,121,167
6037220000,3276190000,2100140000,11413550000,50,125,175
3110410000,4902860000,1062970000,9076240000,38,102,140
6077680000,2880860000,1373940000,10332480000,54,135,189
3111320000,5644300000,1586270000,10341890000,54,129,183
516140000,4585300000,4979810000,10081250000,49,120,169
2051950000,7390100000,4920180000,14362230000,65,150,215
4939200000,6603030000,13429360000,24971590000,36,100,136
722780000,39080000,4825720000,5587580000,37,80,117
4017650000,2027370000,3956640000,10001660000,47,133,180
3078220000,24640000,2077470000,5180330000,34,90,124
5411640000,8739510000,6573310000,20724460000,63,159,222
812780000,7738910000,2131560000,10683250000,56,127,183
2937820000,502720000,10392650000,13833190000,45,126,171
3138210000,5575320000,1367570000,10081100000,51,124,175
591610000,2852800000,598390000,4042800000,56,126,182
1496660000,765220000,8586500000,10848380000,44,110,154
821610000,5981520000,1992710000,8795840000,46,108,154
499700000,2235360000,10801400000,13536460000,34,93,127
8210560000,7728490000,7270640000,23209690000,48,126,174
5218600000,484870000,5068380000,10771850000,45,117,162
1055490000,339030000,6359890000,7754410000,48,136,184
1964910000,7138070000,1354160000,10457140000,46,111,157
7000180000,13221560000,12869880000,33091620000,63,161,224
7036550000,22940000,5277300000,12336790000,33,99,132
2225830000,6857810000,1727780000,10811420000,52,121,173
2956540000,6002740000,1763540000,10722820000,54,125,179
988880000,3033710000,1318060000,5340650000,57,125,182
552070000,2773800000,6755780000,10081650000,51,128,179
405090000,4121080000,8030670000,12556840000,50,126,176
4752270000,3305160000,2023760000,10081190000,51,124,175
3200970000,10100490000,2858640000,16160100000,47,114,161
3196150000,2112060000,5074180000,10382390000,40,123,163
3862650000,4308820000,2165890000,10337360000,52,105,157
2834200000,3248960000,4075560000,10158720000,48,135,183
3776810000,9062110000,1942510000,14781430000,49,116,165
11074400000,14730000,9681290000,20770420000,35,106,141
4027310000,5732550000,2515220000,12275080000,57,139,196
4265690000,3006570000,2808850000,10081110000,41,100,141
3542330000,4969840000,1569190000,10081360000,50,110,160
3509690000,2530610000,3924080000,9964380000,52,140,192
3311570000,4227370000,2542870000,10081810000,51,117,168
5209450000,4296390000,3416410000,12922250000,48,134,182
6635580000,791460000,2161510000,9588550000,40,116,156
3857280000,9197450000,3006050000,16060780000,54,126,180
1224470000,44680000,9758300000,11027450000,40,101,141
1.188e+10,3019890000,4034450000,18934340000,50,133,183
1857660000,3510700000,718730000,6087090000,50,110,160
3345950000,3819180000,2431990000,9597120000,52,133,185
6.933e+09,8014060000,2561010000,17508070000,56,124,180
5546390000,648330000,8911070000,15105790000,46,128,174
1964360000,223510000,6302500000,8490370000,35,93,128
3617210000,4286390000,5301810000,13205410000,56,130,186
2751930000,1334810000,5222810000,9309550000,45,117,162
598110000,4724820000,5128210000,10451140000,46,120,166
4262280000,6598310000,1389250000,12249840000,53,112,165
1280200000,2790290000,1179970000,5250460000,53,114,167
4929280000,5433420000,13315570000,23678270000,56,148,204
3424590000,1926410000,3760870000,9111870000,50,139,189
1950680000,6367300000,6681580000,14999560000,41,131,172
590010000,2377940000,9105330000,12073280000,42,108,150
977790000,538770000,9242870000,10759430000,39,98,137
1408500000,3275260000,666920000,5350680000,45,115,160
11850550000,81840000,7729500000,19661890000,36,109,145
1648640000,4812690000,12910730000,19372060000,39,121,160
5274720000,3006770000,2406090000,10687580000,48,124,172
6225380000,157170000,2548590000,8931140000,38,112,150
3016670000,4806680000,2257510000,10080860000,52,128,180
2330900000,5007220000,2505940000,9844060000,52,107,159
1524600000,123590000,3055410000,4703600000,42,102,144
5152230000,6081060000,2615020000,13848310000,39,123,162
1165370000,5276510000,7137470000,13579350000,44,106,150
2348840000,3998310000,1532450000,7879600000,55,134,189
2746230000,4535650000,1789740000,9071620000,53,132,185
3442450000,5415440000,1604760000,10462650000,46,111,157
7838890000,1847940000,5102110000,14788940000,50,124,174
1604330000,5198120000,1330810000,8133260000,52,121,173
1175010000,7310080000,4998070000,13483160000,41,107,148
9563390000,527160000,6873670000,16964220000,45,131,176
2814710000,3395110000,4568410000,10778230000,41,122,163
1645520000,4521880000,2239170000,8406570000,49,110,159
464750000,4572300000,5795910000,10832960000,42,109,151
4382370000,1087280000,5311860000,10781510000,49,132,181
4007010000,419230000,12483280000,16909520000,38,100,138
7088660000,606450000,3398770000,11093880000,44,116,160
7041880000,661140000,2634490000,10337510000,40,102,142
1108880000,481720000,5545250000,7135850000,44,125,169
549840000,384890000,13388280000,14323010000,49,110,159
10492040000,1443880000,2167530000,14103450000,41,104,145
5537290000,3175040000,4213660000,12925990000,47,121,168
6376470000,216130000,7641550000,14234150000,43,115,158
4135070000,35680000,6206850000,10377600000,34,98,132
5836400000,5379610000,2881770000,14097780000,51,117,168
3884110000,4151260000,2312210000,10347580000,53,127,180
2845890000,634120000,7197340000,10677350000,40,109,149
6822150000,73950000,5313220000,12209320000,36,107,143
937280000,2587860000,4625200000,8150340000,50,135,185
67850000,109800000,4279720000,4457370000,33,81,114
4404470000,3522930000,2414570000,10341970000,55,127,182
5451470000,1793460000,1836070000,9.081e+09,41,99,140
4185980000,371420000,4880360000,9437760000,52,130,182
5428920000,2667240000,2261140000,10357300000,42,117,159
11191670000,20870000,7214780000,18427320000,39,117,156
1277360000,285020000,6833160000,8395540000,37,105,142
3149200000,3818620000,7782990000,14750810000,40,115,155
1009740000,251230000,7195170000,8456140000,36,102,138
1908340000,4432170000,6176560000,12517070000,40,106,146
5794120000,6431430000,1787310000,14012860000,50,128,178
450690000,5868990000,3181770000,9501450000,39,122,161
2209100000,2880800000,4223030000,9312930000,42,109,151
1102870000,3523450000,10399840000,15026160000,44,110,154
4147490000,1684640000,4655220000,10487350000,42,124,166
3957880000,4690630000,2023900000,10672410000,53,127,180
5477790000,4543260000,9069790000,19090840000,55,142,197
7872120000,8394710000,3834010000,20100840000,50,119,169
3836880000,345080000,6202660000,10384620000,44,132,176
3952280000,3958640000,2170080000,1.0081e+10,51,126,177
4582450000,3500860000,2975530000,11058840000,38,104,142
92800000,1880000,2405320000,2.5e+09,26,66,92
1804510000,3649130000,3127750000,8581390000,40,100,140
1492330000,655890000,6539030000,8687250000,49,126,175
2585720000,2446180000,3215410000,8247310000,52,134,186
3371390000,5249040000,2087300000,10707730000,52,119,171
1658360000,1095210000,2687240000,5440810000,33,83,116
1186180000,6812570000,2769030000,10767780000,46,130,176
1971440000,1345420000,1768210000,5085070000,40,95,135
1654670000,12860570000,6231130000,20746370000,51,120,171
358360000,5565710000,2876870000,8800940000,47,118,165
3003180000,9862200000,1337350000,14202730000,45,109,154
1822860000,7221420000,6474120000,15518400000,42,101,143
7336500000,788490000,2978930000,11103920000,47,126,173
5186410000,48940000,5137210000,10372560000,36,106,142
3445810000,3358420000,3438990000,10243220000,45,116,161
1621100000,542230000,3002430000,5165760000,47,133,180
3250160000,5222810000,1868950000,10341920000,50,123,173
1025470000,3210290000,1034680000,5270440000,38,109,147
2020980000,1523210000,1826520000,5370710000,45,133,178
4542210000,13517950000,2610790000,20670950000,53,124,177
3124450000,7337910000,581040000,11043400000,38,107,145
3953920000,811560000,8094070000,12859550000,43,117,160
5466250000,7471600000,3133050000,16070900000,58,134,192
2088500000,3769450000,3948980000,9806930000,57,136,193
1210260000,979410000,8468100000,10657770000,48,137,185
1297540000,4445070000,6293800000,12036410000,49,137,186
789230000,4138740000,3662350000,8590320000,49,122,171
5.861e+09,116200000,20892280000,26869480000,41,113,154
2804020000,4643100000,1468320000,8915440000,49,110,159
3079800000,11012730000,2235400000,16327930000,54,121,175
1673590000,5495860000,3895730000,11065180000,37,116,153
3941560000,4285860000,1853910000,10081330000,43,106,149
7116010000,330340000,3005850000,10452200000,41,111,152
3.003e+09,1153340000,9544350000,13700690000,42,119,161
842400000,148900000,7651550000,8642850000,42,98,140
3265580000,776470000,1388790000,5430840000,43,118,161
2473300000,6555890000,1313330000,10342520000,51,119,170
2354640000,5391770000,5131510000,12877920000,33,105,138
2960050000,5660780000,2092300000,10713130000,56,126,182
10659580000,641670000,3789600000,15090850000,42,106,148
6953790000,294750000,3680110000,10928650000,41,108,149
1001910000,5502280000,9220470000,15724660000,47,116,163
7241780000,11602670000,9857570000,28702020000,70,166,236
269510000,977840000,8049740000,9297090000,38,89,127
5186610000,2094400000,1635120000,8916130000,46,111,157
518430000,29070000,4888350000,5435850000,34,88,122
6898270000,6892200000,3405610000,17196080000,53,143,196
4469590000,5474080000,1993460000,11937130000,59,135,194
994640000,5904390000,1803210000,8702240000,41,102,143
3709970000,653600000,7162430000,1.1526e+10,38,124,162
3718640000,3261450000,2091010000,9071100000,52,131,183
1047930000,1692270000,6401620000,9141820000,40,98,138
387030000,1892470000,8307180000,10586680000,51,129,180
713820000,5749020000,5728030000,12190870000,36,118,154
5177180000,4569220000,2087690000,11834090000,51,113,164
3601440000,3574840000,1784190000,8960470000,39,96,135
9148400000,3794320000,6155580000,19098300000,51,125,176
3740460000,425460000,4148620000,8314540000,40,116,156
2534080000,5320570000,2481400000,10336050000,53,106,159
8871090000,1643710000,2786600000,13301400000,43,114,157
602040000,6992860000,887030000,8481930000,49,124,173
1600630000,2203050000,1376600000,5180280000,49,105,154
5762060000,9805930000,5159810000,20727800000,40,129,169
5521130000,1148530000,3662890000,10332550000,50,133,183
5840290000,7934210000,4747560000,18522060000,52,140,192
289270000,1415350000,7124490000,8829110000,45,125,170
895530000,3755460000,4476080000,9127070000,40,105,145
3674990000,7081760000,7519580000,18276330000,41,114,155
3555370000,2268640000,2640260000,8464270000,42,115,157
1227920000,5306830000,6702140000,13236890000,46,123,169
3017820000,88440000,2069060000,5175320000,33,94,127
1136790000,8465400000,4935300000,14537490000,44,127,171
1997240000,6959100000,12407270000,21363610000,40,126,166
5258410000,3990910000,4064850000,13314170000,50,139,189
3172520000,5847440000,1683300000,10703260000,52,124,176
5770520000,1425830000,1729840000,8926190000,43,107,150
3927770000,913030000,4584730000,9425530000,49,135,184
6616300000,1466100000,3003270000,11085670000,41,130,171
125430000,262760000,6495550000,6883740000,36,82,118
3779930000,2846060000,3617400000,10243390000,42,101,143
2984740000,4094720000,2379750000,9459210000,59,135,194
7137010000,2598950000,3186420000,12922380000,42,117,159
172180000,560330000,7423150000,8155660000,31,77,108
991010000,12944940000,8464780000,22400730000,51,124,175
4350020000,3062130000,2876550000,10288700000,52,118,170
913210000,4466290000,3598950000,8978450000,48,116,164
1069710000,2366830000,1793850000,5230390000,41,88,129
1606680000,1866800000,7771190000,11244670000,38,115,153
78420000,446990000,6262140000,6787550000,34,83,117
4427850000,3607970000,2045710000,10081530000,41,87,128
2155030000,4809260000,3813500000,10777790000,42,126,168
3460580000,5470120000,1411220000,10341920000,53,118,171
5098010000,7381100000,6605310000,19084420000,38,113,151
4239720000,931620000,4079970000,9251310000,50,139,189
2798740000,5481270000,1801380000,10081390000,47,108,155
2347560000,7821960000,5106770000,15276290000,51,118,169
698150000,3805520000,1165730000,5669400000,55,126,181
890260000,3581240000,879160000,5350660000,50,116,166
2737690000,5761280000,1582750000,10081720000,47,103,150
3505870000,497880000,1567370000,5571120000,40,115,155
444060000,3319080000,8475590000,12238730000,45,108,153
5356030000,93020000,3410290000,8859340000,35,103,138
6378900000,2134710000,2468280000,10981890000,48,122,170
9267720000,35100000,7204790000,16507610000,35,106,141
3588110000,81730000,5223430000,8893270000,39,107,146
4469440000,7613180000,2015280000,14097900000,55,127,182
2865300000,223860000,6981240000,10070400000,36,105,141
2399650000,6137670000,1798820000,10336140000,56,117,173
4606140000,2.143e+09,2312140000,9061280000,41,109,150
3544270000,1058950000,4966720000,9569940000,43,126,169
2763420000,4766880000,2926800000,10457100000,51,115,166
2181760000,3704180000,4551120000,10437060000,52,144,196
3492420000,1947350000,4761910000,10201680000,38,116,154
3565590000,470610000,1755800000,5.792e+09,43,121,164
6056320000,146870000,3883660000,10086850000,39,109,148
7439630000,277750000,3055900000,10773280000,37,111,148
4913390000,1009100000,4519590000,10442080000,37,121,158
3604550000,4433700000,2413140000,10451390000,43,107,150
2858140000,1118390000,1369120000,5345650000,48,108,156
5836870000,4293620000,3941060000,14071550000,51,133,184
4660490000,6591920000,1921560000,13173970000,36,106,142
1982500000,10312770000,2360450000,14655720000,58,138,196
2496230000,6520750000,1657330000,10674310000,54,117,171
5981990000,4560150000,4449680000,14991820000,50,109,159
2273180000,6051850000,6461550000,14786580000,54,128,182
3379490000,5562440000,1399910000,10341840000,52,124,176
4225860000,3604480000,2251470000,10081810000,50,110,160
2535370000,14305870000,5488540000,22329780000,40,110,150
820440000,4201570000,1984240000,7006250000,54,126,180
7566470000,2020000,8342440000,15910930000,36,99,135
832450000,9487090000,5911030000,16230570000,37,93,130
4053780000,3397830000,3005570000,10457180000,38,102,140
3885640000,3188630000,3704010000,10778280000,45,136,181
7133550000,237200000,5316890000,12687640000,37,105,142
2848740000,6086700000,10620420000,19555860000,53,130,183
3330500000,4103490000,2026480000,9460470000,55,136,191
453120000,7340690000,2673970000,10467780000,45,111,156
5388870000,5162640000,5623370000,16174880000,54,130,184
5446320000,105130000,4780450000,10331900000,40,102,142
3168530000,274530000,1857460000,5300520000,45,121,166
4481430000,2705390000,2044370000,9231190000,47,122,169
3.977e+09,1994930000,4786320000,10758250000,50,141,191
2448060000,1370240000,6207530000,10025830000,51,143,194
290500000,8002830000,2649060000,10942390000,35,94,129
2649580000,774760000,6736660000,1.0161e+10,41,119,160
4057900000,4769500000,6301230000,15128630000,49,139,188
3814160000,91430000,13593110000,17498700000,45,120,165
178680000,695290000,8309490000,9183460000,34,79,113
761480000,4518830000,11589920000,16870230000,50,123,173
664270000,1594730000,290180000,2549180000,54,131,185
3300130000,4596440000,6668930000,14565500000,31,87,118
5824920000,1734540000,3193760000,10753220000,52,139,191
3808560000,393740000,15275960000,19478260000,46,102,148
666880000,3496850000,1006540000,5170270000,57,121,178
7042680000,730640000,3325620000,11098940000,41,120,161
1776970000,9311640000,1702880000,12791490000,49,106,155
1092910000,2821510000,1416190000,5330610000,45,130,175
5632920000,1398200000,2609950000,9641070000,44,125,169
1463100000,397900000,8072450000,9933450000,47,123,170
8232710000,156730000,6375030000,14764470000,38,114,152
3330350000,6454480000,4874500000,14659330000,37,110,147
8260000,170450000,4333990000,4512700000,37,88,125
2705700000,2172890000,547240000,5425830000,43,121,164
2036340000,7835440000,6920680000,16792460000,43,130,173
454380000,3686740000,1194510000,5335630000,47,110,157
4192450000,1324470000,4940690000,10457610000,45,102,147
4499670000,5148540000,2648420000,12296630000,48,125,173
2705640000,3602550000,5613430000,11921620000,54,128,182
2772930000,339530000,1726120000,4838580000,45,120,165
537400000,6853730000,1704290000,9095420000,40,115,155
638910000,9524590000,3760830000,13924330000,44,128,172
916300000,7397840000,9715480000,18029620000,48,111,159
1664560000,6804560000,2212740000,10681860000,52,113,165
3727580000,12112880000,8680340000,24520800000,47,129,176
459370000,3773140000,3844940000,8077450000,46,114,160
1360890000,3116100000,542360000,5019350000,42,107,149
2703710000,7027830000,1210750000,10942290000,59,141,200
2021440000,605220000,7256980000,9883640000,43,122,165
653500000,144030000,8129520000,8927050000,37,97,134
649340000,891910000,9277110000,10818360000,38,94,132
5090220000,14777450000,9517760000,29385430000,45,133,178
2341620000,4748400000,1803250000,8893270000,54,120,174
2697150000,3900560000,4154300000,10752010000,35,98,133
4.588e+09,9320000,14938820000,19536140000,32,105,137
2576300000,2068170000,701170000,5345640000,51,118,169
2696980000,435890000,6361670000,9494540000,42,117,159
4822630000,2527330000,1571280000,8921240000,42,108,150
2966010000,4768970000,1186180000,8921160000,55,131,186
255370000,496420000,8495330000,9247120000,34,79,113
1759810000,3301360000,5391520000,10452690000,44,115,159
4610730000,2243270000,3588100000,10442100000,45,129,174
3832240000,1352510000,845230000,6029980000,51,121,172
2586240000,6771610000,1349790000,10707640000,57,130,187
2754160000,16380000,2409780000,5180320000,34,97,131
171390000,4.176e+09,998280000,5345670000,41,103,144
5675560000,69330000,4210550000,9955440000,34,102,136
335170000,5728780000,5274830000,11338780000,43,112,155
4805980000,492720000,8549130000,13847830000,38,124,162
439410000,4006540000,12316830000,16762780000,48,124,172
437200000,8439460000,1811770000,10688430000,46,105,151
3354740000,4385780000,1225570000,8966090000,41,100,141
2300340000,5634580000,1041260000,8976180000,45,112,157
4788760000,2816300000,4984170000,12589230000,47,129,176
3351560000,3139240000,2435050000,8925850000,50,117,167
2512920000,406090000,7768060000,10687070000,41,119,160
4682730000,8412180000,5970310000,19065220000,39,118,157
2154460000,5642500000,6096340000,13893300000,53,129,182
6726260000,490280000,8436550000,15653090000,45,123,168
2733490000,2681060000,3546430000,8960980000,46,117,163
1554980000,11254870000,6004580000,18814430000,46,118,164
4982930000,1793090000,3976840000,10752860000,52,142,194
4284260000,1364970000,8178250000,13827480000,54,127,181
4511660000,4371300000,1459340000,10342300000,50,120,170
3245630000,5239840000,1595610000,10081080000,41,121,162
155690000,7543400000,1362200000,9061290000,53,123,176
2795370000,712050000,4387840000,7895260000,49,140,189
3570670000,5213750000,1291460000,10075880000,51,108,159
1505560000,2727230000,1007670000,5240460000,34,113,147
7599630000,2282330000,3036100000,12918060000,52,136,188
1892280000,655700000,2610250000,5158230000,49,135,184
2840390000,1821320000,4314360000,8976070000,43,109,152
2068700000,5483770000,1418900000,8971370000,39,104,143
2906250000,635090000,6545370000,10086710000,45,121,166
1270940000,5881860000,5318520000,12471320000,59,145,204
9152120000,7125480000,8074730000,24352330000,60,165,225
3521830000,4531090000,1814630000,9867550000,49,107,156
1992340000,5527480000,2870480000,10390300000,47,139,186
1528320000,3194650000,622700000,5345670000,57,117,174
1881900000,7252520000,1578260000,10712680000,53,124,177
4310290000,2621300000,2901740000,9833330000,53,138,191
5838100000,1367610000,3534910000,10740620000,46,129,175
2737480000,7048070000,1644540000,11430090000,54,124,178
5552530000,1403180000,2874880000,9830590000,48,105,153
1297040000,7822900000,896800000,10016740000,36,90,126
2367310000,1453510000,1354510000,5175330000,42,90,132
4730100000,93010000,22454360000,27277470000,41,115,156
6573090000,17826070000,13122710000,37521870000,42,121,163
2296650000,3692390000,4422310000,10411350000,43,125,168
1772040000,5339540000,1864500000,8976080000,37,102,139
5589380000,1320610000,2220280000,9130270000,39,120,159
526340000,3868410000,3566180000,7960930000,48,114,162
2559170000,5341030000,1181440000,9081640000,49,119,168
729750000,4772380000,4584060000,10086190000,51,123,174
5212990000,361180000,3226610000,8800780000,44,120,164
11401860000,171610000,6313040000,17886510000,38,115,153
4980570000,3187770000,2915100000,11083440000,51,140,191
5170070000,4016620000,6478950000,15665640000,46,130,176
2231580000,3346500000,3658760000,9236840000,35,117,152
1198400000,502580000,799020000,2.5e+09,30,94,124
527250000,485740000,8685940000,9698930000,42,111,153
1629790000,2770430000,4770550000,9170770000,41,117,158
6355030000,72690000,4476710000,10904430000,40,116,156
3303330000,4698480000,2330040000,10331850000,48,111,159
2180850000,12103110000,1880400000,16164360000,43,134,177
4417930000,9685460000,5135730000,19239120000,40,106,146
1745950000,7417980000,1298810000,10462740000,48,108,156
1321110000,2826410000,1203160000,5350680000,52,117,169
2775620000,9709200000,4945890000,17430710000,35,112,147
2189940000,6647160000,3884620000,12721720000,51,119,170
2521050000,288600000,11821400000,14631050000,39,106,145
2107870000,1215610000,1716380000,5039860000,40,85,125
751170000,3334670000,1264840000,5350680000,42,100,142
2223020000,3801350000,4432060000,10456430000,44,102,146
4014540000,963570000,8859970000,13838080000,49,128,177
2087610000,875110000,11611920000,14574640000,45,112,157
2154030000,5619320000,6691470000,14464820000,41,116,157
1668600000,4894850000,2502310000,9065760000,55,122,177
2810310000,6742250000,1054420000,10606980000,52,117,169
2821220000,3821730000,2874570000,9517520000,48,109,157
4293280000,3980370000,5558830000,13832480000,43,136,179
1652530000,4138370000,8657010000,14447910000,32,102,134
1480600000,8314640000,4908090000,14703330000,41,136,177
2954490000,8.13e+08,5081640000,8849130000,45,118,163
2625790000,8703690000,2492290000,13821770000,49,134,183
1305560000,3785530000,1687920000,6779010000,50,120,170
906330000,2917490000,4041250000,7865070000,44,116,160
3681910000,3269590000,5750560000,12702060000,47,122,169
2762990000,2878900000,3309350000,8951240000,50,131,181
1359060000,3782170000,5654290000,10795520000,49,128,177
3825730000,2215590000,4321070000,10362390000,42,121,163
3624440000,4258110000,5040390000,12922940000,33,102,135
2772970000,1802620000,770040000,5345630000,47,113,160
3538100000,579740000,4701330000,8819170000,47,126,173
2765380000,5442780000,2128610000,10336770000,50,115,165
463660000,8511980000,7110450000,16086090000,48,118,166
163200000,83130000,5056820000,5303150000,36,84,120
3731990000,6140070000,1981910000,11853970000,54,125,179
5838530000,887640000,2525240000,9251410000,41,122,163
4095300000,3622850000,3009550000,10727700000,54,134,188
509830000,1736690000,10290270000,12536790000,31,73,104
5659020000,168540000,5291650000,11119210000,43,119,162
636600000,2786350000,10279800000,13702750000,33,80,113
9887510000,7.777e+09,7174890000,24839400000,55,154,209
7346630000,134870000,5494420000,12975920000,37,107,144
1211500000,4023550000,14411770000,19646820000,35,101,136
23061440000,4780810000,14425770000,42268020000,57,145,202
6300330000,1973480000,29824490000,38098300000,55,149,204
12988180000,21705720000,15810850000,50504750000,47,134,181
18452720000,10312700000,25074200000,53839620000,58,150,208
6413340000,151550000,36532790000,43097680000,44,116,160
7624570000,1533030000,28932140000,38089740000,50,134,184
18456010000,17256900000,10373210000,46086120000,54,135,189
2190690000,7443920000,53693410000,63328020000,41,99,140
20321750000,888540000,37805760000,59016050000,49,130,179
13991750000,35753590000,9403050000,59148390000,59,132,191
10650110000,26910000,21085120000,31762140000,36,111,147
9016510000,22431680000,6139510000,37587700000,42,113,155
6463630000,6203710000,46902900000,59570240000,51,132,183
6069260000,32076070000,18298540000,56443870000,58,133,191
23890010000,4176690000,18567340000,46634040000,53,146,199
12829640000,24471930000,12027940000,49329510000,57,144,201
15522570000,22856520000,20134280000,58513370000,57,153,210
3831080000,30490480000,7484130000,41805690000,65,150,215
15799330000,12863200000,18474020000,47136550000,60,159,219
15503300000,20073860000,21416960000,56994120000,61,152,213
10093720000,18642050000,15464800000,44200570000,52,124,176
12192680000,24354660000,21233450000,57780790000,51,151,202
18528540000,27075860000,9621440000,55225840000,57,156,213
13868710000,34812950000,18951980000,67633640000,48,141,189
24657290000,8128400000,21297960000,54083650000,48,138,186
19256370000,11289690000,12895920000,43441980000,50,134,184
3028810000,11510510000,40198730000,54738050000,49,121,170
2060330000,16105820000,35370740000,53536890000,54,131,185
16426040000,8860550000,25585960000,50872550000,60,156,216
24415700000,8976330000,13604800000,46996830000,47,135,182
15450300000,20582140000,7240260000,43272700000,61,153,214
11251840000,28815290000,7108700000,47175830000,51,121,172
23345310000,26951670000,11561260000,61858240000,65,158,223
17797930000,18836460000,11753310000,48387700000,55,130,185
3327720000,12346750000,7896090000,23570560000,63,146,209
12795900000,27096840000,21612690000,61505430000,47,129,176
31780830000,3359540000,15688030000,50828400000,51,137,188
25258470000,6121190000,13600130000,44979790000,57,148,205
4003340000,15401570000,31607420000,51012330000,55,138,193
12320190000,10351860000,9234760000,31906810000,56,140,196
5030820000,28224540000,14955490000,48210850000,55,131,186
14188380000,10550420000,21689640000,46428440000,57,140,197
14936710000,23626840000,8115390000,46678940000,58,140,198
12571360000,28879440000,35752040000,77202840000,47,133,180
4276110000,12785410000,36412770000,53474290000,42,118,160
18903970000,22543320000,23068270000,64515560000,56,163,219
9523060000,20107210000,27579230000,57209500000,58,141,199
21923400000,12984020000,19479580000,5.4387e+10,57,140,197
12848610000,27697880000,8.067e+09,48613490000,63,149,212
12473610000,743920000,16959360000,30176890000,49,140,189
8943230000,15147140000,33258280000,57348650000,57,154,211
20617860000,14830790000,13140200000,48588850000,54,145,199
16431670000,15039180000,19988960000,51459810000,60,158,218
2629180000,17832220000,24624960000,45086360000,51,126,177
11574720000,2362520000,30947520000,44884760000,48,135,183
21419820000,160360000,13609350000,35189530000,40,118,158
4417960000,23378070000,17425540000,45221570000,56,136,192
4096630000,16981560000,25107420000,46185610000,51,133,184
8670030000,24238640000,19949400000,52858070000,60,166,226
18102410000,12764320000,10621530000,41488260000,59,160,219
8399540000,16675520000,17426520000,42501580000,45,138,183
19547260000,453070000,15813850000,35814180000,50,128,178
11934710000,2345930000,32932020000,47212660000,51,139,190
13294750000,8470000,9553350000,22856570000,40,116,156
19775730000,23075810000,8244390000,51095930000,57,126,183
3825780000,33078630000,7458220000,44362630000,60,132,192
20937880000,7206680000,17761970000,45906530000,54,141,195
15320030000,22208810000,15164950000,52693790000,51,151,202
20113480000,22398870000,14876420000,57388770000,53,120,173
11445760000,18501330000,11729720000,41676810000,68,174,242
2934540000,1014650000,37858840000,41808030000,47,122,169
8185610000,727810000,32373670000,41287090000,46,118,164
8605930000,15096240000,12839820000,36541990000,62,168,230
16919760000,33911630000,9792950000,60624340000,57,144,201
2414030000,21239510000,22919150000,46572690000,51,131,182
13879780000,20738730000,13383890000,48002400000,54,128,182
22520620000,18657250000,15299320000,56477190000,58,155,213
34081200000,1261410000,16411140000,51753750000,47,130,177
33497660000,11195270000,28730490000,73423420000,56,147,203
9293600000,29839590000,25395470000,64528660000,55,142,197
14751930000,25316070000,11632650000,51700650000,67,154,221
11775080000,29513700000,10430980000,51719760000,64,151,215
9499080000,12793600000,12756180000,35048860000,70,169,239
9108830000,40752990000,29043290000,78905110000,55,141,196
23740590000,26738280000,9874700000,60353570000,64,157,221
28934330000,95800000,18790620000,47820750000,38,121,159
3.7567e+10,1771450000,24425130000,63763580000,51,138,189
7597980000,19873530000,20059420000,47530930000,52,142,194
4806890000,16578760000,22560740000,43946390000,56,144,200
21881840000,24678300000,10229080000,56789220000,57,137,194
18788890000,26810490000,16577990000,62177370000,61,138,199
8881680000,4402390000,17848560000,31132630000,48,146,194
17437180000,1081960000,18098040000,36617180000,55,142,197
22510560000,2023200000,13013290000,37547050000,46,138,184
6921560000,28818180000,23618090000,59357830000,48,147,195
21772800000,9771240000,18279180000,49823220000,60,154,214
3267310000,33952660000,29396950000,66616920000,50,123,173
12156390000,16639950000,19858370000,48654710000,55,132,187
1.454e+09,5611380000,56837240000,63902620000,41,106,147
2224030000,7904750000,39241300000,49370080000,51,118,169
25229130000,12415720000,14796360000,52441210000,64,170,234
18030110000,14358740000,23714500000,56103350000,58,150,208
19401270000,29758910000,10463340000,59623520000,61,145,206
14014840000,32661120000,7838710000,54514670000,61,140,201
14705290000,30354340000,8915660000,53975290000,54,139,193
11358180000,25053430000,7750950000,44162560000,59,135,194
9578800000,466510000,43970910000,54016220000,50,131,181
39455800000,1363190000,30449750000,71268740000,46,136,182
10510480000,12606960000,22297770000,45415210000,44,125,169
22690900000,4883830000,16245710000,43820440000,58,150,208
16322730000,24258940000,15850950000,56432620000,53,143,196
19367610000,11821650000,30532730000,61721990000,59,155,214
40841490000,56350370000,137833450000,235025310000,73,186,259
31872310000,66615480000,111404900000,209892690000,57,157,214
80807040000,111741600000,43901050000,236449690000,69,172,241
97673680000,23864520000,65839980000,187378180000,65,165,230
40349320000,73647020000,80782430000,194778770000,56,165,221
44611490000,98001940000,92558690000,235172120000,66,166,232
78122310000,6777140000,69281790000,154181240000,61,156,217
36560800000,32387590000,92424110000,161372500000,66,176,242
81119260000,64608530000,90244900000,235972690000,71,193,264
81746240000,147032280000,78533810000,307312330000,78,198,276
60141520000,67618180000,71823280000,199582980000,68,179,247
24717850000,101709500000,88697580000,215124930000,65,153,218
52884540000,9144410000,113147130000,175176080000,58,161,219
42424910000,101016190000,83916450000,227357550000,68,181,249
73014550000,1153610000,136630070000,210798230000,54,146,200
47433230000,81968870000,68130130000,197532230000,64,157,221
32301200000,119009900000,84625480000,235936580000,63,155,218
77188330000,133891700000,53587240000,264667270000,69,180,249
64960570000,64451010000,66706340000,196117920000,66,166,232
93460180000,27289480000,58563900000,179313560000,56,153,209
61167940000,88623510000,35098450000,184889900000,69,171,240
9217850000,67943130000,124236390000,201397370000,65,155,220
14167780000,25486960000,248817950000,288472690000,57,142,199
73606920000,3467330000,58556340000,135630590000,55,152,207
44932460000,93940380000,34525870000,173398710000,71,161,232
55771250000,45291440000,81099390000,182162080000,69,183,252
70135010000,2462900000,117538110000,190136020000,53,152,205
73371450000,101731200000,54841090000,229943740000,64,154,218
151416990000,346156500000,308242930000,805816420000,79,201,280
268142430000,436818230000,440182350000,1145143010000,82,215,297
361810540000,43721750000,442202460000,847734750000,76,192,268
46419520000,206737900000,505366980000,758524400000,80,188,268
224359170000,86572970000,339396730000,650328870000,74,187,261
314245310000,369292380000,334500730000,1018038420000,76,222,298
225839980000,359510390000,206081470000,791431840000,77,195,272
1547170170000,1789055420000,2665756380000,6001981970000,117,302,419
