"Forest","Agriculture","Urban","Grassland","Other","Area_Total","natural_sp","human_dominated_sp","Sp_Total"
124760000,247110000,482870000,31740000,1603660000,2490140000,34,64,98
145150000,388660000,58290000,3180000,1602760000,2198040000,23,59,82
181440000,1195730000,162710000,39290000,920830000,2.5e+09,30,59,89
477670000,685220000,10270000,72720000,1254120000,2.5e+09,30,61,91
346850000,449720000,70750000,50290000,1582390000,2.5e+09,36,68,104
167350000,1758200000,10530000,122360000,441560000,2.5e+09,36,64,100
696300000,498280000,40750000,46400000,1218270000,2.5e+09,25,54,79
200940000,1827710000,27910000,304620000,138820000,2.5e+09,32,67,99
309660000,1837590000,28830000,141160000,182760000,2.5e+09,38,72,110
507050000,1229450000,158270000,25780000,579450000,2.5e+09,31,71,102
610450000,1457110000,87300000,48260000,296880000,2.5e+09,34,72,106
690250000,557200000,47570000,8320000,1196660000,2.5e+09,24,55,79
1195260000,1019350000,10850000,29500000,245040000,2.5e+09,27,62,89
867320000,811630000,143720000,24960000,652370000,2.5e+09,26,58,84
727390000,344930000,25010000,5970000,1396700000,2.5e+09,19,48,67
122960000,800110000,38120000,52260000,1486550000,2.5e+09,37,68,105
428910000,710430000,11440000,174900000,1174320000,2.5e+09,27,55,82
268670000,836450000,80530000,47660000,1266690000,2.5e+09,42,76,118
247410000,1806490000,18310000,165970000,261820000,2.5e+09,36,66,102
380690000,1471040000,13210000,100790000,534270000,2.5e+09,33,68,101
168510000,1698900000,17780000,476480000,138330000,2.5e+09,29,61,90
123410000,1844420000,55760000,274740000,201670000,2.5e+09,43,81,124
367440000,968540000,27860000,57290000,1078870000,2.5e+09,27,64,91
267670000,1074310000,8220000,328670000,821130000,2.5e+09,35,71,106
39860000,768310000,119400000,15700000,1556730000,2.5e+09,52,94,146
15690000,31970000,80750000,5970000,1604950000,1739330000,39,63,102
572660000,767310000,23970000,88810000,1047250000,2.5e+09,32,72,104
902670000,960240000,17260000,17980000,601850000,2.5e+09,18,44,62
306960000,1560060000,13940000,284610000,334430000,2.5e+09,33,64,97
83550000,927110000,34210000,969640000,485490000,2.5e+09,41,71,112
106360000,1936770000,33960000,207110000,215800000,2.5e+09,46,81,127
105550000,1452780000,24520000,464250000,452900000,2.5e+09,40,81,121
221930000,150110000,7170000,6100000,1884600000,2269910000,17,34,51
378310000,291380000,266270000,9250000,1439510000,2384720000,29,56,85
393800000,1022140000,190390000,11680000,881990000,2.5e+09,21,51,72
717870000,615100000,41010000,10140000,1115880000,2.5e+09,16,47,63
790910000,449450000,187420000,14520000,1057700000,2.5e+09,33,56,89
395660000,676390000,137760000,9750000,1280440000,2.5e+09,24,49,73
939720000,490910000,44930000,28870000,995570000,2.5e+09,23,62,85
368620000,461670000,23690000,84030000,1561990000,2.5e+09,20,58,78
880200000,904580000,32810000,15950000,666460000,2.5e+09,25,53,78
1020590000,641400000,104260000,20620000,713130000,2.5e+09,33,60,93
959760000,1026110000,34220000,25420000,454490000,2.5e+09,21,52,73
330930000,781840000,37160000,28190000,1321880000,2.5e+09,26,58,84
426730000,772570000,23930000,208170000,1068600000,2.5e+09,27,61,88
231880000,1226180000,21870000,34830000,985240000,2.5e+09,25,58,83
300270000,1008810000,24740000,16590000,1149590000,2.5e+09,23,57,80
136740000,1328340000,16320000,81200000,937400000,2.5e+09,34,65,99
97310000,1087810000,11430000,191340000,1112110000,2.5e+09,35,66,101
658310000,631120000,18430000,38520000,1153620000,2.5e+09,35,64,99
289820000,1128300000,32400000,58280000,991200000,2.5e+09,27,60,87
278760000,1309910000,14390000,53810000,843130000,2.5e+09,27,59,86
936380000,973730000,14660000,6470000,568760000,2.5e+09,22,49,71
932320000,351770000,40870000,172930000,1002110000,2.5e+09,27,56,83
962640000,422910000,17520000,50010000,1046920000,2.5e+09,22,38,60
593010000,669810000,8110000,273350000,955720000,2.5e+09,39,74,113
86650000,1243240000,9950000,464260000,695900000,2.5e+09,40,71,111
138430000,1375380000,11360000,691490000,283340000,2.5e+09,36,65,101
324290000,883140000,7590000,252620000,1032360000,2.5e+09,37,66,103
663010000,186100000,4540000,337870000,1308480000,2.5e+09,26,55,81
887670000,241270000,21550000,295890000,1053620000,2.5e+09,27,61,88
9570000,28480000,3e+06,78790000,1720200000,1840040000,18,44,62
88650000,24020000,2800000,257130000,1964550000,2337150000,14,39,53
40170000,64350000,8810000,545610000,1841060000,2.5e+09,17,44,61
32590000,143050000,3040000,109030000,2212290000,2.5e+09,19,46,65
168700000,319410000,11830000,836180000,1163880000,2.5e+09,19,46,65
85680000,250090000,16430000,477660000,1670140000,2.5e+09,19,41,60
27190000,115700000,2390000,23680000,2324250000,2493210000,20,51,71
125210000,176200000,11700000,698600000,1488290000,2.5e+09,22,49,71
59540000,148750000,7580000,97180000,2122760000,2435810000,18,40,58
83130000,213150000,20830000,458070000,1724820000,2.5e+09,20,48,68
249280000,174700000,42650000,946390000,1086980000,2.5e+09,18,39,57
186730000,371930000,30640000,1065320000,845380000,2.5e+09,23,48,71
11450000,79630000,11290000,77760000,2157940000,2338070000,22,58,80
185020000,222810000,29250000,1902980000,159940000,2.5e+09,15,36,51
33070000,204340000,93150000,1099260000,1070180000,2.5e+09,18,41,59
96250000,261300000,24860000,832230000,1264960000,2479600000,19,45,64
111540000,91740000,74050000,2004100000,218570000,2.5e+09,18,43,61
194690000,186900000,20960000,1751400000,346050000,2.5e+09,21,40,61
225980000,165120000,22430000,1852520000,233950000,2.5e+09,17,36,53
66160000,70720000,33350000,1826770000,5.03e+08,2.5e+09,21,44,65
93020000,103460000,38200000,2055300000,210020000,2.5e+09,16,38,54
39980000,175990000,129700000,1931310000,223020000,2.5e+09,17,48,65
66270000,129390000,70730000,481710000,1701630000,2449730000,21,56,77
57760000,83090000,35880000,618560000,1704710000,2.5e+09,15,46,61
427510000,1482570000,22830000,64480000,502610000,2.5e+09,42,82,124
331760000,278140000,73720000,1108090000,708290000,2.5e+09,25,54,79
94130000,438020000,47510000,1095650000,824690000,2.5e+09,19,40,59
117750000,243400000,40320000,1722590000,375940000,2.5e+09,18,39,57
32940000,533740000,444530000,943570000,545220000,2.5e+09,24,50,74
147650000,0,2210000,279380000,2070760000,2.5e+09,19,56,75
577890000,1255140000,34650000,355410000,276910000,2.5e+09,43,81,124
159010000,1779690000,9710000,2.83e+08,268590000,2.5e+09,37,57,94
308990000,990360000,13390000,500240000,687020000,2.5e+09,40,83,123
49430000,1677780000,40800000,525660000,206330000,2.5e+09,43,80,123
347420000,1258790000,26480000,263550000,603760000,2.5e+09,48,92,140
386470000,1199360000,29100000,83130000,801940000,2.5e+09,36,75,111
132320000,42870000,117060000,39200000,1742840000,2074290000,26,56,82
117970000,1122780000,149450000,65290000,1044510000,2.5e+09,49,85,134
14980000,2381280000,28180000,38270000,37290000,2.5e+09,28,56,84
79960000,1949090000,4.5e+07,85190000,340760000,2.5e+09,39,73,112
597340000,1217810000,20650000,54580000,609620000,2.5e+09,29,58,87
495730000,836660000,7380000,314860000,845370000,2.5e+09,35,74,109
391010000,1080370000,10690000,416740000,601190000,2.5e+09,34,65,99
270240000,1802550000,59350000,180440000,187420000,2.5e+09,41,83,124
218760000,663520000,44120000,43240000,1530360000,2.5e+09,37,73,110
162640000,583640000,19030000,100140000,1634550000,2.5e+09,36,67,103
206750000,1913800000,44800000,100800000,233850000,2.5e+09,27,61,88
144930000,1989240000,126550000,64400000,174880000,2.5e+09,37,73,110
204330000,1515170000,10260000,303550000,466690000,2.5e+09,34,66,100
446810000,900080000,24050000,249420000,879640000,2.5e+09,29,61,90
2.46e+08,1700290000,19960000,147990000,385760000,2.5e+09,29,66,95
74790000,1985290000,56490000,93270000,290160000,2.5e+09,38,77,115
95100000,428510000,59720000,139280000,1777390000,2.5e+09,37,67,104
479700000,1153680000,13330000,347260000,506030000,2.5e+09,31,63,94
6.43e+08,684390000,5900000,225160000,941550000,2.5e+09,26,53,79
366020000,1394490000,5110000,253870000,480510000,2.5e+09,21,51,72
587690000,1228040000,10820000,315010000,358440000,2.5e+09,33,62,95
798820000,199300000,33920000,320520000,1147440000,2.5e+09,26,51,77
125380000,1131410000,156770000,189490000,896950000,2.5e+09,44,74,118
424860000,1273470000,33810000,507930000,259930000,2.5e+09,32,65,97
169180000,1389290000,219390000,516570000,205570000,2.5e+09,49,79,128
732110000,1314550000,11180000,134040000,308120000,2.5e+09,25,55,80
475490000,881890000,32260000,269110000,841250000,2.5e+09,29,60,89
637290000,661610000,16600000,320530000,863970000,2.5e+09,33,67,100
1009100000,289830000,3670000,618530000,578870000,2.5e+09,31,60,91
1031050000,465970000,4690000,273160000,725130000,2.5e+09,32,62,94
404490000,583170000,170520000,503700000,838120000,2.5e+09,36,72,108
64350000,830940000,324200000,114450000,1166060000,2.5e+09,46,88,134
80850000,1113790000,143980000,181250000,980130000,2.5e+09,40,71,111
536490000,688490000,104810000,309140000,861070000,2.5e+09,38,73,111
463330000,428390000,18300000,717750000,872230000,2.5e+09,37,69,106
103080000,1743410000,74820000,485700000,92990000,2.5e+09,42,73,115
579300000,880160000,94440000,378750000,567350000,2.5e+09,38,75,113
449190000,340460000,15920000,318750000,1375680000,2.5e+09,36,71,107
915490000,273480000,61770000,531530000,717730000,2.5e+09,34,68,102
159370000,2185960000,28820000,61870000,63980000,2.5e+09,36,73,109
142120000,1847340000,25440000,247590000,237510000,2.5e+09,39,72,111
977820000,1298490000,47690000,69670000,106330000,2.5e+09,37,74,111
434690000,1393530000,62050000,415730000,1.94e+08,2.5e+09,39,77,116
55150000,2375850000,17830000,26020000,25150000,2.5e+09,34,65,99
133050000,2230510000,41790000,30940000,63710000,2.5e+09,36,67,103
143210000,2192690000,41730000,30480000,91890000,2.5e+09,36,73,109
383530000,1736940000,112600000,89790000,177140000,2.5e+09,37,71,108
839510000,96120000,4320000,200740000,1359310000,2.5e+09,32,59,91
956870000,975960000,14180000,205340000,347650000,2.5e+09,37,71,108
820760000,115610000,3220000,437800000,1122610000,2.5e+09,31,60,91
696900000,1343060000,14700000,206460000,238880000,2.5e+09,38,72,110
280640000,283700000,16870000,67010000,1591580000,2239800000,28,52,80
58320000,47850000,13300000,70660000,1.49e+09,1680130000,27,59,86
437510000,776500000,655860000,324240000,305890000,2.5e+09,45,81,126
622660000,1291730000,14930000,356120000,214560000,2.5e+09,37,73,110
868580000,287810000,110100000,710050000,523460000,2.5e+09,38,80,118
703900000,725510000,7590000,464510000,598490000,2.5e+09,36,68,104
501120000,1002970000,48320000,318990000,628600000,2.5e+09,39,77,116
150420000,2086200000,55060000,122130000,86190000,2.5e+09,35,68,103
303870000,1960750000,26090000,38830000,170460000,2.5e+09,36,70,106
1168880000,554840000,11140000,196370000,568770000,2.5e+09,39,71,110
1049210000,999090000,11860000,101510000,338330000,2.5e+09,31,64,95
709120000,229390000,36320000,639190000,885980000,2.5e+09,36,71,107
593520000,1011830000,6450000,405280000,482920000,2.5e+09,35,70,105
1027430000,489380000,44520000,431330000,507340000,2.5e+09,36,70,106
686820000,1247940000,7900000,109560000,447780000,2.5e+09,37,67,104
15250000,89270000,34640000,4660000,1854180000,1.998e+09,31,47,78
174950000,495480000,153630000,63890000,1606980000,2494930000,33,71,104
536750000,1318270000,16620000,201940000,426420000,2.5e+09,38,75,113
1394690000,463320000,3330000,364200000,274460000,2.5e+09,32,57,89
527850000,1092820000,4710000,486960000,387660000,2.5e+09,34,67,101
868980000,894100000,8420000,408060000,320440000,2.5e+09,35,68,103
1156540000,439770000,2490000,423140000,478060000,2.5e+09,25,58,83
1122100000,428440000,30750000,298040000,620670000,2.5e+09,37,70,107
1368200000,537980000,15610000,213960000,364250000,2.5e+09,33,69,102
394660000,1167240000,39190000,142700000,756210000,2.5e+09,36,77,113
483180000,1254650000,5540000,270420000,486210000,2.5e+09,36,69,105
1521090000,202060000,139530000,305950000,331370000,2.5e+09,37,69,106
703080000,1359370000,91110000,52190000,294250000,2.5e+09,43,88,131
1461240000,61680000,98480000,553440000,325160000,2.5e+09,35,67,102
785680000,1205050000,33270000,141460000,334540000,2.5e+09,38,78,116
45480000,611760000,132320000,323010000,1387430000,2.5e+09,32,79,111
297240000,1115780000,176730000,237570000,672680000,2.5e+09,36,74,110
6830000,83910000,43910000,11300000,1970100000,2116050000,34,61,95
283020000,1612810000,129110000,381580000,93480000,2.5e+09,30,63,93
48540000,905470000,227950000,500810000,817230000,2.5e+09,40,88,128
645630000,832900000,19860000,224560000,777050000,2.5e+09,28,59,87
260690000,1646900000,11310000,14030000,567070000,2.5e+09,36,69,105
171150000,1840960000,49430000,36150000,402310000,2.5e+09,45,87,132
222340000,1590760000,33010000,83740000,570150000,2.5e+09,40,80,120
639090000,1333590000,11990000,31630000,483700000,2.5e+09,42,82,124
1273600000,181390000,20680000,877910000,146420000,2.5e+09,35,59,94
759080000,1106920000,78730000,33650000,521620000,2.5e+09,44,83,127
1066360000,449310000,31930000,814450000,137950000,2.5e+09,35,61,96
1437220000,305300000,4220000,173180000,580080000,2.5e+09,36,72,108
474780000,64510000,44660000,650000,1606300000,2190900000,29,57,86
536810000,499490000,220540000,207060000,1002840000,2466740000,36,80,116
626940000,497610000,74340000,9480000,1291630000,2.5e+09,28,59,87
556690000,1587300000,120800000,179790000,55420000,2.5e+09,32,67,99
263280000,1740000,39770000,660000,1439250000,1744700000,28,62,90
249130000,11390000,64390000,330000,1562220000,1887460000,25,52,77
868560000,469190000,427030000,106200000,629020000,2.5e+09,35,72,107
124150000,118150000,79590000,38090000,1815700000,2175680000,34,74,108
134070000,10370000,18450000,4170000,1420390000,1587450000,25,49,74
292300000,1659970000,144230000,297550000,105950000,2.5e+09,37,85,122
484060000,1109660000,69340000,239710000,597230000,2.5e+09,36,76,112
107100000,1830190000,157870000,387630000,17210000,2.5e+09,27,64,91
41810000,608100000,150890000,226200000,1.473e+09,2.5e+09,38,81,119
146690000,1710800000,108380000,524960000,9170000,2.5e+09,32,68,100
122810000,1940420000,155920000,269170000,11680000,2.5e+09,34,68,102
179490000,1739370000,87590000,4.66e+08,27550000,2.5e+09,31,61,92
91760000,1554270000,344830000,441150000,67990000,2.5e+09,39,86,125
141850000,1340220000,197460000,777910000,42560000,2.5e+09,35,79,114
131340000,1655790000,142580000,551810000,18480000,2.5e+09,35,73,108
1048150000,311990000,3830000,554740000,581290000,2.5e+09,29,60,89
130440000,1971240000,21030000,26530000,350760000,2.5e+09,36,77,113
548870000,1245710000,14010000,28330000,663080000,2.5e+09,43,75,118
181450000,1915610000,12800000,20690000,369450000,2.5e+09,36,70,106
838190000,567890000,114010000,717360000,262550000,2.5e+09,35,67,102
1027320000,141850000,14600000,478780000,837450000,2.5e+09,38,70,108
477980000,1449260000,242070000,233380000,97310000,2.5e+09,32,59,91
1215910000,737520000,66420000,104830000,375320000,2.5e+09,28,56,84
258990000,2033450000,139510000,56450000,11600000,2.5e+09,34,63,97
668630000,1570250000,52890000,107780000,100450000,2.5e+09,28,56,84
276380000,1748040000,117550000,335600000,22430000,2.5e+09,34,72,106
590890000,1233970000,102590000,542970000,29580000,2.5e+09,39,73,112
517110000,1589080000,145190000,189900000,58720000,2.5e+09,41,76,117
24740000,397660000,49300000,164700000,1863600000,2.5e+09,26,60,86
122420000,681520000,83560000,382530000,1229970000,2.5e+09,23,58,81
32180000,339550000,23850000,413090000,1431860000,2240530000,19,50,69
15360000,65020000,7170000,213030000,1484860000,1785440000,24,51,75
19470000,137360000,42730000,308490000,1836600000,2344650000,26,65,91
39010000,86620000,197480000,594250000,1582640000,2.5e+09,22,53,75
28440000,199220000,66490000,887320000,1318200000,2499670000,24,44,68
343600000,1770000,9070000,133160000,2012400000,2.5e+09,18,40,58
205810000,70210000,112730000,415200000,1696050000,2.5e+09,28,71,99
251290000,47160000,26380000,362150000,1813020000,2.5e+09,25,60,85
35330000,632450000,159170000,51590000,1621460000,2.5e+09,29,58,87
25450000,312910000,43600000,21090000,2094600000,2497650000,33,60,93
80320000,481030000,108150000,410380000,1419100000,2498980000,27,66,93
61820000,166480000,43940000,633900000,1593860000,2.5e+09,21,54,75
196740000,828050000,36920000,1206750000,231540000,2.5e+09,17,58,75
121820000,368040000,99610000,670330000,1240200000,2.5e+09,27,64,91
168850000,839830000,163110000,871350000,456860000,2.5e+09,25,69,94
256290000,12520000,15090000,1764150000,451950000,2.5e+09,22,59,81
135240000,68570000,222140000,1043860000,1030190000,2.5e+09,28,73,101
190250000,236680000,19540000,1619080000,434450000,2.5e+09,27,63,90
346070000,146770000,403740000,1112960000,490460000,2.5e+09,25,67,92
31830000,17750000,53760000,742320000,1654340000,2.5e+09,34,84,118
217060000,20470000,21240000,697360000,1542840000,2498970000,24,60,84
196220000,142730000,88450000,1583940000,488660000,2.5e+09,28,70,98
232460000,149730000,26760000,1847580000,243470000,2.5e+09,25,61,86
22290000,128890000,195230000,205090000,1.706e+09,2257500000,33,67,100
249730000,189050000,16900000,631880000,1412440000,2.5e+09,24,74,98
118950000,275020000,59430000,1025010000,1021590000,2.5e+09,27,69,96
165070000,53390000,40360000,845600000,1395580000,2.5e+09,28,73,101
231640000,1.57e+08,545880000,1117570000,447910000,2.5e+09,25,67,92
529380000,59880000,39280000,739360000,1132100000,2.5e+09,22,56,78
272820000,255550000,247330000,931650000,792650000,2.5e+09,24,62,86
480800000,180150000,59490000,1114660000,664900000,2.5e+09,25,58,83
241410000,1437030000,145850000,158180000,517530000,2.5e+09,32,62,94
189500000,1743080000,173640000,201560000,192220000,2.5e+09,31,60,91
289190000,1883750000,100990000,149870000,76200000,2.5e+09,28,53,81
443590000,1708900000,78400000,220880000,48230000,2.5e+09,24,51,75
20690000,234060000,66230000,10380000,1674930000,2006290000,27,56,83
81020000,807190000,108420000,867630000,635740000,2.5e+09,29,64,93
148310000,1259370000,159300000,927900000,5120000,2.5e+09,24,64,88
468300000,397840000,753430000,804410000,76020000,2.5e+09,29,66,95
270150000,616090000,231940000,488930000,892890000,2.5e+09,33,79,112
192330000,1451660000,88320000,759110000,8580000,2.5e+09,24,62,86
287400000,780810000,288860000,824800000,318130000,2.5e+09,30,73,103
74350000,1360080000,253520000,798840000,13210000,2.5e+09,26,61,87
112670000,1322400000,254180000,780070000,30680000,2.5e+09,29,71,100
69230000,876870000,227700000,1304690000,21510000,2.5e+09,23,64,87
174820000,1234590000,164490000,876410000,49690000,2.5e+09,26,66,92
107270000,356310000,291310000,1647940000,97170000,2.5e+09,31,73,104
81590000,969300000,917360000,466750000,6.5e+07,2.5e+09,31,72,103
22920000,93830000,213070000,680750000,1489430000,2.5e+09,34,83,117
94700000,111290000,450570000,1346490000,496950000,2.5e+09,30,70,100
130090000,145910000,6.25e+08,1035550000,563450000,2.5e+09,28,70,98
138670000,226980000,65010000,1367630000,701710000,2.5e+09,26,62,88
137380000,17590000,41900000,1419560000,883570000,2.5e+09,32,75,107
72880000,695710000,507090000,406720000,817600000,2.5e+09,35,80,115
96550000,1159340000,48940000,500800000,694370000,2.5e+09,30,78,108
544490000,176450000,13140000,1046420000,719500000,2.5e+09,24,53,77
43220000,440410000,116730000,251520000,1381990000,2233870000,32,82,114
160210000,1328430000,146280000,131290000,733790000,2.5e+09,28,62,90
246360000,1866660000,104420000,263650000,18910000,2.5e+09,27,48,75
136910000,1342230000,154390000,207710000,658760000,2.5e+09,34,69,103
308600000,1679690000,184300000,278310000,49100000,2.5e+09,29,64,93
19360000,215980000,49750000,218460000,1996450000,2.5e+09,29,64,93
195660000,362290000,348940000,464360000,1128750000,2.5e+09,32,77,109
89230000,360970000,183190000,304120000,1369620000,2307130000,30,74,104
47670000,1393130000,276240000,772330000,10630000,2.5e+09,25,60,85
179710000,1260380000,276860000,753490000,29560000,2.5e+09,29,70,99
172180000,582850000,1186620000,509930000,48420000,2.5e+09,31,71,102
114010000,1372130000,499110000,473970000,40780000,2.5e+09,29,70,99
39740000,1257560000,412760000,761640000,28300000,2.5e+09,31,62,93
54380000,2177850000,151290000,94640000,21840000,2.5e+09,28,64,92
88160000,1851680000,267850000,227660000,64650000,2.5e+09,30,71,101
57410000,1848760000,238690000,319840000,35300000,2.5e+09,30,76,106
116670000,1632300000,492980000,175140000,82910000,2.5e+09,31,76,107
78720000,1990880000,211960000,116100000,102340000,2.5e+09,29,60,89
239850000,816940000,64670000,500310000,878230000,2.5e+09,29,74,103
107510000,1338480000,93440000,776390000,184180000,2.5e+09,34,65,99
160740000,1683170000,158340000,472950000,24800000,2.5e+09,29,59,88
164850000,1023110000,69400000,1226840000,15800000,2.5e+09,31,64,95
146360000,1229350000,109150000,1000330000,14810000,2.5e+09,31,67,98
42400000,303720000,47650000,365090000,1709180000,2468040000,36,78,114
75480000,822390000,116380000,1267680000,218070000,2.5e+09,32,61,93
17900000,480040000,125630000,186570000,1470900000,2281040000,36,73,109
199450000,1215700000,150660000,923870000,10320000,2.5e+09,27,55,82
367630000,1047260000,70300000,999580000,15230000,2.5e+09,30,56,86
335340000,1117900000,162510000,865280000,18970000,2.5e+09,30,62,92
386850000,1830000,11390000,494370000,1605560000,2.5e+09,20,58,78
319150000,1600000,4600000,223350000,1951300000,2.5e+09,19,49,68
306480000,1920000,6440000,615340000,1569820000,2.5e+09,23,55,78
91360000,2880000,3510000,186050000,2216200000,2.5e+09,22,58,80
133030000,3450000,7320000,269450000,2086750000,2.5e+09,20,54,74
389670000,2990000,17350000,375530000,1714460000,2.5e+09,20,53,73
20100000,1990000,1800000,60390000,2371770000,2456050000,22,67,89
87980000,2620000,1780000,136250000,2271370000,2.5e+09,24,61,85
334490000,4900000,7100000,579030000,1574480000,2.5e+09,22,67,89
413290000,218660000,139600000,958100000,770350000,2.5e+09,27,71,98
369780000,587390000,92120000,648640000,802070000,2.5e+09,28,74,102
522470000,327900000,71790000,408600000,1169240000,2.5e+09,31,76,107
213540000,10140000,13560000,255330000,2007430000,2.5e+09,30,65,95
616180000,285580000,55510000,443400000,1099330000,2.5e+09,31,70,101
291150000,2840000,9720000,252740000,1943550000,2.5e+09,28,69,97
131490000,0,3490000,151890000,2213130000,2.5e+09,23,60,83
359220000,83220000,20500000,270890000,1766170000,2.5e+09,26,69,95
145390000,34300000,22210000,548360000,1749740000,2.5e+09,26,74,100
7750000,3280000,2230000,33920000,2248260000,2295440000,18,42,60
0,38070000,3070000,2.2e+08,2161480000,2422620000,20,57,77
711110000,1279340000,33400000,4710000,471440000,2.5e+09,34,63,97
129530000,739350000,41840000,185650000,1399890000,2496260000,41,73,114
493660000,1299530000,13120000,23510000,670180000,2.5e+09,40,78,118
807600000,1062060000,23650000,71580000,535110000,2.5e+09,34,75,109
994020000,711370000,11200000,26800000,756610000,2.5e+09,40,71,111
131970000,2088700000,48830000,30870000,199630000,2.5e+09,45,85,130
865650000,793500000,114710000,538730000,187410000,2.5e+09,34,70,104
949140000,55470000,12930000,607540000,874920000,2.5e+09,28,60,88
531340000,1722430000,37100000,82560000,126570000,2.5e+09,29,52,81
336210000,1866370000,44430000,241010000,11980000,2.5e+09,27,53,80
764230000,1392840000,112940000,184720000,45270000,2.5e+09,30,56,86
470920000,1731240000,90780000,113880000,93180000,2.5e+09,29,56,85
517270000,1550340000,170310000,236090000,25990000,2.5e+09,34,67,101
789830000,1481470000,36500000,154450000,37750000,2.5e+09,30,56,86
681520000,1301950000,65870000,16070000,434590000,2.5e+09,35,73,108
1840000,266140000,12480000,3240000,1761500000,2045200000,45,81,126
563220000,986670000,171650000,8070000,770390000,2.5e+09,33,64,97
1126160000,349890000,4110000,132750000,887090000,2.5e+09,37,68,105
2.44e+08,1854860000,55290000,10920000,334930000,2.5e+09,46,81,127
1721220000,197960000,11780000,130530000,438510000,2.5e+09,35,64,99
957550000,948090000,80160000,477100000,37100000,2.5e+09,36,68,104
931620000,26290000,11960000,707870000,822260000,2.5e+09,28,55,83
732680000,1200480000,69520000,435950000,61370000,2.5e+09,32,72,104
884480000,51110000,12670000,435330000,1116410000,2.5e+09,29,58,87
153900000,2138810000,98740000,77080000,31470000,2.5e+09,29,62,91
167320000,2098450000,51010000,164630000,18590000,2.5e+09,30,55,85
421940000,1754020000,144530000,127700000,51810000,2.5e+09,32,67,99
157450000,1767660000,496650000,27670000,50570000,2.5e+09,33,71,104
1137430000,977240000,55320000,289190000,40820000,2.5e+09,29,64,93
484850000,1692100000,80640000,215260000,27150000,2.5e+09,30,56,86
1105730000,789050000,73710000,439220000,92290000,2.5e+09,29,61,90
1036870000,868640000,44720000,337870000,211900000,2.5e+09,27,54,81
716470000,815380000,68290000,870900000,28960000,2.5e+09,32,59,91
1114930000,1010740000,89400000,236140000,48790000,2.5e+09,27,53,80
793600000,599960000,155520000,905490000,45430000,2.5e+09,31,62,93
654540000,1005430000,89090000,732270000,18670000,2.5e+09,32,61,93
565280000,1669170000,96820000,135630000,33100000,2.5e+09,35,75,110
277820000,1228390000,4.1e+07,916120000,36670000,2.5e+09,41,73,114
548580000,1160240000,49630000,627010000,114540000,2.5e+09,38,83,121
361210000,931060000,37930000,1148710000,21090000,2.5e+09,29,65,94
520100000,1472350000,149730000,314330000,43490000,2.5e+09,34,70,104
491950000,1589620000,163760000,190850000,63820000,2.5e+09,35,74,109
649440000,1607040000,145300000,55390000,42830000,2.5e+09,39,76,115
564230000,1668670000,57140000,193710000,16250000,2.5e+09,37,76,113
340400000,171910000,420840000,16590000,1523120000,2472860000,40,72,112
1495910000,280100000,39950000,214640000,469400000,2.5e+09,40,67,107
1034420000,410180000,28620000,693170000,333610000,2.5e+09,29,70,99
1328510000,614660000,238020000,16290000,302520000,2.5e+09,34,61,95
1674820000,557190000,57490000,41580000,168920000,2.5e+09,37,68,105
1425120000,315340000,181100000,9180000,569260000,2.5e+09,33,64,97
699210000,1373170000,84180000,204180000,139260000,2.5e+09,32,71,103
1284700000,154460000,29740000,529610000,501490000,2.5e+09,33,65,98
515710000,1155830000,84150000,71530000,672780000,2.5e+09,45,82,127
682640000,898420000,157970000,105470000,655500000,2.5e+09,46,86,132
564530000,1500100000,89600000,310650000,35120000,2.5e+09,33,61,94
541690000,1599820000,114280000,210490000,33720000,2.5e+09,31,71,102
731760000,1259680000,22700000,408540000,77320000,2.5e+09,33,63,96
1481660000,350130000,23840000,417770000,226600000,2.5e+09,29,58,87
1013620000,537770000,43130000,866940000,38540000,2.5e+09,25,60,85
700850000,1025500000,57090000,632500000,84060000,2.5e+09,29,64,93
639070000,467750000,47960000,1270700000,74520000,2.5e+09,30,64,94
7.03e+08,737600000,65240000,939280000,54880000,2.5e+09,28,60,88
1211450000,313360000,23840000,766950000,184400000,2.5e+09,28,61,89
1410360000,250770000,49860000,686980000,102030000,2.5e+09,28,62,90
804090000,519320000,40240000,1087760000,48590000,2.5e+09,30,63,93
670770000,223410000,32170000,1.508e+09,65650000,2.5e+09,29,67,96
339740000,1327600000,75360000,734590000,22710000,2.5e+09,36,71,107
458270000,8.59e+08,43740000,1125620000,13370000,2.5e+09,33,75,108
472460000,935810000,4.9e+07,1008310000,34420000,2.5e+09,34,75,109
353230000,697750000,88560000,1340760000,19700000,2.5e+09,30,69,99
1450670000,812020000,84340000,96840000,56130000,2.5e+09,36,78,114
772680000,1444500000,104580000,137210000,41030000,2.5e+09,33,76,109
715870000,1274080000,82440000,375020000,52590000,2.5e+09,38,77,115
433540000,1533630000,111800000,382070000,38960000,2.5e+09,39,75,114
43270000,382630000,49220000,5180000,1882080000,2362380000,41,75,116
18990000,461990000,106260000,18850000,1615370000,2221460000,39,85,124
748800000,1132880000,119810000,93290000,405220000,2.5e+09,36,84,120
1215140000,620990000,119360000,134390000,410120000,2.5e+09,30,67,97
181810000,675690000,273260000,58870000,1310370000,2.5e+09,45,85,130
911590000,516830000,26780000,872370000,172430000,2.5e+09,31,65,96
961840000,449860000,29640000,817270000,241390000,2.5e+09,32,75,107
827450000,493930000,57540000,965210000,155870000,2.5e+09,32,71,103
1486890000,184370000,27660000,297190000,503890000,2.5e+09,33,58,91
609670000,1065450000,244060000,529690000,51130000,2.5e+09,34,74,108
1054540000,604890000,57780000,686470000,96320000,2.5e+09,33,70,103
858520000,401040000,116290000,1027980000,96170000,2.5e+09,40,90,130
1132360000,562260000,100530000,642580000,62270000,2.5e+09,39,79,118
527640000,643190000,75970000,1193210000,59990000,2.5e+09,34,76,110
342880000,953820000,104120000,1061340000,37840000,2.5e+09,31,72,103
546480000,417540000,60400000,1448290000,27290000,2.5e+09,30,72,102
372200000,387170000,88670000,1627100000,24860000,2.5e+09,35,79,114
767680000,1359990000,74110000,286410000,11810000,2.5e+09,34,63,97
830650000,802460000,72450000,743930000,50510000,2.5e+09,35,75,110
824530000,1164690000,47270000,439550000,23960000,2.5e+09,30,68,98
1133620000,216710000,25750000,1083790000,40130000,2.5e+09,28,64,92
685490000,1198510000,279240000,31020000,305740000,2.5e+09,34,68,102
74270000,993400000,97180000,188850000,1146300000,2.5e+09,47,93,140
835800000,1209310000,168580000,47690000,238620000,2.5e+09,34,71,105
330160000,666530000,420650000,208060000,874600000,2.5e+09,43,90,133
1241600000,546590000,115960000,455220000,140630000,2.5e+09,34,71,105
998590000,845720000,159300000,210790000,285600000,2.5e+09,37,69,106
1133300000,848930000,99860000,243320000,174590000,2.5e+09,40,79,119
1144530000,867030000,32360000,113580000,342500000,2.5e+09,32,72,104
414870000,871720000,472680000,689460000,51270000,2.5e+09,35,89,124
849420000,788760000,301210000,475610000,8.5e+07,2.5e+09,34,70,104
612710000,1217910000,329110000,187590000,152680000,2.5e+09,43,98,141
691430000,1321580000,158210000,300820000,27960000,2.5e+09,39,75,114
593710000,706560000,182470000,963130000,54130000,2.5e+09,37,82,119
668950000,804020000,142250000,849070000,35710000,2.5e+09,36,85,121
583440000,1240690000,122670000,512350000,40850000,2.5e+09,39,76,115
693850000,1020110000,133240000,554020000,98780000,2.5e+09,43,93,136
1069750000,1034570000,34500000,341980000,19200000,2.5e+09,28,61,89
790170000,780640000,79390000,810400000,39400000,2.5e+09,33,69,102
873390000,1148750000,75230000,374210000,28420000,2.5e+09,31,71,102
712680000,1262280000,228100000,206680000,90260000,2.5e+09,38,85,123
94730000,35600000,161550000,1330000,1879030000,2172240000,29,59,88
1120260000,799420000,69410000,131350000,379560000,2.5e+09,34,73,107
1151500000,661670000,224980000,13800000,448050000,2.5e+09,36,77,113
1195970000,261440000,51140000,544690000,446760000,2.5e+09,35,69,104
1156930000,546160000,22260000,216690000,557960000,2.5e+09,35,72,107
1087380000,762680000,182130000,344700000,123110000,2.5e+09,38,81,119
1126870000,563680000,261680000,367010000,180760000,2.5e+09,36,70,106
1324310000,398270000,77300000,594570000,105550000,2.5e+09,41,76,117
1097080000,576280000,288350000,396830000,141460000,2.5e+09,42,78,120
973480000,914980000,83370000,478040000,50130000,2.5e+09,34,73,107
1092550000,743160000,164050000,464870000,35370000,2.5e+09,41,77,118
418530000,1222930000,52240000,795260000,11040000,2.5e+09,28,61,89
403310000,1364070000,75570000,647620000,9430000,2.5e+09,33,66,99
345260000,1926680000,149140000,64620000,14300000,2.5e+09,27,65,92
252770000,2112530000,57450000,61410000,15840000,2.5e+09,30,65,95
357620000,1020320000,222460000,752980000,146620000,2.5e+09,36,80,116
431130000,980800000,73890000,1004750000,9430000,2.5e+09,27,56,83
584670000,1194500000,301440000,348670000,70720000,2.5e+09,37,71,108
527480000,1634260000,225940000,86990000,25330000,2.5e+09,29,61,90
63180000,705630000,69390000,118430000,1342250000,2298880000,28,52,80
296090000,1129620000,121410000,467270000,485610000,2.5e+09,32,60,92
278910000,839480000,328920000,953930000,98760000,2.5e+09,33,73,106
88480000,202570000,104480000,443510000,1401870000,2240910000,31,65,96
99760000,787050000,194610000,233350000,1185230000,2.5e+09,33,71,104
60450000,1960910000,223660000,246460000,8520000,2.5e+09,31,74,105
64570000,1210400000,603050000,351470000,270510000,2.5e+09,36,72,108
61970000,782360000,93820000,146590000,1377970000,2462710000,36,78,114
9980000,298230000,50790000,54180000,2047130000,2460310000,29,60,89
191190000,1912840000,151360000,184050000,60560000,2.5e+09,37,84,121
60010000,615100000,48270000,85640000,1440740000,2249760000,31,76,107
115500000,1807610000,182160000,358250000,36480000,2.5e+09,30,73,103
582400000,1559040000,297910000,43070000,17580000,2.5e+09,36,73,109
426660000,1762880000,206660000,51250000,52550000,2.5e+09,35,73,108
795090000,1102670000,501170000,22570000,78500000,2.5e+09,39,79,118
437150000,1800920000,132030000,100340000,29560000,2.5e+09,33,72,105
349980000,1591790000,153390000,389160000,15680000,2.5e+09,29,58,87
641890000,1501060000,250300000,46530000,60220000,2.5e+09,38,70,108
137940000,831840000,114180000,214490000,1197640000,2496090000,42,85,127
300600000,1767600000,136370000,262550000,32880000,2.5e+09,31,62,93
109600000,1778680000,394730000,178820000,38170000,2.5e+09,33,61,94
145330000,2086380000,170160000,30730000,67400000,2.5e+09,38,67,105
58510000,793100000,122480000,102120000,1409740000,2485950000,41,77,118
64990000,2020230000,250500000,150850000,13430000,2.5e+09,37,83,120
24440000,345990000,77900000,167070000,1370400000,1985800000,30,69,99
406470000,1901560000,95170000,21530000,75270000,2.5e+09,34,79,113
649260000,1655660000,117780000,35440000,41860000,2.5e+09,34,72,106
217830000,2061840000,113840000,23440000,83050000,2.5e+09,34,68,102
788380000,1402180000,101930000,170120000,37390000,2.5e+09,36,72,108
743540000,1417980000,171080000,119040000,48360000,2.5e+09,38,74,112
552540000,1692020000,109960000,126930000,18550000,2.5e+09,30,63,93
324070000,1895270000,145500000,86890000,48270000,2.5e+09,33,71,104
504120000,1791320000,110050000,41860000,52650000,2.5e+09,32,67,99
216930000,1508320000,482570000,227120000,65060000,2.5e+09,40,75,115
142190000,2024170000,173970000,140250000,19420000,2.5e+09,36,68,104
388770000,1069500000,437660000,548740000,55330000,2.5e+09,38,70,108
478330000,952950000,119250000,934730000,14740000,2.5e+09,38,72,110
61750000,1315680000,375150000,207590000,539830000,2.5e+09,40,92,132
51660000,1524720000,744210000,155830000,23580000,2.5e+09,37,72,109
97840000,1262810000,587530000,123480000,428340000,2.5e+09,41,99,140
26330000,102840000,329390000,1.42e+08,1593690000,2194250000,42,76,118
49590000,1145740000,236940000,105950000,961780000,2.5e+09,45,97,142
701700000,1348660000,93470000,201250000,154920000,2.5e+09,38,83,121
1110530000,1166090000,56740000,135010000,31630000,2.5e+09,31,69,100
1038580000,1035250000,54560000,316690000,54920000,2.5e+09,34,62,96
884940000,840260000,74870000,674940000,24990000,2.5e+09,28,58,86
536950000,1263930000,46020000,590270000,62830000,2.5e+09,37,79,116
464810000,1630430000,76420000,195640000,132700000,2.5e+09,43,78,121
743180000,1054930000,126090000,537940000,37860000,2.5e+09,38,75,113
885510000,1119740000,64180000,383510000,47060000,2.5e+09,42,75,117
629750000,1170110000,458800000,198600000,42740000,2.5e+09,33,66,99
1359770000,402180000,152650000,524580000,60820000,2.5e+09,36,69,105
1115020000,673160000,193530000,463360000,54930000,2.5e+09,32,57,89
1155170000,692010000,123740000,479170000,49910000,2.5e+09,34,63,97
358030000,924580000,750240000,401400000,65750000,2.5e+09,35,85,120
487090000,1186940000,478300000,144780000,202890000,2.5e+09,41,93,134
240360000,1247180000,765920000,169080000,77460000,2.5e+09,44,83,127
40010000,337890000,654130000,1219840000,248130000,2.5e+09,47,96,143
210600000,1143490000,487180000,455170000,203560000,2.5e+09,46,93,139
7e+08,525300000,385500000,660820000,228380000,2.5e+09,46,94,140
282880000,1295390000,462510000,361410000,97810000,2.5e+09,42,94,136
14670000,355860000,55010000,117150000,1957310000,2.5e+09,39,80,119
72780000,407990000,474650000,698610000,845970000,2.5e+09,40,88,128
36720000,134710000,145610000,1339520000,843440000,2.5e+09,41,91,132
241260000,917970000,193010000,248650000,899110000,2.5e+09,47,101,148
4460000,178220000,30180000,321230000,1964230000,2498320000,39,87,126
729790000,810290000,200180000,655390000,104350000,2.5e+09,34,69,103
975380000,623670000,82780000,793140000,25030000,2.5e+09,35,65,100
108100000,282300000,11920000,15120000,1965040000,2382480000,22,70,92
32610000,129250000,46130000,28900000,2191060000,2427950000,29,68,97
0,15670000,0,0,1463900000,1479570000,23,48,71
759080000,261390000,8320000,37570000,1433640000,2.5e+09,25,76,101
349430000,587950000,130200000,95820000,1336600000,2.5e+09,34,90,124
660700000,138190000,105210000,2220000,1593680000,2.5e+09,26,72,98
513630000,215760000,31280000,8910000,1730420000,2.5e+09,27,74,101
609610000,86340000,1100000,9690000,1793260000,2.5e+09,20,73,93
1168520000,416040000,206470000,497780000,211190000,2.5e+09,34,69,103
695800000,269280000,79280000,4360000,1451280000,2.5e+09,24,79,103
193230000,88850000,5670000,4240000,2208010000,2.5e+09,21,63,84
553710000,127030000,9510000,440000,1809310000,2.5e+09,19,73,92
640000,19720000,550000,2260000,1739640000,1762810000,20,66,86
414420000,238640000,149250000,4740000,1692950000,2.5e+09,32,72,104
1040180000,493340000,39320000,238870000,688290000,2.5e+09,38,75,113
1238490000,549960000,141510000,109440000,460600000,2.5e+09,29,68,97
425610000,90270000,14990000,576050000,1393080000,2.5e+09,25,57,82
907330000,440130000,42190000,414850000,695500000,2.5e+09,34,69,103
1014620000,225930000,87220000,623310000,548920000,2.5e+09,35,67,102
1310080000,64310000,6170000,523360000,596080000,2.5e+09,27,64,91
751150000,186960000,352150000,154500000,1055240000,2.5e+09,32,70,102
1155640000,124580000,44390000,324250000,851140000,2.5e+09,26,62,88
69600000,25090000,147830000,11300000,1.646e+09,1899820000,27,62,89
832480000,39240000,34400000,451850000,1142030000,2.5e+09,24,57,81
636190000,58860000,18780000,492570000,1293600000,2.5e+09,23,55,78
660220000,1211800000,305020000,63510000,259450000,2.5e+09,29,76,105
913430000,998440000,89230000,81010000,417890000,2.5e+09,29,70,99
679890000,72440000,77770000,555090000,1114810000,2.5e+09,30,63,93
573650000,56500000,40870000,718080000,1110900000,2.5e+09,26,58,84
560470000,129780000,37640000,241310000,1530800000,2.5e+09,28,58,86
641600000,281420000,70710000,210930000,1295340000,2.5e+09,26,59,85
640210000,1210870000,210020000,209350000,229550000,2.5e+09,46,81,127
980110000,217910000,182550000,478370000,641060000,2.5e+09,42,76,118
646080000,670430000,177910000,711180000,294400000,2.5e+09,39,70,109
595110000,174580000,117290000,602870000,1010150000,2.5e+09,36,62,98
1209080000,606010000,236980000,396160000,51770000,2.5e+09,33,74,107
983190000,579200000,100330000,747040000,90240000,2.5e+09,37,62,99
846320000,1118110000,377750000,104030000,53790000,2.5e+09,40,86,126
933110000,992900000,249030000,240080000,84880000,2.5e+09,41,79,120
944110000,269240000,55180000,101930000,1129540000,2.5e+09,27,60,87
517880000,1795080000,130910000,41300000,14830000,2.5e+09,27,63,90
1064310000,1190360000,69110000,94390000,81830000,2.5e+09,27,54,81
190850000,2074520000,133470000,5330000,95830000,2.5e+09,31,73,104
935320000,478700000,118770000,63370000,903840000,2.5e+09,26,51,77
1041540000,82170000,60100000,180050000,1136140000,2.5e+09,25,55,80
396060000,1708930000,174090000,59150000,161770000,2.5e+09,37,80,117
1110260000,485770000,545500000,30970000,327500000,2.5e+09,34,80,114
183600000,1961030000,272590000,4360000,78420000,2.5e+09,37,72,109
724880000,182280000,47990000,650160000,894690000,2.5e+09,33,64,97
594390000,61630000,58730000,362350000,1422900000,2.5e+09,28,60,88
402410000,27610000,25530000,707570000,1336880000,2.5e+09,31,58,89
1270130000,78660000,71810000,2.03e+08,876400000,2.5e+09,32,71,103
1301920000,503400000,236430000,413480000,44770000,2.5e+09,35,73,108
794460000,1120330000,297100000,207770000,80340000,2.5e+09,40,68,108
842490000,1061330000,324970000,223770000,47440000,2.5e+09,38,74,112
714450000,680780000,325300000,409320000,370150000,2.5e+09,41,80,121
6.29e+08,238150000,142810000,13610000,1433430000,2.457e+09,32,65,97
597670000,1616530000,86150000,19730000,179920000,2.5e+09,38,79,117
1550980000,281200000,42230000,90970000,534620000,2.5e+09,23,54,77
243830000,1966070000,144260000,5060000,140780000,2.5e+09,37,72,109
1606910000,654120000,22760000,58620000,157590000,2.5e+09,24,52,76
1024410000,578300000,506500000,111330000,279460000,2.5e+09,39,75,114
34550000,1713660000,627560000,67520000,56710000,2.5e+09,35,66,101
1239530000,447660000,231950000,208350000,372510000,2.5e+09,36,74,110
37280000,2119880000,290270000,17970000,34600000,2.5e+09,32,64,96
690020000,57130000,51870000,790670000,910310000,2.5e+09,31,59,90
1031840000,98560000,62750000,309060000,997790000,2.5e+09,33,64,97
400140000,8950000,27680000,615840000,1447390000,2.5e+09,27,53,80
783390000,121970000,39750000,312080000,1242810000,2.5e+09,38,60,98
480140000,921750000,293630000,298340000,506140000,2.5e+09,38,83,121
878650000,236710000,177340000,878080000,329220000,2.5e+09,38,66,104
798640000,60840000,166370000,1402310000,71840000,2.5e+09,41,74,115
853310000,27900000,105900000,949500000,563390000,2.5e+09,33,57,90
501390000,542470000,48050000,35740000,1372350000,2.5e+09,25,58,83
1216750000,996140000,34010000,125340000,127760000,2.5e+09,24,52,76
409460000,1089130000,34230000,41680000,925500000,2.5e+09,34,63,97
1541900000,612110000,143750000,70700000,131540000,2.5e+09,37,78,115
536460000,1284280000,192190000,18610000,468460000,2.5e+09,33,71,104
1343560000,826630000,179890000,50340000,99580000,2.5e+09,30,67,97
893740000,1404890000,127550000,20650000,53170000,2.5e+09,26,56,82
44820000,2109150000,230960000,1980000,113090000,2.5e+09,37,68,105
803680000,1391890000,117390000,36230000,150810000,2.5e+09,30,66,96
18500000,2292360000,123270000,290000,65580000,2.5e+09,33,65,98
483710000,1619160000,226820000,40020000,130290000,2.5e+09,32,78,110
1428450000,266610000,66760000,194930000,543250000,2.5e+09,31,60,91
94710000,1807480000,287090000,66250000,244470000,2.5e+09,36,72,108
1412780000,471920000,150930000,308240000,156130000,2.5e+09,32,63,95
216350000,1928740000,293880000,32100000,28930000,2.5e+09,31,57,88
551600000,83850000,17380000,380760000,1466410000,2.5e+09,31,58,89
1087540000,200940000,46720000,388230000,776570000,2.5e+09,32,62,94
1528790000,402640000,104810000,117480000,346280000,2.5e+09,34,64,98
986300000,3360000,98690000,1140540000,271110000,2.5e+09,36,67,103
841060000,2.1e+07,79390000,684330000,874220000,2.5e+09,30,49,79
1280930000,11660000,78960000,668090000,460360000,2.5e+09,37,70,107
850970000,74050000,122150000,562270000,890560000,2.5e+09,34,56,90
204720000,872360000,38150000,43350000,1256580000,2415160000,32,64,96
575720000,1643750000,53900000,102440000,124190000,2.5e+09,27,61,88
728890000,1435370000,23080000,150140000,162520000,2.5e+09,27,62,89
1473480000,824930000,32540000,38630000,130420000,2.5e+09,21,53,74
1292470000,924620000,81160000,65730000,136020000,2.5e+09,29,65,94
9930000,2292730000,143100000,60000,54180000,2.5e+09,33,55,88
67570000,2184610000,119070000,21630000,107120000,2.5e+09,33,75,108
828810000,1162140000,271950000,186950000,50150000,2.5e+09,34,63,97
116080000,2033440000,333240000,1010000,16230000,2.5e+09,25,52,77
1175420000,81250000,31650000,404920000,806760000,2.5e+09,30,56,86
1394590000,207740000,59530000,267080000,571060000,2.5e+09,32,66,98
1415590000,43110000,135640000,717110000,188550000,2.5e+09,39,69,108
680840000,14600000,58560000,783460000,962540000,2.5e+09,24,44,68
1074340000,252850000,106630000,1006450000,59730000,2.5e+09,32,61,93
969480000,745490000,192550000,563080000,29400000,2.5e+09,33,55,88
1156350000,752920000,208610000,324090000,58030000,2.5e+09,35,59,94
1264620000,588790000,125410000,478070000,43110000,2.5e+09,29,56,85
276810000,1327810000,654140000,142820000,98420000,2.5e+09,42,78,120
640730000,958310000,390170000,351510000,159280000,2.5e+09,40,77,117
692870000,252330000,745040000,740290000,69470000,2.5e+09,34,68,102
793160000,413980000,606950000,631350000,54560000,2.5e+09,38,67,105
214440000,1127880000,217020000,903460000,37200000,2.5e+09,43,98,141
283850000,1175320000,380810000,538030000,121990000,2.5e+09,35,88,123
255720000,1658200000,295060000,271940000,19080000,2.5e+09,32,76,108
446520000,934250000,845020000,232050000,42160000,2.5e+09,32,71,103
263940000,715570000,218310000,1138680000,163500000,2.5e+09,46,98,144
205840000,610980000,229380000,1333910000,119890000,2.5e+09,44,98,142
166910000,1707590000,2.24e+08,327800000,73700000,2.5e+09,40,87,127
365600000,1534670000,191840000,298550000,109340000,2.5e+09,35,82,117
15230000,436570000,71790000,567370000,1409040000,2.5e+09,45,94,139
22180000,601810000,157140000,759490000,959380000,2.5e+09,39,86,125
964370000,806040000,130130000,532050000,67410000,2.5e+09,39,76,115
1468510000,411360000,163830000,407130000,49170000,2.5e+09,31,58,89
1327370000,752710000,184180000,180160000,55580000,2.5e+09,34,66,100
1067810000,1.002e+09,217170000,159120000,53900000,2.5e+09,39,79,118
806860000,855670000,302640000,455840000,78990000,2.5e+09,38,72,110
467430000,1280980000,202040000,499250000,50300000,2.5e+09,37,79,116
956170000,459100000,368280000,695720000,20730000,2.5e+09,32,55,87
922820000,792310000,201790000,563810000,19270000,2.5e+09,37,66,103
1136900000,647150000,220770000,450160000,45020000,2.5e+09,34,57,91
683540000,1293670000,275910000,190220000,56660000,2.5e+09,37,69,106
859130000,905500000,428680000,288310000,18380000,2.5e+09,38,84,122
789370000,822960000,483990000,338400000,65280000,2.5e+09,39,79,118
1288110000,140890000,265990000,562300000,242710000,2.5e+09,32,57,89
1264570000,62770000,303670000,796880000,72110000,2.5e+09,32,62,94
1222410000,375670000,119380000,653880000,128660000,2.5e+09,33,57,90
1125080000,523750000,224270000,585820000,41080000,2.5e+09,38,67,105
318550000,1485600000,331360000,343360000,21130000,2.5e+09,36,73,109
264370000,1628380000,342490000,236660000,28100000,2.5e+09,36,72,108
354230000,1293010000,527320000,299370000,26070000,2.5e+09,38,72,110
661100000,1125350000,259300000,390500000,63750000,2.5e+09,36,71,107
269150000,1348830000,247130000,533400000,101490000,2.5e+09,38,79,117
303880000,1820060000,129390000,220410000,26260000,2.5e+09,36,84,120
232610000,1069780000,392860000,765310000,39440000,2.5e+09,37,81,118
212030000,1713210000,112200000,335260000,127300000,2.5e+09,36,81,117
127890000,505330000,191240000,1326470000,349070000,2.5e+09,36,81,117
28320000,298730000,56270000,264680000,1.852e+09,2.5e+09,38,87,125
204620000,470980000,159850000,1287030000,377520000,2.5e+09,37,86,123
35070000,631080000,76390000,335360000,1422100000,2.5e+09,39,95,134
32010000,4790000,18570000,14850000,1437070000,1507290000,27,63,90
180130000,1746720000,95580000,57850000,419720000,2.5e+09,38,88,126
39690000,967930000,79390000,51850000,1361140000,2.5e+09,35,85,120
1029850000,810560000,321840000,224810000,112940000,2.5e+09,42,77,119
1351690000,405250000,170490000,557340000,15230000,2.5e+09,35,68,103
1238160000,675910000,205930000,339360000,40640000,2.5e+09,36,60,96
1080860000,450890000,227300000,717820000,23130000,2.5e+09,32,61,93
1300710000,713230000,2.2e+08,253590000,12470000,2.5e+09,35,60,95
1127600000,877270000,261180000,157040000,76910000,2.5e+09,40,78,118
883170000,812090000,492860000,237460000,74420000,2.5e+09,42,81,123
1004760000,918320000,367050000,178260000,31610000,2.5e+09,36,71,107
1211980000,368600000,148410000,737320000,33690000,2.5e+09,33,62,95
1407410000,542010000,217560000,302100000,30920000,2.5e+09,32,61,93
1085970000,742850000,117660000,539460000,14060000,2.5e+09,37,60,97
566870000,1534910000,234390000,139690000,24140000,2.5e+09,37,68,105
955100000,922870000,270380000,305810000,45840000,2.5e+09,36,68,104
1059450000,707110000,122080000,576890000,34470000,2.5e+09,32,56,88
974220000,963370000,124890000,420620000,16900000,2.5e+09,41,64,105
1001140000,600140000,164640000,715380000,18700000,2.5e+09,39,67,106
749020000,1307250000,241040000,178630000,24060000,2.5e+09,34,71,105
984680000,1010610000,139350000,341820000,23540000,2.5e+09,36,61,97
532150000,1502560000,312100000,114920000,38270000,2.5e+09,41,75,116
908530000,1112960000,194900000,253160000,30450000,2.5e+09,38,68,106
476110000,1209880000,168500000,626410000,19100000,2.5e+09,36,76,112
530840000,1250530000,246550000,382440000,89640000,2.5e+09,39,85,124
1231720000,754020000,125310000,231510000,157440000,2.5e+09,39,72,111
887240000,1007720000,265220000,286990000,52830000,2.5e+09,41,82,123
160830000,942900000,156250000,1050920000,189100000,2.5e+09,40,82,122
257620000,1150380000,197980000,799670000,94350000,2.5e+09,39,85,124
340200000,1237640000,229590000,619450000,73120000,2.5e+09,36,81,117
456670000,738670000,752670000,461030000,90960000,2.5e+09,40,86,126
147200000,1516480000,140270000,439530000,256520000,2.5e+09,35,80,115
152640000,1039260000,167320000,1012260000,128520000,2.5e+09,40,88,128
31540000,505340000,45350000,51810000,1865960000,2.5e+09,35,83,118
172310000,980360000,179390000,392610000,775330000,2.5e+09,40,85,125
198830000,1818670000,196930000,33910000,251660000,2.5e+09,34,76,110
90200000,1672980000,132900000,20120000,583800000,2.5e+09,36,80,116
71080000,758850000,74570000,10100000,1585400000,2.5e+09,35,78,113
924050000,726400000,366640000,474530000,8380000,2.5e+09,32,63,95
894270000,895140000,133560000,519870000,57160000,2.5e+09,38,70,108
794200000,1063030000,262100000,346240000,34430000,2.5e+09,37,76,113
674350000,822520000,189990000,757470000,55670000,2.5e+09,39,67,106
990520000,1126850000,149040000,219840000,13750000,2.5e+09,32,56,88
796390000,1030520000,420250000,229580000,23260000,2.5e+09,32,67,99
556370000,1586080000,83140000,260290000,14120000,2.5e+09,33,56,89
923410000,705260000,187450000,668230000,15650000,2.5e+09,34,62,96
987320000,972950000,128820000,402230000,8680000,2.5e+09,40,70,110
1003420000,974470000,167250000,337830000,17030000,2.5e+09,40,79,119
1110350000,680680000,133220000,518950000,56800000,2.5e+09,36,61,97
1104810000,694970000,104220000,575650000,20350000,2.5e+09,39,69,108
397850000,1757560000,165610000,149610000,29370000,2.5e+09,40,74,114
1170090000,648810000,237330000,412740000,31030000,2.5e+09,38,67,105
327990000,1832170000,156090000,137870000,45880000,2.5e+09,42,80,122
1052370000,896820000,159100000,363010000,28700000,2.5e+09,40,67,107
387090000,1676860000,232130000,166010000,37910000,2.5e+09,40,71,111
1304160000,748530000,153380000,220870000,73060000,2.5e+09,41,72,113
248220000,1736240000,268990000,181130000,65420000,2.5e+09,45,79,124
261390000,1836180000,224500000,115410000,62520000,2.5e+09,45,83,128
777340000,1308020000,92100000,306860000,15680000,2.5e+09,41,76,117
676480000,1190880000,161200000,445360000,26080000,2.5e+09,42,77,119
682640000,1116580000,75310000,578670000,46800000,2.5e+09,42,84,126
733430000,1157540000,85840000,405310000,117880000,2.5e+09,44,84,128
214660000,1254410000,173850000,284510000,572570000,2.5e+09,39,85,124
642520000,1178310000,97820000,514300000,67050000,2.5e+09,42,84,126
323390000,1351510000,83310000,301590000,440200000,2.5e+09,44,86,130
694180000,1147540000,127850000,451490000,78940000,2.5e+09,38,78,116
98180000,671680000,53850000,152110000,1524180000,2.5e+09,39,82,121
13100000,72780000,13820000,20370000,2379930000,2.5e+09,31,59,90
649260000,1215730000,263580000,309080000,62350000,2.5e+09,37,64,101
620120000,678750000,190940000,959390000,50800000,2.5e+09,40,74,114
507820000,1505190000,166580000,301020000,19390000,2.5e+09,34,65,99
777180000,541720000,491770000,534260000,155070000,2.5e+09,42,80,122
752940000,1057330000,260910000,421650000,7170000,2.5e+09,33,65,98
747380000,1133410000,121080000,451250000,46880000,2.5e+09,39,78,117
1098130000,715280000,153030000,519700000,13860000,2.5e+09,36,71,107
907070000,1189870000,161340000,211980000,29740000,2.5e+09,37,79,116
416480000,1641940000,175160000,243050000,23370000,2.5e+09,37,73,110
762960000,633690000,189110000,864560000,49680000,2.5e+09,42,71,113
1262090000,118760000,10770000,210000,1108170000,2.5e+09,29,69,98
308070000,63710000,15930000,0,1726890000,2114600000,34,74,108
210500000,26710000,7900000,590000,2254300000,2.5e+09,21,58,79
265160000,30460000,4220000,3e+05,2199860000,2.5e+09,20,46,66
383690000,1.9e+07,5950000,0,2091360000,2.5e+09,16,51,67
606570000,70190000,6670000,0,1816570000,2.5e+09,26,63,89
670290000,110220000,13100000,970000,1705420000,2.5e+09,14,57,71
718380000,129570000,8820000,0,1643230000,2.5e+09,13,57,70
43040000,83950000,4180000,0,2174740000,2305910000,17,49,66
652630000,147160000,48140000,1530000,1650540000,2.5e+09,21,60,81
8020000,68250000,24080000,15620000,1396730000,1512700000,28,66,94
105770000,1436530000,84230000,25020000,848450000,2.5e+09,34,82,116
222050000,1818210000,110470000,10710000,338560000,2.5e+09,30,75,105
1968860000,135570000,23380000,0,372190000,2.5e+09,29,70,99
566180000,51510000,61260000,0,1585830000,2264780000,32,70,102
1381980000,114950000,56420000,0,946650000,2.5e+09,32,81,113
38630000,5380000,880000,0,1054060000,1098950000,18,41,59
1128660000,35670000,7160000,0,1328510000,2.5e+09,20,49,69
1078440000,23910000,5880000,0,1391770000,2.5e+09,18,47,65
1724200000,57340000,7140000,0,711320000,2.5e+09,27,59,86
1982860000,30920000,9490000,0,476730000,2.5e+09,26,55,81
567120000,22190000,13320000,0,1897370000,2.5e+09,15,57,72
1146720000,51540000,20790000,0,1280950000,2.5e+09,22,65,87
583630000,46890000,6620000,270000,1862590000,2.5e+09,18,54,72
400680000,82100000,15480000,0,2001740000,2.5e+09,19,54,73
1077190000,127230000,33570000,3900000,1258110000,2.5e+09,26,65,91
429670000,98220000,2750000,1810000,1967550000,2.5e+09,18,56,74
688480000,271630000,28330000,0,1511560000,2.5e+09,23,74,97
617480000,99070000,8050000,450000,1774950000,2.5e+09,24,62,86
826390000,146600000,5240000,3e+05,1521470000,2.5e+09,29,73,102
272410000,50790000,7450000,0,2169350000,2.5e+09,17,48,65
551760000,95740000,1220000,0,1851280000,2.5e+09,25,75,100
152900000,1703390000,1.11e+08,115890000,416820000,2.5e+09,31,81,112
4.34e+08,1621480000,139720000,26720000,278080000,2.5e+09,29,78,107
200640000,1324940000,107960000,23150000,843310000,2.5e+09,32,79,111
192750000,1326190000,227250000,30820000,722990000,2.5e+09,32,78,110
100920000,1144010000,79320000,62250000,1113500000,2.5e+09,34,87,121
109420000,1193370000,152640000,64070000,980500000,2.5e+09,37,79,116
24420000,910000,220000,0,1034740000,1060290000,15,29,44
1842920000,221370000,68390000,1060000,366260000,2.5e+09,33,74,107
1145350000,61760000,38070000,0,1242630000,2487810000,31,82,113
776810000,552920000,147630000,0,1022640000,2.5e+09,39,84,123
76930000,72320000,33750000,0,1678640000,1861640000,29,61,90
1705560000,96110000,19090000,440000,678800000,2.5e+09,19,55,74
1823960000,176220000,42540000,0,457280000,2.5e+09,33,75,108
1576720000,328880000,40700000,0,553700000,2.5e+09,33,77,110
1293810000,383590000,277430000,420000,544750000,2.5e+09,33,81,114
985690000,138840000,19650000,0,1355820000,2.5e+09,25,58,83
1466770000,93490000,16950000,0,922790000,2.5e+09,22,53,75
1186140000,360780000,60470000,2820000,889790000,2.5e+09,36,80,116
1270100000,361550000,30720000,1030000,836600000,2.5e+09,30,72,102
562990000,116090000,7950000,1e+06,1811970000,2.5e+09,23,67,90
1105580000,138590000,16210000,1750000,1237870000,2.5e+09,28,76,104
1054430000,116720000,24840000,870000,1303140000,2.5e+09,24,63,87
650470000,152580000,5290000,0,1691660000,2.5e+09,25,78,103
367460000,87210000,7660000,610000,2037060000,2.5e+09,25,72,97
769750000,151120000,3890000,0,1575240000,2.5e+09,27,72,99
708870000,102100000,3420000,0,1685610000,2.5e+09,25,72,97
169700000,181010000,10090000,0,2139200000,2.5e+09,26,74,100
884890000,234800000,11720000,0,1368590000,2.5e+09,34,83,117
803980000,194620000,3140000,0,1498260000,2.5e+09,26,71,97
802550000,370130000,97770000,0,1229550000,2.5e+09,33,86,119
47800000,212970000,20040000,3980000,1939440000,2224230000,26,58,84
56380000,196370000,29440000,6790000,2174730000,2463710000,28,69,97
1106740000,416820000,70640000,22740000,883060000,2.5e+09,41,89,130
497720000,269980000,102170000,36570000,1580390000,2486830000,40,85,125
1310580000,600840000,129060000,0,459520000,2.5e+09,38,85,123
892930000,204960000,26980000,12950000,1362180000,2.5e+09,35,81,116
1827770000,156840000,10080000,2e+06,503310000,2.5e+09,33,65,98
1792380000,3.44e+08,19090000,3910000,340620000,2.5e+09,31,70,101
1.282e+09,702750000,83350000,1020000,430880000,2.5e+09,31,74,105
1485930000,572130000,62300000,0,379640000,2.5e+09,35,82,117
1403140000,115130000,24880000,1350000,955500000,2.5e+09,27,78,105
1273730000,404060000,31780000,0,790430000,2.5e+09,34,83,117
984550000,39410000,1030000,0,1475010000,2.5e+09,27,65,92
1484930000,29750000,10240000,0,975080000,2.5e+09,20,68,88
552550000,90260000,1820000,0,1855370000,2.5e+09,23,66,89
950920000,115990000,7810000,0,1425280000,2.5e+09,25,70,95
629070000,489730000,19630000,0,1361570000,2.5e+09,33,86,119
624900000,147020000,6550000,420000,1721110000,2.5e+09,29,76,105
53310000,14980000,0,0,2377420000,2445710000,12,48,60
448360000,49270000,0,0,2002370000,2.5e+09,20,70,90
734460000,173720000,11020000,0,1580800000,2.5e+09,20,61,81
1089910000,229300000,10880000,0,1169910000,2.5e+09,27,70,97
242530000,53230000,0,0,2204240000,2.5e+09,16,51,67
340980000,414640000,54310000,45180000,1643620000,2498730000,24,49,73
541710000,336020000,29580000,22640000,1403850000,2333800000,22,36,58
265500000,255450000,15930000,11450000,1687430000,2235760000,20,37,57
1045640000,415830000,37670000,100630000,900230000,2.5e+09,23,50,73
784890000,791750000,51330000,20620000,851410000,2.5e+09,16,35,51
827240000,1193430000,71370000,19080000,388880000,2.5e+09,26,60,86
1353660000,783320000,99070000,20700000,243250000,2.5e+09,24,51,75
193080000,1060360000,52140000,14350000,1180070000,2.5e+09,27,48,75
451610000,1765220000,111150000,1.8e+07,154020000,2.5e+09,29,57,86
69130000,700600000,393590000,12720000,1283050000,2459090000,27,60,87
705190000,1410250000,129390000,9080000,246090000,2.5e+09,24,59,83
725910000,1592440000,58020000,17420000,106210000,2.5e+09,24,54,78
481230000,1564240000,129520000,35880000,289130000,2.5e+09,30,64,94
1238460000,892460000,39070000,125720000,204290000,2.5e+09,23,50,73
18440000,345760000,21200000,320000,1915060000,2300780000,38,70,108
36860000,1199530000,94920000,0,1168690000,2.5e+09,37,73,110
348410000,1740180000,315900000,37500000,58010000,2.5e+09,31,66,97
8390000,1114030000,258070000,1880000,1117630000,2.5e+09,34,66,100
74290000,764520000,77670000,14070000,1484040000,2414590000,23,42,65
352620000,745790000,51070000,9750000,1340770000,2.5e+09,21,42,63
1163150000,997550000,58890000,48820000,231590000,2.5e+09,26,55,81
584210000,1469330000,210950000,17120000,218390000,2.5e+09,23,52,75
616170000,694140000,70500000,633840000,485350000,2.5e+09,24,52,76
1004160000,977020000,80360000,91600000,346860000,2.5e+09,23,52,75
907690000,1164570000,73230000,147880000,206630000,2.5e+09,27,56,83
1231250000,798090000,55670000,159460000,255530000,2.5e+09,24,55,79
337490000,1799530000,96990000,85730000,180260000,2.5e+09,24,54,78
1137290000,689480000,43030000,297440000,332760000,2.5e+09,24,49,73
41310000,724320000,110560000,1530000,1404020000,2281740000,23,54,77
648860000,1510710000,75150000,69990000,195290000,2.5e+09,26,55,81
35690000,2026440000,276270000,7530000,154070000,2.5e+09,35,80,115
267740000,1101210000,200230000,9870000,920950000,2.5e+09,41,93,134
159640000,282030000,49660000,7450000,1665710000,2164490000,34,68,102
1344560000,71200000,51680000,535560000,4.97e+08,2.5e+09,29,50,79
1329850000,515690000,79200000,112730000,462530000,2.5e+09,39,71,110
1524580000,183190000,88550000,406870000,296810000,2.5e+09,32,62,94
1332070000,547030000,121230000,98150000,401520000,2.5e+09,38,69,107
1447230000,15280000,135340000,598970000,303180000,2.5e+09,34,58,92
720170000,10860000,61610000,946830000,760530000,2.5e+09,30,53,83
1413060000,16730000,141730000,465140000,463340000,2.5e+09,34,62,96
991320000,7930000,91670000,795100000,613980000,2.5e+09,27,51,78
45920000,220230000,35270000,5250000,1867180000,2173850000,22,39,61
750580000,1299360000,87460000,101500000,261100000,2.5e+09,25,64,89
762160000,1177710000,297320000,44430000,218380000,2.5e+09,24,48,72
473080000,1431420000,86440000,111540000,397520000,2.5e+09,26,57,83
1219970000,496620000,24570000,402750000,356090000,2.5e+09,23,50,73
52680000,710660000,44890000,9320000,1465770000,2283320000,21,51,72
505630000,1741450000,34510000,56080000,162330000,2.5e+09,27,55,82
13540000,180320000,25780000,0,1330820000,1550460000,18,38,56
57550000,890800000,87610000,0,1271430000,2307390000,20,39,59
418830000,125340000,36500000,178100000,1741230000,2.5e+09,25,59,84
1532740000,485950000,89130000,162760000,229420000,2.5e+09,43,84,127
1369870000,543220000,57640000,146540000,382730000,2.5e+09,42,89,131
1635300000,494930000,71910000,214790000,83070000,2.5e+09,44,88,132
1801770000,80300000,86930000,89350000,441650000,2.5e+09,29,67,96
1465620000,333710000,166610000,345690000,188370000,2.5e+09,36,66,102
1675880000,317490000,49340000,132090000,325200000,2.5e+09,33,65,98
1373870000,623800000,110880000,313620000,77830000,2.5e+09,38,64,102
1585150000,477370000,107310000,166300000,163870000,2.5e+09,39,80,119
1411150000,18600000,71150000,329450000,669650000,2.5e+09,31,57,88
1251960000,53590000,43800000,788480000,362170000,2.5e+09,25,50,75
1759600000,10470000,45840000,317860000,366230000,2.5e+09,33,59,92
1535670000,154350000,78890000,536020000,195070000,2.5e+09,35,60,95
980560000,1079210000,53530000,122880000,263820000,2.5e+09,27,59,86
1121870000,911160000,41370000,152830000,272770000,2.5e+09,29,55,84
236810000,2124850000,52930000,38050000,47360000,2.5e+09,24,39,63
771090000,1371290000,50660000,109410000,197550000,2.5e+09,27,56,83
8550000,1999790000,49610000,40410000,401640000,2.5e+09,26,55,81
379330000,1964080000,37640000,40600000,78350000,2.5e+09,22,44,66
65220000,1748290000,28860000,41830000,615800000,2.5e+09,25,53,78
546460000,560720000,38990000,163820000,1190010000,2.5e+09,26,52,78
113990000,485980000,130800000,228190000,1541040000,2.5e+09,30,62,92
380550000,545860000,31230000,661690000,880670000,2.5e+09,30,61,91
1661730000,334760000,15690000,174290000,313530000,2.5e+09,25,49,74
1368060000,903600000,53030000,101050000,74260000,2.5e+09,39,74,113
1461750000,628480000,45470000,101590000,262710000,2.5e+09,33,67,100
699520000,1130120000,305550000,167510000,197300000,2.5e+09,37,67,104
1.002e+09,939930000,21770000,167630000,368670000,2.5e+09,31,58,89
1406180000,660310000,119620000,271220000,42670000,2.5e+09,39,68,107
1269430000,894900000,81810000,221820000,32040000,2.5e+09,39,77,116
784740000,1514270000,112630000,54830000,33530000,2.5e+09,40,77,117
854970000,1263790000,79340000,174720000,127180000,2.5e+09,43,86,129
1879650000,44750000,69890000,276700000,229010000,2.5e+09,29,55,84
1481500000,364600000,235820000,383290000,34790000,2.5e+09,37,63,100
1536440000,544800000,145670000,220140000,52950000,2.5e+09,32,62,94
996100000,1290410000,142480000,62460000,8550000,2.5e+09,37,71,108
378680000,1706240000,3e+07,40190000,344890000,2.5e+09,34,55,89
62630000,780800000,102810000,42720000,1495680000,2484640000,28,38,66
132650000,1940250000,59080000,287680000,80340000,2.5e+09,28,43,71
195530000,1873440000,115170000,18810000,297050000,2.5e+09,26,38,64
406370000,248240000,29870000,30680000,1784840000,2.5e+09,24,54,78
558110000,457040000,114500000,301710000,1068640000,2.5e+09,31,56,87
1199030000,954200000,28800000,193230000,124740000,2.5e+09,27,57,84
1677690000,270440000,7880000,379890000,164100000,2.5e+09,23,40,63
978130000,1363680000,51840000,33150000,73200000,2.5e+09,33,66,99
704170000,1361440000,74070000,110240000,250080000,2.5e+09,35,58,93
796040000,983290000,76750000,220410000,423510000,2.5e+09,35,69,104
857100000,1228190000,71400000,145310000,1.98e+08,2.5e+09,33,72,105
1102070000,888360000,51180000,150590000,307800000,2.5e+09,34,66,100
1001090000,1081520000,116560000,163230000,137600000,2.5e+09,37,74,111
656820000,1352140000,144250000,152160000,194630000,2.5e+09,36,70,106
648140000,964160000,139750000,313980000,433970000,2.5e+09,40,90,130
834930000,1123650000,80810000,110460000,350150000,2.5e+09,37,71,108
634850000,1333050000,163870000,114080000,254150000,2.5e+09,43,94,137
737350000,1478290000,139870000,77180000,67310000,2.5e+09,38,68,106
355140000,1678380000,172830000,162930000,130720000,2.5e+09,41,83,124
627450000,1.349e+09,121990000,215160000,186400000,2.5e+09,36,67,103
628980000,1251470000,223850000,274390000,121310000,2.5e+09,46,87,133
276940000,579830000,50820000,114860000,1477550000,2.5e+09,28,81,109
1013320000,310780000,34580000,267030000,874290000,2.5e+09,28,65,93
967500000,1308240000,25430000,116150000,82680000,2.5e+09,26,45,71
1521030000,537750000,27820000,319280000,94120000,2.5e+09,20,38,58
643310000,1448220000,52280000,110750000,245440000,2.5e+09,35,69,104
1077270000,1059650000,78300000,73830000,210950000,2.5e+09,36,70,106
440600000,1598380000,113580000,68450000,278990000,2.5e+09,40,75,115
780220000,1278020000,151170000,139890000,150700000,2.5e+09,37,63,100
402720000,1702470000,173320000,94070000,127420000,2.5e+09,43,80,123
727620000,924260000,161810000,337010000,349300000,2.5e+09,38,78,116
291110000,426020000,78160000,181760000,1522950000,2.5e+09,38,76,114
234220000,1016020000,66980000,251550000,931230000,2.5e+09,45,90,135
77750000,1121030000,276850000,69060000,955310000,2.5e+09,38,90,128
2570000,343850000,46670000,15600000,1694590000,2103280000,29,67,96
481590000,1598240000,97330000,309780000,13060000,2.5e+09,36,62,98
644060000,840360000,158080000,715590000,141910000,2.5e+09,41,78,119
563470000,1282630000,155610000,450880000,47410000,2.5e+09,40,70,110
783720000,910570000,196660000,529440000,79610000,2.5e+09,40,68,108
1124670000,677650000,90300000,579560000,27820000,2.5e+09,45,81,126
651060000,1225110000,132490000,448250000,43090000,2.5e+09,43,78,121
824080000,1070640000,76490000,506610000,22180000,2.5e+09,41,70,111
1414200000,109140000,78290000,708420000,189950000,2.5e+09,35,63,98
1249270000,505120000,160970000,437120000,147520000,2.5e+09,44,79,123
1130730000,681330000,97800000,535140000,5.5e+07,2.5e+09,43,78,121
739140000,909360000,103810000,4.51e+08,296690000,2.5e+09,44,84,128
921180000,1188830000,137800000,206930000,45260000,2.5e+09,40,73,113
449400000,1293200000,345270000,380320000,31810000,2.5e+09,39,77,116
309600000,1728750000,188070000,230870000,42710000,2.5e+09,41,77,118
745250000,855620000,269260000,520750000,109120000,2.5e+09,37,70,107
1084270000,932670000,95150000,317540000,70370000,2.5e+09,39,74,113
1032440000,852640000,157070000,347950000,109900000,2.5e+09,40,79,119
849860000,1131160000,114940000,355210000,48830000,2.5e+09,47,78,125
1182250000,680050000,105180000,389880000,142640000,2.5e+09,42,77,119
582900000,587070000,840320000,359670000,130040000,2.5e+09,41,85,126
369660000,1428180000,124160000,501650000,76350000,2.5e+09,39,77,116
643140000,1134480000,66900000,367080000,288400000,2.5e+09,41,77,118
309990000,1563920000,86290000,429220000,110580000,2.5e+09,41,84,125
807070000,1081140000,84810000,350790000,176190000,2.5e+09,42,80,122
90440000,105480000,25620000,63860000,2023800000,2309200000,31,73,104
435700000,836690000,51520000,104720000,1071370000,2.5e+09,38,90,128
18410000,399790000,28680000,23750000,1371050000,1841680000,29,66,95
975490000,722320000,125220000,600110000,76860000,2.5e+09,39,64,103
582280000,1428500000,286750000,162980000,39490000,2.5e+09,43,68,111
1211520000,864940000,84330000,310830000,28380000,2.5e+09,35,63,98
839790000,1068090000,171150000,377720000,43250000,2.5e+09,40,70,110
766350000,1287300000,85420000,299080000,61850000,2.5e+09,46,88,134
1156960000,594180000,42400000,563440000,143020000,2.5e+09,49,92,141
707480000,1432960000,95860000,221670000,42030000,2.5e+09,41,79,120
948640000,915730000,135360000,364810000,135460000,2.5e+09,49,93,142
416980000,1791730000,188510000,49900000,52880000,2.5e+09,44,81,125
1144790000,968020000,171190000,177370000,38630000,2.5e+09,42,78,120
525890000,1606570000,267310000,44140000,56090000,2.5e+09,43,77,120
687550000,1273670000,367290000,128200000,43290000,2.5e+09,42,74,116
816030000,933170000,323680000,363760000,63360000,2.5e+09,42,78,120
1021450000,637360000,221760000,493080000,126350000,2.5e+09,40,80,120
802790000,983060000,176370000,344620000,193160000,2.5e+09,44,84,128
1075150000,676130000,174190000,494340000,80190000,2.5e+09,41,74,115
1297360000,570550000,153270000,363170000,115650000,2.5e+09,40,78,118
946720000,7.29e+08,193690000,376980000,253610000,2.5e+09,44,86,130
1490040000,594250000,122780000,196990000,95940000,2.5e+09,39,84,123
1.241e+09,584560000,176810000,242080000,255550000,2.5e+09,41,83,124
968050000,954140000,120860000,328510000,128440000,2.5e+09,46,87,133
913740000,964270000,377780000,177770000,66440000,2.5e+09,43,84,127
708290000,1325780000,88350000,249310000,128270000,2.5e+09,38,85,123
791520000,1245420000,96870000,305920000,60270000,2.5e+09,47,90,137
393540000,737660000,78010000,423750000,867040000,2.5e+09,43,91,134
482550000,1426630000,79780000,421880000,89160000,2.5e+09,42,83,125
487020000,375540000,57720000,235300000,1344420000,2.5e+09,38,85,123
949280000,701200000,209560000,387120000,252840000,2.5e+09,43,85,128
27890000,40310000,26170000,19850000,1266300000,1380520000,34,70,104
306260000,485620000,85390000,130250000,1280500000,2288020000,35,81,116
1184390000,1114920000,101050000,67890000,31750000,2.5e+09,39,73,112
1165950000,879770000,141640000,287920000,24720000,2.5e+09,40,64,104
514690000,1751810000,195970000,2430000,35100000,2.5e+09,38,75,113
1360620000,586090000,347890000,184940000,20460000,2.5e+09,38,71,109
740190000,1454290000,97630000,183910000,23980000,2.5e+09,39,77,116
846850000,1394420000,97600000,130300000,30830000,2.5e+09,41,73,114
777900000,1414100000,107130000,165990000,34880000,2.5e+09,44,78,122
648100000,1671860000,120660000,15290000,44090000,2.5e+09,43,87,130
552410000,1648970000,149690000,121360000,27570000,2.5e+09,47,83,130
598910000,1593680000,146690000,93540000,67180000,2.5e+09,43,82,125
727690000,1274720000,203100000,228230000,66260000,2.5e+09,42,83,125
661330000,1424610000,175730000,203480000,34850000,2.5e+09,45,81,126
1141720000,998910000,185320000,85370000,88680000,2.5e+09,36,78,114
1045930000,724970000,201160000,353420000,174520000,2.5e+09,42,73,115
596970000,1502470000,208720000,113530000,78310000,2.5e+09,39,80,119
926920000,881280000,213580000,379250000,98970000,2.5e+09,44,74,118
1422860000,739120000,111730000,156040000,70250000,2.5e+09,39,75,114
1230820000,898100000,134860000,133770000,102450000,2.5e+09,36,73,109
918880000,1105290000,111240000,295280000,69310000,2.5e+09,36,75,111
885510000,1153930000,1.25e+08,215430000,120130000,2.5e+09,39,81,120
965230000,1187530000,58760000,202330000,86150000,2.5e+09,38,80,118
1257440000,778310000,107340000,275900000,81010000,2.5e+09,40,85,125
1588450000,559260000,42820000,232750000,76720000,2.5e+09,40,78,118
1199320000,1051280000,52600000,113710000,83090000,2.5e+09,38,79,117
773560000,1206140000,81570000,310600000,128130000,2.5e+09,37,83,120
741960000,1309430000,93160000,235090000,120360000,2.5e+09,37,82,119
1087640000,1054870000,75120000,206860000,75510000,2.5e+09,37,74,111
1244340000,807730000,69250000,146590000,232090000,2.5e+09,39,82,121
1062840000,1021350000,88840000,209260000,117710000,2.5e+09,37,83,120
455470000,392940000,31590000,197280000,1338260000,2415540000,38,83,121
1103760000,1033810000,76800000,153510000,132120000,2.5e+09,35,75,110
446640000,1789840000,189860000,31900000,41760000,2.5e+09,42,86,128
361850000,1544410000,368850000,35060000,189830000,2.5e+09,44,90,134
941890000,1266640000,165010000,61150000,65310000,2.5e+09,43,77,120
307580000,1730770000,312790000,18630000,130230000,2.5e+09,46,88,134
1045110000,1094210000,198050000,85360000,77270000,2.5e+09,41,72,113
326190000,1870520000,210360000,14100000,78830000,2.5e+09,45,94,139
592680000,1480780000,253560000,95440000,77540000,2.5e+09,45,95,140
786430000,1295070000,182830000,198010000,37660000,2.5e+09,46,91,137
1045930000,904470000,97230000,322440000,129930000,2.5e+09,44,78,122
921180000,1106970000,159680000,282980000,29190000,2.5e+09,41,81,122
602910000,1469760000,1.66e+08,161320000,100010000,2.5e+09,48,81,129
700630000,863180000,110900000,569810000,255480000,2.5e+09,48,77,125
513130000,1454970000,321090000,140850000,69960000,2.5e+09,41,80,121
408770000,1834220000,170220000,50070000,36720000,2.5e+09,44,80,124
754660000,1310440000,151290000,194950000,88660000,2.5e+09,41,82,123
733390000,1418370000,165560000,113980000,68700000,2.5e+09,40,80,120
472420000,1600660000,149970000,218070000,58880000,2.5e+09,41,85,126
591120000,1523580000,141890000,196690000,46720000,2.5e+09,41,83,124
437790000,1726200000,113660000,193850000,28500000,2.5e+09,37,83,120
734250000,1350080000,133520000,212780000,69370000,2.5e+09,40,84,124
818650000,1191460000,105200000,325710000,58980000,2.5e+09,40,83,123
686500000,1294130000,315960000,104060000,99350000,2.5e+09,39,78,117
489850000,1503870000,126820000,271950000,107510000,2.5e+09,37,78,115
423180000,1797640000,108630000,69310000,101240000,2.5e+09,38,76,114
1381970000,733660000,53510000,162050000,168810000,2.5e+09,35,77,112
1146400000,1004440000,70420000,140590000,138150000,2.5e+09,40,76,116
1308090000,659170000,53330000,168930000,310480000,2.5e+09,38,80,118
614750000,1577220000,66420000,112090000,129520000,2.5e+09,36,77,113
531840000,1676900000,248480000,9730000,33050000,2.5e+09,40,75,115
86830000,2162830000,201460000,7260000,41620000,2.5e+09,44,81,125
156190000,482620000,181380000,15270000,1653830000,2489290000,36,76,112
891460000,677120000,109800000,46930000,774690000,2.5e+09,43,88,131
823970000,1057310000,160410000,75110000,383200000,2.5e+09,36,84,120
754140000,249480000,217420000,29530000,1249430000,2.5e+09,39,83,122
68680000,223550000,37470000,26320000,1837520000,2193540000,41,84,125
1827970000,279210000,73780000,15630000,303410000,2.5e+09,36,76,112
1723890000,416410000,30930000,10600000,318170000,2.5e+09,36,74,110
512640000,1264250000,47170000,12470000,663470000,2.5e+09,40,88,128
1606720000,559140000,64580000,28930000,240630000,2.5e+09,35,78,113
1678520000,327990000,24950000,8090000,460450000,2.5e+09,38,80,118
573350000,216250000,14810000,1690000,1693900000,2.5e+09,36,80,116
2031290000,80010000,10580000,0,378120000,2.5e+09,30,64,94
1849520000,206140000,26430000,2680000,415230000,2.5e+09,35,74,109
1584710000,13050000,18700000,490000,883050000,2.5e+09,24,74,98
1941870000,21010000,3980000,0,533140000,2.5e+09,26,74,100
1341380000,15480000,10960000,690000,1131490000,2.5e+09,28,74,102
674990000,11210000,1320000,21770000,1790710000,2.5e+09,20,61,81
861590000,7660000,8210000,42390000,1580150000,2.5e+09,26,70,96
1749780000,243850000,37110000,19590000,449670000,2.5e+09,32,81,113
1553200000,602760000,92860000,112870000,138310000,2.5e+09,36,88,124
1553780000,249390000,21170000,24470000,651190000,2.5e+09,34,81,115
1215810000,384870000,79260000,67390000,752670000,2.5e+09,43,95,138
1927420000,211260000,53630000,9860000,297830000,2.5e+09,32,79,111
1631100000,243060000,52330000,15620000,557890000,2.5e+09,33,82,115
1811430000,360630000,50800000,35130000,242010000,2.5e+09,36,79,115
1738250000,237720000,58190000,16520000,449320000,2.5e+09,34,80,114
1062820000,1111470000,64070000,90200000,171440000,2.5e+09,38,89,127
1484920000,648640000,56440000,61510000,248490000,2.5e+09,36,86,122
692870000,518010000,39660000,20420000,1229040000,2.5e+09,38,87,125
1257050000,374710000,56610000,42160000,769470000,2.5e+09,38,86,124
676320000,294220000,81480000,6540000,1441440000,2.5e+09,38,86,124
396340000,230140000,19370000,3650000,1850500000,2.5e+09,38,78,116
1734910000,322920000,61900000,8520000,371750000,2.5e+09,42,85,127
1494110000,291730000,25290000,8250000,680620000,2.5e+09,40,84,124
1821420000,60310000,14150000,8e+05,603320000,2.5e+09,26,66,92
1869170000,195800000,17960000,4950000,412120000,2.5e+09,32,76,108
1876480000,14440000,10590000,530000,597960000,2.5e+09,34,71,105
1930770000,40240000,27550000,1810000,499630000,2.5e+09,35,69,104
1802420000,26820000,23020000,2760000,644980000,2.5e+09,29,66,95
1763600000,28360000,16710000,3360000,687970000,2.5e+09,27,76,103
1863240000,63130000,43140000,9600000,520890000,2.5e+09,36,80,116
1493640000,3090000,5220000,1500000,996550000,2.5e+09,20,58,78
1658450000,930000,3790000,310000,836520000,2.5e+09,21,59,80
1687400000,16970000,9840000,2520000,783270000,2.5e+09,24,61,85
1717430000,280000,1510000,0,780780000,2.5e+09,17,58,75
1200820000,2760000,6940000,30950000,1258530000,2.5e+09,20,61,81
1587340000,8750000,12430000,4640000,886840000,2.5e+09,26,65,91
1675540000,163180000,7600000,740000,652940000,2.5e+09,31,65,96
1704180000,23550000,10740000,2360000,759170000,2.5e+09,25,67,92
1650980000,65240000,13610000,10070000,760100000,2.5e+09,31,74,105
2009820000,158960000,26680000,12120000,292420000,2.5e+09,27,74,101
778870000,175930000,49010000,30700000,1465420000,2499930000,43,98,141
204290000,393420000,58350000,153520000,1688990000,2498570000,42,100,142
1973960000,264810000,40260000,22690000,198280000,2.5e+09,32,77,109
2.055e+09,122390000,18780000,17210000,286620000,2.5e+09,33,78,111
1976500000,180640000,26300000,17320000,299240000,2.5e+09,38,85,123
1669970000,193220000,41200000,9880000,585730000,2.5e+09,35,85,120
1009490000,1076010000,115390000,52470000,246640000,2.5e+09,38,89,127
1869470000,211590000,18140000,41740000,359060000,2.5e+09,35,80,115
818750000,477560000,18570000,21100000,1164020000,2.5e+09,38,91,129
1023020000,888930000,105450000,18490000,464110000,2.5e+09,42,87,129
1842220000,337160000,37770000,22790000,260060000,2.5e+09,33,82,115
1134200000,769820000,91350000,21340000,483290000,2.5e+09,43,82,125
1499220000,499680000,47860000,18760000,434480000,2.5e+09,38,86,124
1850240000,200880000,59920000,2100000,386860000,2.5e+09,38,83,121
1837730000,220080000,27780000,2810000,411600000,2.5e+09,33,80,113
1666110000,428600000,39960000,9080000,356250000,2.5e+09,34,85,119
1208750000,735010000,108830000,17060000,430350000,2.5e+09,42,89,131
1893960000,43760000,10850000,4910000,546520000,2.5e+09,29,73,102
1790190000,158690000,21080000,2070000,527970000,2.5e+09,35,78,113
1818020000,154460000,44610000,5600000,477310000,2.5e+09,35,79,114
1763640000,38700000,5600000,590000,691470000,2.5e+09,29,64,93
1800840000,36250000,9200000,1100000,652610000,2.5e+09,34,74,108
1868380000,102600000,17920000,3320000,507780000,2.5e+09,35,76,111
1908060000,223160000,25080000,2500000,341200000,2.5e+09,36,79,115
1805820000,27070000,4240000,820000,662050000,2.5e+09,23,59,82
1798940000,32660000,6100000,1760000,660540000,2.5e+09,30,63,93
1888550000,56420000,6530000,3710000,544790000,2.5e+09,25,63,88
1767690000,93450000,9740000,720000,628400000,2.5e+09,30,67,97
1447050000,39990000,7470000,16650000,988840000,2.5e+09,29,70,99
1735330000,47470000,3710000,4420000,709070000,2.5e+09,29,64,93
1611180000,36330000,5880000,4370000,842240000,2.5e+09,18,51,69
1962160000,71470000,3860000,3240000,459270000,2.5e+09,23,60,83
109630000,81420000,5180000,32250000,2256160000,2484640000,38,88,126
1167480000,513680000,71030000,24070000,723740000,2.5e+09,39,85,124
1114620000,590400000,68030000,14220000,712730000,2.5e+09,41,93,134
925470000,314030000,648890000,17100000,594510000,2.5e+09,35,85,120
357170000,111220000,32300000,7590000,1921200000,2429480000,37,88,125
1490020000,5.43e+08,28820000,14680000,423480000,2.5e+09,40,92,132
1031920000,1069900000,128710000,43730000,225740000,2.5e+09,41,89,130
456260000,14490000,33770000,1470000,1722370000,2228360000,36,78,114
1123560000,101460000,89820000,13050000,1172110000,2.5e+09,43,96,139
891540000,93950000,13530000,320000,1500660000,2.5e+09,39,88,127
522640000,45560000,25780000,5840000,1860710000,2460530000,38,84,122
1929070000,111940000,32600000,1200000,425190000,2.5e+09,34,82,116
1292110000,185460000,92090000,5980000,924360000,2.5e+09,41,91,132
1691890000,18800000,2190000,1990000,785130000,2.5e+09,17,52,69
1872590000,110160000,15430000,2440000,499380000,2.5e+09,30,73,103
772070000,102910000,2520000,0,1622500000,2.5e+09,20,57,77
778310000,74540000,1590000,0,1645560000,2.5e+09,20,60,80
314120000,120450000,6860000,0,2058570000,2.5e+09,16,56,72
647960000,70510000,1280000,0,1780250000,2.5e+09,16,53,69
171540000,112860000,6450000,640000,2208510000,2.5e+09,20,70,90
777570000,22560000,1470000,2680000,1695720000,2.5e+09,22,60,82
499010000,13540000,310000,6210000,1980930000,2.5e+09,22,62,84
1118180000,5570000,1600000,58960000,1315690000,2.5e+09,20,55,75
1306910000,4370000,50000,6030000,1182640000,2.5e+09,26,69,95
782120000,31470000,890000,0,1685520000,2.5e+09,13,48,61
813150000,21290000,1410000,26770000,1637380000,2.5e+09,15,50,65
501700000,6350000,1340000,59310000,1931300000,2.5e+09,16,62,78
317120000,46320000,0,0,2136560000,2.5e+09,20,56,76
776980000,144070000,11950000,0,1.567e+09,2.5e+09,28,69,97
640110000,29650000,16700000,0,1813540000,2.5e+09,27,60,87
171440000,32040000,1880000,0,2116180000,2321540000,23,66,89
268210000,56210000,20800000,460000,2154320000,2.5e+09,21,65,86
561970000,54830000,2380000,0,1880820000,2.5e+09,22,60,82
1459470000,8160000,560000,6690000,1025120000,2.5e+09,20,61,81
1686400000,30700000,1390000,8380000,773130000,2.5e+09,25,57,82
1369560000,27100000,5060000,4610000,1093670000,2.5e+09,27,73,100
1559760000,24210000,3730000,7110000,905190000,2.5e+09,28,60,88
1270680000,3950000,4800000,23450000,1197120000,2.5e+09,18,54,72
1435920000,3330000,5410000,20920000,1034420000,2.5e+09,22,60,82
1828470000,6820000,910000,1120000,662680000,2.5e+09,20,54,74
1602790000,4980000,2560000,0,889670000,2.5e+09,23,64,87
148930000,1660000,0,44510000,2304900000,2.5e+09,14,49,63
355280000,460000,0,148810000,1995450000,2.5e+09,21,60,81
1120690000,0,0,18720000,1360590000,2.5e+09,19,47,66
609670000,28740000,4800000,18540000,1838250000,2.5e+09,24,70,94
483770000,30130000,2650000,0,1983450000,2.5e+09,18,53,71
675400000,60090000,960000,0,1763550000,2.5e+09,14,50,64
622100000,48290000,13870000,5640000,1810100000,2.5e+09,18,62,80
453630000,37060000,1620000,0,2007690000,2.5e+09,14,52,66
761390000,127380000,15960000,0,1595270000,2.5e+09,21,66,87
1457570000,15980000,520000,970000,1024960000,2.5e+09,21,59,80
1592700000,19470000,4590000,850000,882390000,2.5e+09,24,62,86
1434560000,19040000,8740000,2390000,1035270000,2.5e+09,22,57,79
263040000,0,570000,67920000,2168470000,2.5e+09,13,53,66
1006040000,3e+05,0,23960000,1469700000,2.5e+09,13,40,53
792240000,71800000,7970000,27210000,1600780000,2.5e+09,11,44,55
119170000,250490000,21460000,66120000,2042760000,2.5e+09,22,41,63
130900000,438690000,49720000,201530000,1679160000,2.5e+09,35,68,103
477400000,681630000,53930000,299100000,987940000,2.5e+09,27,48,75
105220000,618700000,55360000,95120000,1625600000,2.5e+09,29,65,94
1183190000,281070000,11270000,237090000,787380000,2.5e+09,26,57,83
56870000,557200000,10180000,5340000,1870410000,2.5e+09,20,33,53
24260000,893750000,38190000,0,1543800000,2.5e+09,20,34,54
330770000,1033690000,14810000,165320000,955410000,2.5e+09,20,40,60
221650000,1157330000,28450000,131030000,961540000,2.5e+09,16,29,45
461250000,886360000,50590000,131020000,970780000,2.5e+09,29,65,94
35260000,588260000,15310000,22680000,1838490000,2.5e+09,26,53,79
1303310000,305530000,20620000,69660000,800880000,2.5e+09,18,40,58
262930000,735460000,61660000,87710000,1352240000,2.5e+09,27,51,78
616920000,513390000,16490000,123640000,1229560000,2.5e+09,25,54,79
169070000,1400280000,103680000,387490000,439480000,2.5e+09,26,51,77
451330000,878040000,14020000,368090000,788520000,2.5e+09,22,41,63
187880000,615780000,11790000,152610000,1531940000,2.5e+09,21,44,65
0,47470000,540000,17550000,1991160000,2056720000,11,25,36
50260000,439800000,12370000,62630000,1934940000,2.5e+09,19,26,45
397970000,721050000,26160000,175570000,1179250000,2.5e+09,23,51,74
530020000,640780000,24200000,292780000,1012220000,2.5e+09,19,47,66
127700000,801320000,60600000,84530000,1425850000,2.5e+09,22,30,52
83730000,239270000,20150000,137010000,2019840000,2.5e+09,21,35,56
725820000,541060000,35700000,219260000,978160000,2.5e+09,32,66,98
245250000,389020000,18580000,84840000,1762310000,2.5e+09,22,49,71
147220000,1008300000,44080000,37020000,1263380000,2.5e+09,23,36,59
306530000,505730000,55530000,74540000,1557670000,2.5e+09,22,34,56
6180000,1937490000,99890000,179900000,276540000,2.5e+09,25,38,63
177070000,1199990000,62220000,88640000,972080000,2.5e+09,32,69,101
374120000,405150000,55230000,51260000,1.565e+09,2450760000,33,65,98
382710000,485980000,46260000,55430000,1529620000,2.5e+09,19,32,51
673700000,366980000,8630000,409420000,1041270000,2.5e+09,20,51,71
222490000,214280000,44190000,73620000,1945420000,2.5e+09,23,57,80
830930000,1377630000,86230000,105780000,99430000,2.5e+09,32,61,93
435160000,1712920000,85770000,78380000,187770000,2.5e+09,36,70,106
6.36e+08,1498810000,91100000,81610000,192480000,2.5e+09,33,66,99
1202170000,512060000,9360000,277100000,499310000,2.5e+09,25,56,81
314840000,1889230000,1.62e+08,6e+06,127930000,2.5e+09,36,69,105
358670000,1647110000,92910000,82170000,319140000,2.5e+09,43,80,123
313360000,1796120000,142110000,21050000,227360000,2.5e+09,35,61,96
5910000,2268320000,127110000,55560000,43100000,2.5e+09,36,61,97
249670000,1937590000,118290000,42860000,151590000,2.5e+09,36,74,110
305390000,1789600000,122090000,151460000,131460000,2.5e+09,43,82,125
534780000,1635340000,111310000,72230000,146340000,2.5e+09,39,69,108
337350000,1218090000,87280000,506850000,350430000,2.5e+09,39,83,122
489750000,1445250000,94510000,199450000,271040000,2.5e+09,36,74,110
768790000,1053190000,308960000,146240000,222820000,2.5e+09,41,81,122
181310000,1736630000,260750000,159370000,161940000,2.5e+09,42,90,132
451520000,1128250000,5.94e+08,119690000,206540000,2.5e+09,40,76,116
444560000,1194570000,185360000,400330000,275180000,2.5e+09,41,84,125
774510000,1548840000,69480000,4.9e+07,58170000,2.5e+09,30,47,77
1280690000,732240000,37850000,85980000,363240000,2.5e+09,21,56,77
231790000,1889420000,203100000,31470000,144220000,2.5e+09,36,76,112
104510000,1814790000,301320000,49090000,230290000,2.5e+09,41,79,120
15560000,2.048e+09,111940000,218610000,105890000,2.5e+09,39,78,117
118690000,1832470000,182600000,148320000,217920000,2.5e+09,43,92,135
5650000,2276610000,112360000,74410000,30970000,2.5e+09,37,62,99
14020000,1961030000,118010000,255750000,151190000,2.5e+09,36,70,106
268700000,1623180000,107860000,360990000,139270000,2.5e+09,41,88,129
254650000,1618250000,176400000,294900000,155800000,2.5e+09,42,93,135
35840000,2.187e+09,99400000,154970000,22790000,2.5e+09,34,69,103
33570000,2154280000,108850000,173390000,29910000,2.5e+09,41,81,122
169700000,1829550000,153980000,218760000,128010000,2.5e+09,37,73,110
106090000,1566320000,128980000,475880000,222730000,2.5e+09,41,92,133
612460000,994960000,30560000,280590000,581430000,2.5e+09,34,64,98
744960000,832580000,36840000,284620000,6.01e+08,2.5e+09,43,100,143
843330000,509850000,14850000,474020000,657950000,2.5e+09,35,67,102
811520000,734850000,49750000,320840000,583040000,2.5e+09,32,67,99
737680000,1480700000,116800000,22330000,142490000,2.5e+09,30,56,86
479230000,1465210000,79910000,199020000,276630000,2.5e+09,44,89,133
1794860000,312840000,32580000,3.19e+08,40720000,2.5e+09,28,53,81
1721180000,417870000,14300000,99510000,247140000,2.5e+09,27,63,90
220590000,1676420000,187930000,356580000,58480000,2.5e+09,36,63,99
159970000,1895810000,99470000,301470000,43280000,2.5e+09,34,66,100
881870000,1021920000,105500000,404440000,86270000,2.5e+09,31,53,84
1268350000,696540000,70590000,416210000,48310000,2.5e+09,23,50,73
134790000,1684670000,146590000,429770000,104180000,2.5e+09,40,85,125
86870000,2003600000,170990000,192940000,45600000,2.5e+09,37,65,102
701340000,1279800000,107340000,364740000,46780000,2.5e+09,35,69,104
1199140000,868670000,88090000,293640000,50460000,2.5e+09,32,59,91
91580000,1392620000,148540000,690170000,177090000,2.5e+09,40,97,137
60010000,1760910000,91750000,521270000,66060000,2.5e+09,41,88,129
722230000,1203200000,154620000,199340000,220610000,2.5e+09,38,76,114
271730000,1658860000,195610000,306760000,67040000,2.5e+09,38,78,116
441530000,1274430000,88580000,16860000,678600000,2.5e+09,36,74,110
118710000,918090000,127630000,18930000,1316640000,2.5e+09,37,64,101
789160000,723550000,42380000,198920000,745990000,2.5e+09,37,73,110
378760000,1775280000,92630000,91440000,161890000,2.5e+09,30,53,83
895120000,1002800000,6.4e+07,119320000,418760000,2.5e+09,44,100,144
355380000,1352440000,135030000,183120000,474030000,2.5e+09,35,61,96
1188270000,623260000,31810000,327010000,329650000,2.5e+09,36,73,109
879890000,839650000,86690000,344190000,349580000,2.5e+09,43,77,120
1182050000,592900000,36040000,286860000,402150000,2.5e+09,37,75,112
999170000,600020000,70850000,425280000,404680000,2.5e+09,40,87,127
441800000,1166930000,350290000,263870000,277110000,2.5e+09,41,85,126
144730000,1867100000,145500000,136270000,206400000,2.5e+09,36,74,110
1434170000,368640000,53520000,549470000,94200000,2.5e+09,23,50,73
457890000,1646510000,100900000,272900000,21800000,2.5e+09,27,51,78
1584840000,221110000,25620000,422510000,245920000,2.5e+09,19,52,71
1481110000,402860000,53440000,475980000,86610000,2.5e+09,32,57,89
1640900000,438470000,63330000,300260000,57040000,2.5e+09,24,44,68
1279140000,418460000,55240000,669150000,78010000,2.5e+09,31,58,89
231200000,1750720000,182720000,295840000,39520000,2.5e+09,34,64,98
892260000,606310000,37180000,298640000,665610000,2.5e+09,39,69,108
396610000,1313360000,60670000,22760000,706600000,2.5e+09,31,54,85
1585060000,438900000,45160000,133760000,297120000,2.5e+09,40,76,116
906630000,883910000,96050000,267650000,345760000,2.5e+09,34,67,101
1216440000,727890000,104090000,175760000,275820000,2.5e+09,38,77,115
237100000,1813140000,109240000,173860000,166660000,2.5e+09,44,78,122
364850000,1281540000,148790000,643710000,61110000,2.5e+09,37,72,109
1303630000,329190000,83100000,736290000,47790000,2.5e+09,25,54,79
751980000,1166730000,329210000,103190000,148890000,2.5e+09,42,79,121
393450000,1300640000,517020000,142450000,146440000,2.5e+09,45,92,137
897310000,524170000,620300000,283780000,174440000,2.5e+09,36,81,117
825150000,958740000,421540000,151400000,143170000,2.5e+09,41,90,131
547560000,1614550000,120650000,185590000,31650000,2.5e+09,35,66,101
1253530000,897580000,104730000,183910000,60250000,2.5e+09,43,84,127
741120000,1120290000,1.44e+08,333670000,160920000,2.5e+09,33,73,106
811110000,988330000,268560000,316340000,115660000,2.5e+09,37,74,111
528890000,1334950000,130520000,378700000,126940000,2.5e+09,39,84,123
446370000,1613610000,144140000,218660000,77220000,2.5e+09,37,82,119
217050000,1860520000,101090000,268680000,52660000,2.5e+09,35,78,113
542350000,1336420000,349360000,220280000,51590000,2.5e+09,37,77,114
761390000,1.28e+09,212470000,158850000,87290000,2.5e+09,38,75,113
243690000,1909870000,72240000,95690000,178510000,2.5e+09,37,81,118
608100000,1664970000,68750000,93960000,64220000,2.5e+09,42,83,125
534220000,1636820000,77920000,88240000,162800000,2.5e+09,42,84,126
1058940000,1134270000,73920000,151690000,81180000,2.5e+09,35,75,110
790250000,1.394e+09,72420000,137690000,105640000,2.5e+09,37,79,116
379250000,1745790000,116710000,155920000,102330000,2.5e+09,43,81,124
460950000,1741170000,89870000,98350000,109660000,2.5e+09,43,83,126
388230000,326410000,98540000,133830000,1524320000,2471330000,37,78,115
746250000,1.097e+09,280670000,102370000,273710000,2.5e+09,42,83,125
80980000,8.89e+08,82100000,30730000,1417190000,2.5e+09,40,83,123
1387350000,780940000,131100000,152590000,48020000,2.5e+09,39,65,104
519760000,1780750000,130730000,29800000,38960000,2.5e+09,44,77,121
1353780000,744280000,95650000,251020000,55270000,2.5e+09,42,67,109
904040000,1132080000,111340000,224230000,128310000,2.5e+09,40,79,119
1505600000,522150000,150160000,208920000,113170000,2.5e+09,41,67,108
993130000,901640000,188510000,294770000,121950000,2.5e+09,40,85,125
1410670000,653960000,147250000,194700000,93420000,2.5e+09,44,81,125
1310700000,486290000,108330000,330170000,264510000,2.5e+09,40,67,107
1645580000,342950000,99940000,267130000,144400000,2.5e+09,38,72,110
389630000,1796860000,201050000,99460000,1.3e+07,2.5e+09,34,68,102
725120000,1158030000,395910000,141450000,79490000,2.5e+09,40,76,116
222940000,1712480000,173220000,334660000,56700000,2.5e+09,39,86,125
736190000,1398240000,172060000,101380000,92130000,2.5e+09,36,77,113
820410000,1140610000,137860000,272270000,128850000,2.5e+09,36,81,117
847850000,1134050000,99900000,338160000,80040000,2.5e+09,38,79,117
1180250000,780500000,157760000,217470000,164020000,2.5e+09,36,83,119
774410000,1122960000,231460000,296520000,74650000,2.5e+09,40,80,120
303530000,1792710000,157460000,184750000,61550000,2.5e+09,36,80,116
612020000,1489560000,186750000,131140000,80530000,2.5e+09,38,75,113
547260000,1254800000,423230000,156240000,118470000,2.5e+09,42,86,128
503400000,1664140000,79130000,187540000,65790000,2.5e+09,37,79,116
634790000,1283280000,67090000,465960000,48880000,2.5e+09,39,82,121
355390000,1851060000,87610000,99800000,106140000,2.5e+09,38,80,118
472500000,1591200000,86460000,298280000,51560000,2.5e+09,37,72,109
497340000,1594400000,138140000,179370000,90750000,2.5e+09,38,84,122
774980000,1309730000,82450000,125430000,207410000,2.5e+09,40,80,120
689060000,1424290000,97570000,157640000,131440000,2.5e+09,40,74,114
747120000,1306660000,113380000,182730000,150110000,2.5e+09,39,84,123
1302370000,700370000,73070000,251970000,172220000,2.5e+09,40,79,119
0,0,0,0,2.24e+08,2.24e+08,40,83,123
469100000,847330000,37960000,50620000,556140000,1961150000,40,83,123
346770000,818750000,25230000,74730000,71100000,1336580000,43,81,124
10470000,0,880000,0,918630000,929980000,31,57,88
1225890000,940640000,78100000,141790000,113580000,2.5e+09,41,72,113
1293710000,594350000,128230000,283080000,200630000,2.5e+09,38,70,108
1198500000,761530000,83860000,261980000,194130000,2.5e+09,40,73,113
826770000,1056540000,202760000,227430000,186500000,2.5e+09,40,81,121
1010750000,622940000,155910000,454650000,255750000,2.5e+09,41,74,115
1269990000,380770000,77250000,267350000,504640000,2.5e+09,35,60,95
1304550000,785940000,125720000,246110000,37680000,2.5e+09,40,68,108
1314150000,706970000,103050000,201170000,174660000,2.5e+09,40,63,103
676160000,1400430000,172240000,143450000,107720000,2.5e+09,38,80,118
649820000,1578450000,153610000,83560000,34560000,2.5e+09,38,74,112
651960000,1302080000,238510000,162540000,144910000,2.5e+09,38,79,117
527080000,1567260000,185830000,116490000,103340000,2.5e+09,38,80,118
473400000,1678770000,152430000,118640000,76760000,2.5e+09,40,86,126
880820000,1193850000,155880000,156390000,113060000,2.5e+09,39,79,118
751610000,898040000,498560000,236310000,115480000,2.5e+09,41,89,130
891620000,1070270000,154550000,243370000,140190000,2.5e+09,43,85,128
587370000,1280350000,158790000,407640000,65850000,2.5e+09,40,83,123
603050000,1376070000,1.34e+08,310450000,76430000,2.5e+09,40,87,127
809680000,1008030000,85710000,540500000,56080000,2.5e+09,41,86,127
810380000,1039120000,180690000,351980000,117830000,2.5e+09,42,91,133
530110000,1397160000,109200000,412640000,50890000,2.5e+09,42,90,132
712660000,1311530000,111300000,317630000,46880000,2.5e+09,37,82,119
651520000,1316130000,74530000,1.48e+08,309820000,2.5e+09,45,85,130
1238950000,484970000,38940000,631480000,105660000,2.5e+09,39,80,119
708530000,1247490000,61130000,180350000,302500000,2.5e+09,42,83,125
647510000,1193230000,74680000,475110000,109470000,2.5e+09,43,90,133
203250000,730630000,18140000,74530000,60340000,1086890000,43,83,126
7210000,2710000,1740000,8320000,5220000,25200000,40,77,117
391240000,646550000,16760000,61970000,37980000,1154500000,44,84,128
643020000,1114020000,158920000,145320000,438720000,2.5e+09,47,85,132
238140000,514770000,26100000,230950000,539780000,1549740000,50,95,145
802660000,1121160000,42360000,385350000,148470000,2.5e+09,38,81,119
735830000,1103740000,64790000,317190000,172280000,2393830000,47,92,139
878240000,1160570000,177120000,152680000,131390000,2.5e+09,41,79,120
199360000,1629880000,141040000,343070000,186650000,2.5e+09,42,85,127
223810000,1477550000,153660000,163820000,95370000,2114210000,42,94,136
388970000,1476740000,226760000,171780000,2.35e+08,2499250000,39,79,118
1462070000,647630000,75790000,297120000,17390000,2.5e+09,39,59,98
1214160000,970480000,162780000,105650000,46930000,2.5e+09,38,64,102
1417520000,678970000,119950000,247700000,35860000,2.5e+09,37,62,99
1374430000,821770000,129340000,72570000,101890000,2.5e+09,42,74,116
1068180000,1006460000,125110000,225560000,74690000,2.5e+09,40,87,127
546090000,1224580000,165820000,155430000,72590000,2164510000,40,77,117
592190000,740650000,53460000,139390000,28120000,1553810000,48,90,138
8880000,4010000,350000,1730000,0,14970000,40,87,127
375130000,1645800000,208370000,214250000,56450000,2.5e+09,42,86,128
803370000,1402850000,103820000,164100000,25860000,2.5e+09,38,91,129
505270000,1076980000,77330000,324680000,93270000,2077530000,45,94,139
345530000,1724790000,128110000,275510000,26060000,2.5e+09,42,85,127
585330000,1355920000,123450000,381070000,42590000,2488360000,40,85,125
608010000,1247960000,115180000,444270000,84580000,2.5e+09,41,90,131
298390000,464960000,36670000,189010000,42590000,1031620000,43,97,140
541530000,5.44e+08,35540000,197740000,57650000,1376460000,46,96,142
560030000,1242090000,176850000,435170000,85860000,2.5e+09,45,88,133
709920000,1296550000,85090000,352960000,55480000,2.5e+09,39,86,125
1157810000,574240000,46910000,408670000,137140000,2324770000,46,90,136
593800000,322580000,43240000,145370000,52810000,1157800000,49,91,140
873410000,1238350000,65120000,186390000,136730000,2.5e+09,40,84,124
658350000,905420000,5.7e+07,580580000,298650000,2.5e+09,47,93,140
1023170000,374530000,28650000,121250000,104710000,1652310000,49,94,143
568870000,753070000,39480000,203210000,51250000,1615880000,48,89,137
251160000,1492180000,68190000,51300000,50190000,1913020000,39,74,113
363840000,1621920000,31610000,159160000,90880000,2267410000,46,80,126
823620000,1145720000,214990000,89460000,226210000,2.5e+09,44,92,136
440330000,1436800000,78320000,290530000,254020000,2.5e+09,45,90,135
689920000,1299650000,56050000,185250000,269130000,2.5e+09,41,87,128
516830000,1649090000,80180000,73220000,180680000,2.5e+09,38,61,99
563580000,1668420000,78730000,47710000,141560000,2.5e+09,39,65,104
0,3340000,0,3190000,0,6530000,38,80,118
137890000,1045790000,94090000,241200000,122700000,1641670000,41,82,123
413650000,468410000,67470000,187300000,31720000,1168550000,38,78,116
910690000,148210000,22250000,178460000,44330000,1303940000,35,62,97
693720000,45260000,7150000,85440000,10420000,841990000,33,61,94
372200000,159130000,45050000,181120000,32920000,790420000,30,62,92
430520000,46040000,106600000,1210000,1915630000,2.5e+09,35,82,117
951810000,220530000,42320000,11790000,1273550000,2.5e+09,40,90,130
1326570000,436960000,97360000,22550000,616560000,2.5e+09,43,91,134
1912370000,27410000,2470000,980000,556770000,2.5e+09,24,62,86
1858960000,167190000,16030000,1390000,456430000,2.5e+09,39,86,125
545960000,40200000,9740000,650000,1688770000,2285320000,38,73,111
1036900000,117210000,66800000,2940000,1276150000,2.5e+09,41,89,130
745040000,909340000,64140000,239110000,542370000,2.5e+09,48,90,138
738820000,1189310000,57170000,144950000,369750000,2.5e+09,43,90,133
833890000,979740000,43510000,115410000,527450000,2.5e+09,42,80,122
702810000,1424340000,83870000,134100000,154880000,2.5e+09,37,74,111
592630000,359420000,11620000,127360000,1408970000,2.5e+09,46,86,132
1006910000,653540000,39080000,147950000,652520000,2.5e+09,41,82,123
155900000,30440000,3230000,35840000,2274590000,2.5e+09,36,84,120
875470000,378680000,81800000,1420000,1162630000,2.5e+09,43,93,136
905530000,309990000,68690000,0,1215790000,2.5e+09,42,101,143
880820000,400040000,25480000,1630000,1192030000,2.5e+09,47,97,144
1288530000,777730000,75540000,0,358200000,2.5e+09,42,98,140
1.209e+09,924720000,183170000,9e+05,182210000,2.5e+09,44,96,140
1150070000,143100000,12210000,1140000,1193480000,2.5e+09,48,107,155
666400000,204610000,94800000,1720000,1532470000,2.5e+09,48,105,153
1604130000,425830000,19840000,0,450200000,2.5e+09,39,91,130
1780020000,388620000,24630000,0,306730000,2.5e+09,42,94,136
1.15e+09,382800000,76360000,0,890840000,2.5e+09,44,104,148
1266550000,433050000,43940000,0,756460000,2.5e+09,45,108,153
1243760000,933410000,94670000,0,228160000,2.5e+09,38,89,127
1406270000,650310000,34670000,0,408750000,2.5e+09,36,93,129
516080000,66810000,31660000,0,1885450000,2.5e+09,44,100,144
438540000,119520000,46920000,460000,1762160000,2367600000,46,102,148
1284010000,540650000,34490000,0,640850000,2.5e+09,46,104,150
667290000,1286900000,51370000,120350000,374090000,2.5e+09,43,80,123
662970000,1439590000,84540000,52470000,260430000,2.5e+09,37,74,111
604440000,1437550000,95400000,95600000,267010000,2.5e+09,40,80,120
689090000,770490000,38070000,169140000,833210000,2.5e+09,46,93,139
370270000,152270000,188100000,78060000,1673610000,2462310000,42,88,130
423320000,214200000,7130000,154670000,1641010000,2440330000,35,91,126
657460000,279850000,10430000,94190000,1458070000,2.5e+09,50,105,155
31430000,35150000,6650000,17930000,2135360000,2226520000,40,86,126
64480000,8080000,0,6800000,2072240000,2151600000,33,70,103
370980000,114900000,14080000,155010000,1845030000,2.5e+09,42,99,141
801290000,214780000,52900000,160820000,1270210000,2.5e+09,48,90,138
1146920000,498970000,16860000,342540000,494710000,2.5e+09,48,95,143
1460660000,563630000,71620000,0,404090000,2.5e+09,45,95,140
282510000,18020000,12410000,0,1919480000,2232420000,43,91,134
1330350000,894060000,37550000,0,238040000,2.5e+09,41,87,128
1146090000,1117030000,52530000,460000,183890000,2.5e+09,39,85,124
1.884e+09,157230000,13800000,0,444970000,2.5e+09,42,86,128
1270770000,460380000,198290000,0,570560000,2.5e+09,45,95,140
1623060000,491990000,35620000,0,349330000,2.5e+09,40,91,131
1687920000,358880000,19670000,920000,432610000,2.5e+09,38,90,128
1554350000,423850000,63870000,460000,457470000,2.5e+09,45,100,145
1525520000,438230000,25760000,0,510490000,2.5e+09,39,92,131
1668680000,18300000,11870000,2140000,799010000,2.5e+09,25,73,98
1661370000,19200000,1320000,840000,817270000,2.5e+09,22,59,81
1251250000,7370000,1670000,730000,1238980000,2.5e+09,20,63,83
794870000,0,0,2100000,1703030000,2.5e+09,9,46,55
1203470000,146900000,11320000,0,1138310000,2.5e+09,22,63,85
404730000,14670000,720000,6050000,2073830000,2.5e+09,14,43,57
370090000,21930000,1240000,29340000,2077400000,2.5e+09,19,66,85
159380000,0,0,35760000,2304860000,2.5e+09,15,48,63
479480000,62940000,23570000,250000,1933760000,2.5e+09,23,70,93
127090000,13430000,2520000,0,2356960000,2.5e+09,9,46,55
3.87e+08,65830000,5540000,0,2041630000,2.5e+09,11,43,54
1765060000,11530000,3370000,1060000,718980000,2.5e+09,25,66,91
1855410000,53050000,6130000,320000,585090000,2.5e+09,22,65,87
1909370000,199790000,31890000,3390000,355560000,2.5e+09,33,77,110
1948770000,163250000,5480000,1060000,381440000,2.5e+09,37,79,116
1581060000,6090000,9620000,6820000,896410000,2.5e+09,22,73,95
1710280000,20060000,4720000,12440000,752500000,2.5e+09,28,77,105
1919420000,30270000,5370000,3110000,541830000,2.5e+09,22,56,78
1644780000,470000,1350000,1370000,852030000,2.5e+09,14,44,58
1688960000,5100000,7300000,2850000,795790000,2.5e+09,21,69,90
1758530000,0,770000,2030000,738670000,2.5e+09,20,59,79
1691520000,1720000,11660000,260000,794840000,2.5e+09,20,58,78
745830000,0,2800000,5310000,1746060000,2.5e+09,13,47,60
1302990000,1120000,3490000,5440000,1186960000,2.5e+09,17,57,74
1476140000,820000,1690000,2640000,1018710000,2.5e+09,14,39,53
465920000,0,0,38100000,1995980000,2.5e+09,17,63,80
835890000,7250000,2120000,0,1654740000,2.5e+09,13,42,55
1137950000,1930000,0,0,1360120000,2.5e+09,14,53,67
459920000,1930000,0,0,2038150000,2.5e+09,15,46,61
496670000,55660000,22360000,4e+05,1696420000,2271510000,34,76,110
470950000,58840000,2e+06,320000,1562790000,2094900000,38,77,115
491290000,24270000,40520000,3270000,1940650000,2.5e+09,37,85,122
1672710000,63460000,12260000,16550000,735020000,2.5e+09,25,77,102
1604750000,2380000,3320000,6640000,882910000,2.5e+09,17,47,64
1302700000,8600000,6080000,4090000,1178530000,2.5e+09,18,55,73
1584420000,5850000,1910000,0,907820000,2.5e+09,28,80,108
1765180000,1310000,11490000,2950000,719070000,2.5e+09,30,76,106
621650000,0,0,0,1878350000,2.5e+09,17,55,72
495850000,160930000,25670000,1280000,1619350000,2303080000,45,100,145
1622430000,59050000,12710000,19920000,785890000,2.5e+09,29,83,112
1763610000,13040000,13090000,770000,709490000,2.5e+09,29,79,108
1713870000,14540000,7210000,12670000,751710000,2.5e+09,26,85,111
1377820000,353250000,35020000,226190000,507720000,2.5e+09,35,65,100
214810000,573480000,52500000,69630000,1589580000,2.5e+09,33,71,104
1866070000,281230000,25310000,121220000,206170000,2.5e+09,30,68,98
797410000,1158150000,75450000,224170000,244820000,2.5e+09,33,65,98
1394870000,555150000,49570000,275030000,225380000,2.5e+09,30,74,104
944680000,669720000,101140000,680240000,104220000,2.5e+09,33,72,105
1383720000,440390000,38510000,101570000,535810000,2.5e+09,34,64,98
100590000,650500000,34620000,30380000,1582890000,2398980000,43,77,120
940180000,804260000,42030000,116540000,596990000,2.5e+09,34,73,107
198580000,696010000,26490000,40900000,1516570000,2478550000,38,68,106
1612470000,400360000,40430000,131620000,315120000,2.5e+09,31,74,105
678790000,1089260000,91550000,297200000,343200000,2.5e+09,39,83,122
1155960000,728540000,84630000,292750000,238120000,2.5e+09,41,83,124
1422230000,652280000,118130000,120810000,186550000,2.5e+09,35,76,111
1441570000,395720000,117480000,406220000,139010000,2.5e+09,30,58,88
636740000,1113610000,197280000,479580000,72790000,2.5e+09,37,73,110
1375380000,469430000,77380000,358980000,218830000,2.5e+09,34,62,96
899420000,775240000,78770000,597250000,149320000,2.5e+09,40,74,114
1414400000,107660000,42100000,619570000,229350000,2413080000,21,48,69
1444860000,122330000,58900000,527260000,241680000,2395030000,22,43,65
1561920000,237240000,33040000,359280000,308520000,2.5e+09,21,47,68
1055950000,880360000,21210000,106080000,436400000,2.5e+09,36,73,109
394200000,1033970000,47890000,94340000,929600000,2.5e+09,46,95,141
1.11e+08,2009410000,63640000,139890000,176060000,2.5e+09,27,55,82
538350000,1328860000,61710000,245310000,325770000,2.5e+09,41,84,125
334210000,1629120000,95200000,257710000,183760000,2.5e+09,35,77,112
159540000,1800420000,65130000,268900000,206010000,2.5e+09,35,70,105
929140000,1102540000,107410000,147510000,213400000,2.5e+09,36,65,101
1100730000,909450000,104700000,153990000,231130000,2.5e+09,39,84,123
869390000,1218840000,133940000,127760000,150070000,2.5e+09,38,71,109
659460000,1426690000,105340000,200460000,108050000,2.5e+09,39,90,129
229460000,1846010000,170640000,104310000,149580000,2.5e+09,43,81,124
460740000,1604110000,124170000,140250000,170730000,2.5e+09,42,79,121
313830000,1827980000,119950000,86790000,151450000,2.5e+09,44,91,135
508950000,1664570000,133730000,106900000,85850000,2.5e+09,30,63,93
243800000,1511030000,517980000,101790000,125400000,2.5e+09,33,71,104
1072620000,880830000,117790000,331750000,97010000,2.5e+09,32,63,95
1557890000,354920000,112020000,401960000,73210000,2.5e+09,22,49,71
1834750000,181550000,47670000,336150000,99880000,2.5e+09,20,51,71
1639740000,267750000,66740000,317640000,208130000,2.5e+09,22,51,73
1679170000,279360000,99820000,298220000,143430000,2.5e+09,24,53,77
493480000,1374900000,219790000,356460000,55370000,2.5e+09,33,66,99
1221370000,871020000,49250000,134090000,224270000,2.5e+09,44,95,139
653550000,130190000,22760000,22980000,1452920000,2282400000,45,92,137
749980000,1323080000,122910000,156660000,147370000,2.5e+09,36,73,109
460640000,1384670000,127620000,2.49e+08,278070000,2.5e+09,50,106,156
466270000,632970000,117910000,49130000,1233720000,2.5e+09,43,91,134
295230000,209590000,34390000,38370000,1673040000,2250620000,49,88,137
446440000,1609410000,146990000,109040000,188120000,2.5e+09,48,99,147
394760000,1777070000,128390000,110860000,88920000,2.5e+09,32,54,86
213140000,1939640000,156470000,71360000,119390000,2.5e+09,37,72,109
39730000,2014370000,103040000,299140000,43720000,2.5e+09,35,59,94
177350000,1416020000,81780000,222800000,35020000,1932970000,38,85,123
560420000,1453190000,162730000,270690000,52970000,2.5e+09,25,50,75
340870000,1293820000,137880000,264880000,63560000,2101010000,36,70,106
108510000,958340000,88240000,287240000,51260000,1493590000,38,80,118
417450000,1310970000,230650000,390300000,111810000,2461180000,38,81,119
159560000,362480000,66900000,61800000,43470000,694210000,37,71,108
31320000,1023590000,64040000,86690000,1283230000,2488870000,43,88,131
568380000,1339700000,98010000,273270000,220640000,2.5e+09,40,86,126
58730000,299180000,25670000,61220000,2055200000,2.5e+09,41,83,124
206100000,401590000,45290000,50500000,165340000,868820000,43,95,138
104880000,375250000,17700000,63240000,968030000,1529100000,45,92,137
739740000,1190160000,127640000,173580000,268880000,2.5e+09,44,90,134
1078540000,949170000,60550000,160100000,251640000,2.5e+09,43,82,125
832530000,980940000,232550000,253990000,199990000,2.5e+09,46,85,131
1123630000,687430000,35200000,208040000,170580000,2224880000,47,90,137
719440000,1502280000,90490000,82350000,105440000,2.5e+09,39,75,114
725650000,1433330000,73450000,8.3e+07,184570000,2.5e+09,36,71,107
744620000,1340850000,58660000,174900000,180970000,2.5e+09,41,77,118
584740000,1473800000,61590000,190660000,189210000,2.5e+09,42,73,115
271700000,120000,340000,71290000,53190000,396640000,26,57,83
235390000,38590000,17790000,23810000,22740000,338320000,25,57,82
15930000,55070000,3360000,21080000,560000,9.6e+07,40,76,116
715160000,90110000,7630000,37750000,137980000,988630000,44,92,136
720190000,310710000,40380000,89480000,158380000,1319140000,42,93,135
789570000,1111460000,40810000,289020000,269140000,2.5e+09,44,93,137
1162320000,709390000,60500000,240260000,327530000,2.5e+09,47,100,147
702580000,527090000,69230000,249240000,360670000,1908810000,47,100,147
270090000,634400000,21790000,128950000,176910000,1232140000,49,101,150
139510000,1331990000,160110000,423330000,44240000,2099180000,37,75,112
229830000,226530000,11410000,98320000,96760000,662850000,49,101,150
11950000,222140000,19080000,49660000,36790000,339620000,33,69,102
935590000,1014360000,49770000,194670000,305610000,2.5e+09,39,80,119
338580000,1984890000,73650000,28840000,74040000,2.5e+09,41,68,109
1133590000,563940000,36060000,224420000,541990000,2.5e+09,44,82,126
7.76e+08,1330400000,41020000,136180000,216400000,2.5e+09,44,81,125
742130000,245580000,341820000,140920000,1029550000,2.5e+09,44,90,134
963090000,790170000,19180000,126520000,601040000,2.5e+09,43,85,128
1092250000,614420000,40010000,243020000,510300000,2.5e+09,42,80,122
1183430000,431710000,42780000,103920000,738160000,2.5e+09,46,99,145
1144310000,602020000,16850000,105700000,631120000,2.5e+09,48,92,140
893500000,478570000,229300000,416150000,482480000,2.5e+09,44,93,137
1322890000,579590000,30230000,223680000,343610000,2.5e+09,41,78,119
908280000,335860000,447570000,1310000,806980000,2.5e+09,48,102,150
1461880000,497040000,7.7e+07,0,464080000,2.5e+09,43,93,136
1461930000,697120000,122470000,720000,217760000,2.5e+09,44,93,137
1823920000,142940000,24870000,0,508270000,2.5e+09,40,91,131
1507040000,335700000,25510000,0,631750000,2.5e+09,40,91,131
1889930000,169140000,9870000,0,431060000,2.5e+09,40,88,128
2034880000,56180000,12700000,0,396240000,2.5e+09,39,88,127
1565040000,412400000,22020000,0,500540000,2.5e+09,39,90,129
1699900000,175090000,6700000,0,618310000,2.5e+09,36,88,124
981600000,636350000,35230000,280140000,566680000,2.5e+09,43,80,123
681660000,841260000,12800000,285430000,678850000,2.5e+09,47,101,148
1145060000,675030000,34230000,187880000,457800000,2.5e+09,43,79,122
1022710000,450400000,11300000,444090000,571500000,2.5e+09,43,80,123
1265020000,5.69e+08,12090000,280260000,373630000,2.5e+09,42,75,117
1156110000,612520000,25500000,306050000,399820000,2.5e+09,46,83,129
1061920000,816590000,34230000,106740000,480520000,2.5e+09,41,82,123
1125130000,776270000,33370000,124540000,440690000,2.5e+09,43,83,126
911680000,1025610000,71660000,124740000,366310000,2.5e+09,47,92,139
1076330000,1088370000,32490000,138640000,164170000,2.5e+09,40,83,123
1247620000,569800000,26740000,182480000,473360000,2.5e+09,45,88,133
1147540000,877580000,36650000,156500000,281730000,2.5e+09,37,75,112
1036770000,764380000,46680000,184930000,467240000,2.5e+09,49,89,138
1308100000,721810000,29670000,134780000,305640000,2.5e+09,41,87,128
548300000,185780000,66040000,350000,1663320000,2463790000,46,100,146
206080000,29220000,5760000,15870000,1882340000,2139270000,43,87,130
145650000,7790000,9040000,0,2006560000,2169040000,38,83,121
1391380000,443480000,135420000,0,529720000,2.5e+09,41,87,128
1357030000,921630000,61410000,530000,159400000,2.5e+09,42,92,134
1599160000,242250000,54390000,0,604200000,2.5e+09,45,90,135
1356460000,740120000,96920000,0,306500000,2.5e+09,45,104,149
1663310000,158360000,47540000,0,630790000,2.5e+09,39,86,125
1355740000,182160000,12860000,0,949240000,2.5e+09,38,83,121
1753930000,81260000,9850000,0,654960000,2.5e+09,37,86,123
1689760000,76080000,9920000,0,724240000,2.5e+09,33,76,109
1698720000,102280000,13440000,0,685560000,2.5e+09,34,84,118
1731170000,208040000,117330000,0,443460000,2.5e+09,38,88,126
1472860000,135760000,4120000,0,887260000,2.5e+09,36,84,120
1626890000,151920000,10050000,0,711140000,2.5e+09,39,86,125
1802560000,399900000,12490000,370000,284680000,2.5e+09,38,90,128
1822590000,125780000,7620000,0,544010000,2.5e+09,39,88,127
1743440000,345240000,10720000,0,400600000,2.5e+09,36,86,122
1796250000,181150000,4520000,0,518080000,2.5e+09,33,85,118
651380000,903760000,35570000,508090000,401200000,2.5e+09,41,85,126
833790000,683140000,16450000,411750000,548120000,2493250000,39,83,122
349010000,169640000,4560000,177730000,211360000,912300000,45,103,148
9.04e+08,390140000,14630000,129120000,275350000,1713240000,39,74,113
936890000,626610000,16840000,295370000,509720000,2385430000,42,85,127
395750000,245880000,6590000,26540000,837480000,1512240000,43,91,134
852270000,684800000,37210000,82920000,306510000,1963710000,45,80,125
1010280000,250480000,53550000,1.21e+08,1064690000,2.5e+09,45,95,140
333560000,71540000,7040000,26180000,1167430000,1605750000,42,84,126
1752710000,199070000,14650000,0,533570000,2.5e+09,40,85,125
1557400000,311350000,60140000,0,560710000,2489600000,49,104,153
1009820000,286330000,105580000,0,835960000,2237690000,44,97,141
1718860000,166800000,11660000,0,602680000,2.5e+09,39,86,125
1678070000,93630000,37420000,0,690880000,2.5e+09,39,88,127
1320860000,148090000,12950000,0,1018100000,2.5e+09,38,81,119
1556160000,46090000,3970000,0,893780000,2.5e+09,37,74,111
1369210000,196190000,72240000,0,862360000,2.5e+09,39,84,123
1701140000,105370000,44750000,0,648740000,2.5e+09,38,90,128
1636050000,177150000,10330000,0,676470000,2.5e+09,39,80,119
1689820000,41470000,12300000,0,756410000,2.5e+09,32,74,106
1827920000,205730000,6310000,870000,459170000,2.5e+09,34,79,113
1582050000,397670000,24290000,0,495990000,2.5e+09,40,88,128
2056060000,86210000,2210000,0,355520000,2.5e+09,35,80,115
1906270000,116480000,12640000,0,464610000,2.5e+09,35,80,115
1393290000,111710000,23730000,0,971270000,2.5e+09,38,92,130
951240000,159340000,11290000,0,628750000,1750620000,41,94,135
1625560000,186390000,40770000,0,647280000,2.5e+09,39,99,138
1207080000,259010000,51540000,0,982370000,2.5e+09,38,98,136
2124260000,43090000,0,0,331580000,2498930000,35,79,114
1479670000,117750000,12640000,0,889940000,2.5e+09,37,85,122
861500000,151020000,36900000,3610000,1437450000,2490480000,52,105,157
1682100000,473130000,39890000,0,304880000,2.5e+09,44,96,140
280210000,9930000,41830000,2050000,2147600000,2481620000,44,95,139
1423930000,28460000,970000,70000,1046570000,2.5e+09,26,74,100
1637180000,209060000,54400000,12230000,587130000,2.5e+09,38,89,127
1338160000,625210000,41750000,11310000,483570000,2.5e+09,45,108,153
1745170000,318210000,12330000,0,424290000,2.5e+09,34,90,124
1465510000,149400000,9640000,0,875450000,2.5e+09,39,92,131
1626360000,146720000,5010000,0,721910000,2.5e+09,35,92,127
1274850000,57610000,6900000,0,1160640000,2.5e+09,38,97,135
1016530000,93600000,172750000,4010000,1213110000,2.5e+09,46,114,160
1339800000,32240000,270000,0,1127690000,2.5e+09,26,79,105
1632090000,39420000,2400000,0,826090000,2.5e+09,34,84,118
1627820000,15120000,53860000,0,803200000,2.5e+09,34,92,126
1568530000,73170000,2230000,310000,855760000,2.5e+09,33,81,114
1926960000,12480000,3280000,0,557280000,2.5e+09,29,82,111
1505280000,25800000,3030000,0,965890000,2.5e+09,26,74,100
1657770000,5890000,1480000,0,834860000,2.5e+09,23,72,95
1948690000,11220000,720000,0,539370000,2.5e+09,24,71,95
1543270000,20650000,10250000,0,925830000,2.5e+09,25,74,99
1728010000,6020000,0,0,765970000,2.5e+09,20,69,89
1560510000,1850000,0,0,937640000,2.5e+09,17,64,81
1514210000,10610000,14140000,0,961040000,2.5e+09,26,71,97
1.619e+09,0,0,0,8.81e+08,2.5e+09,21,57,78
1364050000,1300000,0,0,1134650000,2.5e+09,21,72,93
1677250000,770000,0,0,821980000,2.5e+09,10,43,53
1460080000,0,0,20000,1039900000,2.5e+09,19,59,78
1344920000,0,0,0,1155080000,2.5e+09,21,64,85
1867040000,290000,1380000,0,631290000,2.5e+09,24,70,94
417940000,13190000,4720000,0,2064150000,2.5e+09,24,70,94
1122940000,2490000,0,0,1374570000,2.5e+09,14,51,65
194710000,0,0,0,2305290000,2.5e+09,13,54,67
629530000,4070000,0,0,1866400000,2.5e+09,24,68,92
1170000,0,6e+05,0,2498230000,2.5e+09,10,42,52
181240000,8300000,1120000,0,2309340000,2.5e+09,13,45,58
1649640000,27300000,3170000,0,819890000,2.5e+09,31,81,112
1773910000,22110000,7030000,0,696950000,2.5e+09,33,78,111
1773280000,68320000,11230000,0,647170000,2.5e+09,37,86,123
1812220000,18560000,0,0,669220000,2.5e+09,25,87,112
1520250000,14560000,0,0,965190000,2.5e+09,28,77,105
1463120000,17120000,5070000,0,1014690000,2.5e+09,28,79,107
1758190000,19920000,11010000,0,710880000,2.5e+09,22,76,98
1851790000,15380000,1710000,0,631120000,2.5e+09,26,74,100
1748710000,19790000,0,0,731410000,2499910000,25,82,107
1560760000,9360000,0,0,929880000,2.5e+09,26,73,99
1692170000,16160000,7310000,0,784360000,2.5e+09,30,83,113
1720930000,5610000,1140000,0,772320000,2.5e+09,24,70,94
1768500000,320000,1820000,0,729360000,2.5e+09,25,71,96
1.18e+09,0,0,0,1.32e+09,2.5e+09,21,66,87
1719010000,0,0,0,775720000,2494730000,19,55,74
1258820000,0,0,0,1241180000,2.5e+09,23,72,95
1852610000,3380000,10250000,0,633760000,2.5e+09,32,80,112
737140000,33650000,2400000,0,1726810000,2.5e+09,20,67,87
4.42e+08,0,0,0,2.058e+09,2.5e+09,20,66,86
410590000,23670000,5050000,0,2060690000,2.5e+09,20,69,89
1111720000,3080000,960000,0,1384240000,2.5e+09,30,75,105
304470000,18440000,230000,0,2176860000,2.5e+09,12,49,61
86450000,7430000,2370000,0,2403750000,2.5e+09,13,58,71
1543740000,9130000,280000,0,756450000,2309600000,23,69,92
1746770000,22260000,6630000,0,718560000,2494220000,30,83,113
1430440000,8650000,0,0,477980000,1917070000,24,76,100
1033180000,4970000,0,0,624090000,1662240000,25,77,102
1483150000,51760000,18150000,0,618210000,2171270000,39,94,133
720540000,1382320000,249050000,88850000,59240000,2.5e+09,39,68,107
1863370000,31950000,7380000,0,597300000,2.5e+09,41,93,134
1911620000,92500000,6460000,0,394790000,2405370000,41,96,137
1585430000,21980000,10070000,0,435780000,2053260000,39,86,125
3700000,706980000,98280000,32150000,1503430000,2344540000,29,74,103
887140000,565650000,62850000,340930000,643430000,2.5e+09,45,87,132
0,6450000,280000,0,2238680000,2245410000,14,54,68
4312360000,1993210000,213550000,1.624e+09,5767880000,1.3911e+10,41,79,120
1697830000,6403860000,3116060000,1423790000,520350000,13161890000,50,106,156
2686630000,3932160000,209880000,590970000,1666880000,9086520000,49,95,144
3646450000,3282760000,152110000,409310000,1755530000,9246160000,49,101,150
3146380000,64320000,18150000,0,1199430000,4428280000,39,94,133
867480000,626700000,181110000,0,2721050000,4396340000,39,86,125
3297160000,242960000,104740000,0,3499920000,7144780000,37,80,117
8997780000,2351860000,227110000,1740000,6298810000,17877300000,51,114,165
4903270000,7422700000,1286140000,1287980000,228220000,15128310000,45,85,130
817150000,6459620000,323170000,391340000,2308430000,10299710000,37,57,94
4873150000,8196480000,260080000,1974180000,2443480000,17747370000,46,86,132
6632270000,4843990000,1886440000,1405480000,350200000,15118380000,49,89,138
3696420000,2402220000,1051100000,2127670000,171130000,9448540000,41,74,115
7091490000,3078120000,243400000,807270000,5156950000,16377230000,53,106,159
10845840000,122530000,32340000,14780000,6735960000,17751450000,31,84,115
3519230000,5329920000,398900000,1.015e+09,199600000,10462650000,42,88,130
3762060000,5104330000,377440000,780790000,698570000,10723190000,45,86,131
1256520000,3501020000,1166300000,226050000,5622010000,11771900000,42,95,137
769040000,8112780000,701360000,1855100000,1712320000,13150600000,42,93,135
1551320000,6296850000,625200000,2268140000,163490000,1.0905e+10,44,90,134
3127740000,3457720000,259950000,1909230000,331770000,9086410000,48,97,145
5211540000,4667330000,199140000,2426640000,8460990000,20965640000,51,88,139
1089480000,2661100000,603330000,6972310000,3211940000,14538160000,33,79,112
542600000,4412710000,565980000,460490000,7584060000,13565840000,38,75,113
4935710000,1111780000,922930000,2623190000,487760000,10081370000,41,75,116
9721500000,1573370000,278910000,27740000,2517790000,14119310000,42,93,135
1865760000,1300710000,328350000,3347220000,7737470000,14579510000,32,90,122
4347960000,8156960000,881430000,338740000,4180120000,17905210000,38,89,127
1615540000,2369970000,298370000,1599580000,188660000,6072120000,39,81,120
8724580000,158670000,23240000,45440000,5166490000,14118420000,37,82,119
6794030000,41120000,25420000,0,4273420000,11133990000,30,88,118
1907130000,2479750000,960640000,422160000,6077770000,11847450000,51,108,159
4944050000,3723140000,292450000,873280000,513990000,10346910000,46,90,136
3800370000,4339190000,656590000,433730000,1211480000,10441360000,44,82,126
4433530000,3052620000,187080000,677140000,716080000,9066450000,47,98,145
2722320000,6829560000,837340000,311470000,241600000,10942290000,50,104,154
1622720000,5565190000,1467750000,1.285e+09,140890000,10081550000,42,86,128
852510000,2737780000,131600000,1482900000,20600000,5225390000,36,69,105
2357320000,6998730000,1052930000,2775120000,2049290000,15233390000,42,92,134
6641200000,2488720000,637060000,1170550000,734420000,11671950000,46,85,131
836630000,827860000,254960000,5610070000,6952620000,14482140000,37,94,131
607750000,6054590000,371150000,287020000,3437240000,10757750000,53,95,148
6050240000,2859830000,317880000,725970000,378560000,10332480000,48,97,145
3585950000,27750000,28240000,3070000,1535330000,5180340000,32,75,107
3063390000,3252040000,411150000,64560000,4267700000,11058840000,36,78,114
1654230000,354360000,25810000,3330000,8049190000,10086920000,32,82,114
5661440000,3942950000,791750000,2045210000,1007250000,13448600000,45,91,136
2712890000,5575520000,514560000,1647880000,261840000,10712690000,46,94,140
2244790000,5608340000,349860000,464620000,303550000,8971160000,43,90,133
5260520000,491090000,111260000,12550000,4660780000,10536200000,41,94,135
7536260000,159700000,73370000,15610000,2582610000,10367550000,38,88,126
1732230000,3140020000,598550000,5437740000,6045780000,16954320000,35,89,124
4866410000,3983560000,1300540000,3932340000,1028310000,15111160000,46,88,134
3249880000,4970440000,228100000,588710000,1208160000,10245290000,49,91,140
3003170000,30220000,28910000,1180000,2056660000,5120140000,30,80,110
2643860000,1449690000,303270000,1246050000,138290000,5781160000,42,84,126
2019870000,4788140000,333610000,34040000,1775150000,8950810000,43,78,121
550480000,349480000,314480000,4608680000,7022190000,12845310000,32,79,111
437980000,5963670000,149990000,1740400000,1209410000,9501450000,48,90,138
8101960000,1262710000,85160000,920000,1881720000,11332470000,44,100,144
1712730000,1517110000,200240000,381340000,1.36e+08,3947420000,45,94,139
256620000,3165150000,230480000,162510000,1680070000,5494830000,46,93,139
574660000,58340000,19170000,105890000,87450000,845510000,29,61,90
1372540000,6511690000,6.18e+08,1678760000,2154820000,12335810000,44,95,139
4768160000,4468440000,598540000,1650930000,2723230000,14209300000,54,103,157
2430610000,4889140000,658200000,681610000,421850000,9081410000,47,89,136
5695960000,2098330000,164710000,1880500000,3886510000,13726010000,42,83,125
4163420000,1525370000,104300000,1477270000,5666110000,12936470000,38,78,116
668560000,2243170000,671050000,6132350000,3186700000,12901830000,29,68,97
168410000,1922800000,379460000,401580000,6132700000,9004950000,46,86,132
1769430000,10460000,44370000,2318370000,10982100000,15124730000,28,75,103
7570610000,4717250000,219220000,926630000,7306240000,20739950000,54,108,162
950520000,3067300000,31040000,505610000,856330000,5410800000,35,73,108
1989680000,5660450000,549070000,1729710000,3786660000,13715570000,48,96,144
2140350000,2439550000,432670000,2790180000,133810000,7936560000,41,90,131
7735500000,1281790000,311020000,0,2511380000,11839690000,45,101,146
7222350000,3118550000,328420000,0,5472340000,16141660000,49,117,166
2680740000,519330000,56420000,1350000,1751360000,5009200000,37,93,130
3432740000,3302740000,66450000,1339590000,2610490000,10752010000,37,73,110
4332420000,2335070000,567360000,2493780000,219300000,9947930000,37,69,106
3769930000,5256240000,227390000,2631630000,2610330000,14495520000,46,86,132
1005610000,8000820000,706680000,2366420000,717900000,12797430000,45,103,148
5619930000,394590000,117260000,1060000,2662890000,8795730000,37,87,124
6152210000,3156180000,375960000,110200000,4222990000,14017540000,45,98,143
626300000,6644910000,410340000,501630000,298750000,8481930000,51,104,155
1169330000,1242460000,295490000,10690130000,3250910000,16648320000,24,59,83
5769990000,3039240000,266790000,5369550000,1235240000,15680810000,40,88,128
3056400000,2781260000,244070000,483620000,3704530000,10269880000,56,116,172
3729740000,2843990000,417620000,2149600000,1586350000,10727300000,45,92,137
1102200000,2814140000,867550000,4637630000,1.402e+09,10823520000,35,84,119
6089710000,2190370000,733160000,981940000,342170000,10337350000,42,77,119
3345110000,4972560000,623180000,930150000,470920000,10341920000,46,91,137
5409030000,179940000,409920000,3628560000,3182960000,12810410000,41,76,117
2548110000,1948290000,319420000,188550000,3806950000,8811320000,55,93,148
1016950000,4683260000,877930000,3165580000,471890000,10215610000,50,112,162
12036610000,521610000,81510000,13450000,5780390000,18433570000,42,95,137
4498220000,2606480000,393680000,2530000,3252340000,10753250000,52,115,167
1804820000,994880000,104810000,597370000,193690000,3695570000,51,93,144
917540000,2247450000,105780000,242710000,396840000,3910320000,50,87,137
888270000,1110530000,80600000,425770000,102220000,2607390000,48,99,147
2879030000,2213330000,146360000,1251810000,2822400000,9312930000,44,79,123
3857960000,2943600000,121840000,1286640000,3017610000,11227650000,47,102,149
7910560000,46490000,15760000,370420000,10591440000,18934670000,29,77,106
208980000,301740000,34870000,988470000,5979530000,7513590000,23,60,83
3678950000,4250910000,650330000,1431120000,64570000,10075880000,44,86,130
6608350000,4698370000,1167700000,2380980000,285480000,15140880000,44,92,136
3252340000,6036140000,455360000,705190000,4105650000,14554680000,58,109,167
2717420000,4912820000,157060000,382090000,731560000,8900950000,34,67,101
1163270000,8565090000,601840000,209670000,6053960000,16593830000,41,95,136
3513960000,4426940000,2086480000,739020000,704940000,11471340000,47,96,143
10312240000,1055500000,209840000,0,6064570000,17642150000,46,106,152
3412010000,5218390000,645160000,750490000,315790000,10341840000,43,89,132
315300000,2843660000,559500000,1630170000,62170000,5410800000,32,73,105
4577180000,4573090000,638360000,753280000,166240000,10708150000,43,77,120
6128430000,2997180000,227650000,1390590000,2020250000,12764100000,46,88,134
3108200000,471830000,17170000,0,6682500000,10279700000,33,86,119
3404740000,3012730000,153620000,640750000,770830000,7982670000,49,105,154
2568510000,2803210000,481150000,560010000,3333980000,9746860000,47,91,138
4217200000,695040000,25920000,7e+05,13974160000,18913020000,34,90,124
101060000,1664570000,197230000,407250000,3007620000,5377730000,37,81,118
6770050000,3739620000,347480000,1180000,1471500000,12329830000,46,100,146
1189190000,63230000,38240000,0,2276200000,3566860000,31,82,113
3521010000,7916230000,385980000,652810000,896870000,13372900000,47,88,135
2270760000,861780000,461660000,2334690000,2861910000,8790800000,43,84,127
1916500000,4715900000,476870000,384640000,1672760000,9166670000,45,97,142
5303970000,2382310000,587130000,852080000,1225180000,10350670000,40,74,114
1489480000,699700000,143830000,1887410000,13315210000,17535630000,37,97,134
1157240000,2550690000,1675870000,3730270000,5261100000,14375170000,52,114,166
3671170000,5675180000,335340000,1526270000,3144930000,14352890000,51,107,158
4059560000,6979590000,382710000,574700000,1182970000,13179530000,44,84,128
200280000,1608600000,177540000,1054860000,6255810000,9297090000,27,69,96
3053670000,4927680000,1051620000,920850000,738820000,10692640000,46,92,138
3744630000,4326750000,367020000,1515660000,388300000,10342360000,54,99,153
1754040000,7355190000,804730000,347170000,201610000,10462740000,45,79,124
2874130000,5037410000,145100000,410540000,1348380000,9815560000,41,76,117
91580000,3377420000,415350000,192010000,2150920000,6227280000,32,77,109
818340000,4168200000,533200000,1201620000,214070000,6935430000,40,87,127
5841950000,1611350000,139730000,18050000,3171120000,10782200000,53,114,167
1238140000,8870300000,211350000,138570000,2456660000,12915020000,46,87,133
1325500000,373400000,800040000,2813490000,5530530000,10842960000,31,85,116
1575010000,4801150000,641240000,1084970000,295350000,8397720000,40,85,125
1899420000,145260000,17320000,27820000,6831590000,8921410000,22,76,98
2393210000,6197180000,815310000,937160000,365360000,10708220000,44,93,137
1856210000,4997200000,255330000,919010000,173710000,8201460000,46,87,133
7333210000,920200000,119360000,0,2731210000,11103980000,44,94,138
7235450000,2524770000,601560000,2069140000,491460000,12922380000,37,70,107
3799150000,3180080000,143430000,515680000,316930000,7955270000,37,75,112
1509390000,2981890000,258300000,310420000,415930000,5475930000,43,86,129
3726040000,12560000,2120000,219470000,14582010000,18542200000,22,71,93
2041540000,6252730000,147730000,947380000,7166320000,16555700000,38,76,114
2.254e+09,480950000,86110000,3690000,2210170000,5034920000,39,86,125
3765510000,5786630000,490570000,978910000,2913690000,13935310000,54,99,153
6255400000,5730970000,796870000,1005860000,298980000,14088080000,47,94,141
2467030000,508660000,16310000,3e+05,5808340000,8800640000,35,93,128
351060000,2831830000,1785290000,2002140000,3171660000,10141980000,54,115,169
6692390000,1186790000,162280000,26680000,2987520000,11055660000,41,90,131
542640000,7970690000,855140000,524470000,785130000,10678070000,45,94,139
2411090000,1826890000,127910000,544480000,696010000,5606380000,52,107,159
2474150000,2250250000,73010000,1365600000,1523880000,7686890000,49,109,158
3250520000,3452090000,425230000,740840000,808660000,8677340000,51,100,151
3237400000,1145750000,854610000,44130000,3408840000,8690730000,46,83,129
2099380000,1416910000,126760000,679540000,4359240000,8681830000,38,93,131
2806880000,5580270000,480090000,1570010000,245810000,10683060000,43,82,125
2985870000,5777610000,301670000,789160000,868510000,10722820000,44,96,140
3022490000,258070000,114070000,1221280000,501780000,5117690000,24,49,73
2442340000,6025530000,620040000,583300000,664930000,10336140000,45,99,144
7807530000,22440000,20800000,13420000,4472600000,12336790000,27,83,110
1485440000,210940000,48740000,3900000,3280770000,5029790000,27,70,97
1646760000,7674490000,714660000,1680330000,1090490000,12806730000,45,99,144
3118860000,2980520000,779190000,1830920000,1371530000,10081020000,46,87,133
1294930000,5658710000,449350000,889730000,4060190000,12352910000,48,109,157
460230000,4113390000,567750000,4139860000,7481550000,16762780000,41,93,134
7194590000,3e+05,2490000,163180000,9878250000,17238810000,25,70,95
1935540000,7027690000,228140000,1217200000,20305750000,30714320000,35,71,106
2079940000,3923910000,292480000,630750000,4.435e+09,11362080000,50,94,144
4176010000,480430000,43930000,51680000,9416260000,14168310000,27,80,107
4462530000,1252620000,1194840000,664040000,2502460000,10076490000,45,91,136
1855840000,2001580000,100890000,401300000,810650000,5170260000,36,77,113
2554330000,5226320000,120850000,228270000,2260530000,10390300000,57,96,153
2415840000,106370000,73490000,22390000,2767640000,5385730000,39,91,130
2756880000,8412700000,142050000,1661450000,8573820000,21546900000,43,79,122
9625840000,2096750000,318450000,137210000,3361440000,15539690000,44,94,138
4069820000,4855400000,942140000,884270000,3075460000,13827090000,49,93,142
3194270000,1560490000,97110000,462230000,7457010000,12771110000,50,103,153
356280000,579140000,114080000,162470000,2544180000,3756150000,38,81,119
1458380000,398350000,44910000,7090000,8024720000,9933450000,24,84,108
1964260000,5664040000,430420000,98980000,3328210000,11485910000,45,96,141
4243320000,3404430000,645560000,1512380000,541270000,10346960000,50,90,140
1490250000,3072350000,1.52e+08,258850000,246950000,5220400000,39,82,121
967980000,6122330000,473950000,708600000,429380000,8702240000,44,90,134
1719820000,7637720000,751160000,246930000,106530000,10462160000,42,84,126
1334280000,6456370000,484920000,85990000,699390000,9060950000,38,81,119
6152560000,2764280000,392860000,1600890000,10480650000,21391240000,56,113,169
9774220000,712970000,90750000,0,4161810000,14739750000,42,96,138
11495210000,382610000,130130000,48020000,5044460000,17100430000,39,100,139
1069840000,13712750000,1360450000,1.54e+08,565170000,16862210000,44,90,134
2796580000,2408570000,167930000,174240000,3171950000,8719270000,27,64,91
11671720000,443550000,67280000,16110000,3451890000,15650550000,38,85,123
1485840000,3183320000,292730000,261130000,257920000,5480940000,39,76,115
2391590000,983450000,666490000,253370000,4254010000,8548910000,37,87,124
2971220000,4.622e+09,712140000,851480000,451110000,9607950000,50,96,146
1083250000,3161550000,324340000,622660000,4144280000,9336080000,41,90,131
2455750000,4998360000,197810000,671110000,640790000,8963820000,49,89,138
320290000,427250000,64970000,1231670000,6330910000,8375090000,24,62,86
163470000,2703070000,1013100000,345460000,1000260000,5225360000,43,101,144
4615940000,3812120000,1122660000,1998840000,756850000,12306410000,52,110,162
4751120000,6720360000,1248510000,2235230000,448150000,15403370000,49,95,144
2854730000,9263100000,578540000,1163680000,342870000,14202920000,45,86,131
2184640000,3282700000,276020000,872740000,2983490000,9599590000,55,107,162
6709630000,3467130000,204190000,851790000,4292230000,15524970000,51,106,157
3320070000,3522890000,955790000,2121060000,156540000,10076350000,41,84,125
5834850000,1170530000,404240000,2059920000,862780000,10332320000,38,69,107
3234120000,8359510000,493240000,1670080000,440600000,14197550000,37,75,112
1305270000,5437760000,290550000,846940000,562680000,8443200000,42,98,140
982220000,4507840000,462350000,1501170000,1661830000,9115410000,53,92,145
2621040000,3653770000,394920000,156670000,1963800000,8790200000,35,74,109
2002210000,5298550000,77110000,805850000,3596930000,11780650000,39,83,122
3562390000,150680000,20810000,0,1435580000,5169460000,39,92,131
908250000,2802470000,19940000,634900000,1045240000,5410800000,31,67,98
1216280000,3117890000,212540000,530380000,68290000,5145380000,49,94,143
3228210000,4764020000,292730000,177480000,613800000,9076240000,36,71,107
447690000,6524110000,96710000,465590000,799450000,8333550000,34,77,111
3316470000,2501020000,379660000,3980390000,275210000,10452750000,37,83,120
9322710000,44170000,39060000,28220000,5187910000,14622070000,35,94,129
4900770000,2452070000,379580000,100680000,2664720000,10497820000,45,96,141
5572620000,4064660000,664690000,232380000,1970360000,12504710000,42,93,135
2971730000,4305800000,1036200000,1659310000,363730000,10336770000,44,89,133
144550000,4352670000,435150000,350670000,92660000,5375700000,31,75,106
2173530000,6997880000,395450000,1409300000,6308260000,17284420000,39,89,128
2284290000,6006210000,164840000,485500000,5718490000,14659330000,46,87,133
1257750000,377340000,103750000,1345420000,15071420000,18155680000,35,88,123
523610000,956630000,157140000,4101360000,7811340000,13550080000,25,59,84
4337150000,2945840000,236420000,613610000,686890000,8819910000,40,88,128
6867220000,1345970000,213910000,46670000,2694530000,11168300000,45,103,148
2063250000,5404500000,873300000,523380000,216970000,9081400000,41,84,125
3189480000,5215360000,599090000,282640000,794510000,10081080000,35,84,119
1864040000,482730000,89930000,14490000,5108410000,7559600000,26,85,111
1837420000,5194850000,258840000,2956610000,208660000,10456380000,44,89,133
2220180000,5843800000,1034670000,786540000,899560000,10784750000,46,99,145
2471510000,86620000,21240000,590000,6220540000,8800500000,23,66,89
583630000,46890000,6620000,270000,1862590000,2.5e+09,18,54,72
3561490000,47530000,10910000,20000,16562960000,20182910000,29,94,123
7751010000,661450000,109520000,0,3036410000,11558390000,45,105,150
767490000,6500620000,617120000,1925220000,997410000,10807860000,38,79,117
5174560000,3446890000,450390000,963680000,317090000,10352610000,50,92,142
683270000,2892950000,547220000,4070810000,6105740000,14299990000,33,84,117
2656180000,1830340000,247050000,308390000,464020000,5505980000,42,90,132
5249380000,339670000,70880000,51610000,3234370000,8945910000,39,82,121
1030240000,5989280000,889370000,1876240000,296610000,10081740000,43,94,137
3567640000,7204820000,866790000,814590000,213280000,12667120000,50,89,139
1052010000,4660450000,444540000,4273990000,64490000,10495480000,36,73,109
3908830000,4921920000,617410000,907750000,351750000,10707660000,44,98,142
685700000,1502530000,175310000,8914910000,2310630000,13589080000,26,57,83
2.395e+09,6772870000,872260000,194660000,227970000,10462760000,41,87,128
649360000,2916600000,687940000,4248570000,4049720000,12552190000,44,97,141
5216780000,6127080000,773010000,1354840000,952960000,14424670000,48,94,142
3873320000,1314520000,816070000,4533460000,3294980000,13832350000,46,92,138
5525610000,1316660000,169430000,2860000,3738660000,10753220000,52,112,164
5271890000,10005200000,771660000,1176650000,1057820000,18283220000,38,78,116
1710470000,4393540000,747950000,1556450000,4828480000,13236890000,53,99,152
2474940000,69370000,11160000,0,2453720000,5009190000,29,76,105
1820920000,2257250000,377480000,687040000,207990000,5350680000,39,81,120
963450000,5116290000,44280000,464290000,1232300000,7820610000,37,72,109
7727270000,1852150000,894560000,4314340000,2713600000,17501920000,45,77,122
4714620000,2289950000,799930000,20440000,8739920000,16564860000,50,112,162
4109150000,4381640000,249430000,1601920000,109250000,10451390000,35,78,113
6679410000,53370000,39130000,11210000,3589360000,10372480000,31,76,107
4626260000,2454140000,76020000,1098870000,1697810000,9953100000,48,92,140
2871540000,192450000,243650000,6880000,5289400000,8603920000,48,117,165
1178610000,354920000,136810000,11130000,3348460000,5029930000,31,81,112
3914730000,1504570000,797900000,130990000,7736650000,14084840000,41,82,123
2595260000,3280710000,433750000,254580000,4843430000,11407730000,28,64,92
1530740000,7646160000,444560000,687440000,403790000,10712690000,45,90,135
423330000,1751970000,119700000,131850000,3129230000,5556080000,48,82,130
3356890000,380830000,266490000,2033440000,4032550000,10070200000,37,70,107
1907060000,2336400000,168620000,533740000,224440000,5170260000,38,85,123
5619040000,5640680000,1031050000,2506070000,135450000,14932290000,45,89,134
8787530000,1386200000,58380000,1240000,2654540000,12887890000,42,101,143
879530000,6569590000,171820000,288260000,2418140000,10327340000,36,77,113
4554270000,3004960000,95710000,828240000,442290000,8925470000,38,79,117
3226880000,4471260000,384540000,132340000,8247080000,16462100000,30,62,92
3861230000,45980000,3640000,74250000,6392340000,10377440000,29,79,108
4568590000,3583180000,688770000,847090000,654870000,10342500000,45,91,136
6286440000,4196310000,760360000,1950860000,889350000,14083320000,49,80,129
1691240000,465550000,39300000,15330000,5340200000,7551620000,38,90,128
1268100000,5087150000,1817830000,2018600000,237910000,10429590000,44,103,147
4888030000,3376630000,171990000,1591410000,2879360000,12907420000,51,101,152
5.536e+09,1207590000,185250000,563430000,2840280000,10332550000,42,85,127
6807130000,1632540000,233570000,0,2410430000,11083670000,52,112,164
3828510000,3195390000,46340000,763500000,2743090000,10576830000,50,89,139
10793090000,3990000,13450000,0,5903060000,16713590000,33,90,123
534910000,1529700000,158890000,461560000,4734300000,7419360000,46,90,136
7834480000,284350000,45390000,22300000,2586760000,10773280000,36,89,125
892130000,1755180000,72360000,138510000,1021130000,3879310000,46,92,138
1378800000,1741740000,106010000,842620000,367270000,4436440000,50,100,150
2795270000,662060000,36430000,65680000,6502440000,10061880000,38,94,132
3517370000,4624280000,465910000,1123120000,621890000,10352570000,46,90,136
1890970000,5155880000,409950000,232080000,495580000,8184460000,48,92,140
3132530000,1149940000,226770000,1900000,4988320000,9499460000,48,103,151
2667230000,399080000,161740000,2183710000,3976440000,9388200000,36,71,107
2931400000,4876160000,420180000,1770890000,207110000,10205740000,45,89,134
1023040000,3051240000,312260000,634500000,172680000,5193720000,47,94,141
2191800000,272690000,36480000,30130000,11117220000,13648320000,27,86,113
6870730000,19520000,1140000,0,4229510000,11120900000,30,86,116
1596670000,3688560000,262270000,406820000,3142190000,9096510000,26,66,92
2125480000,6286340000,702750000,1.151e+09,185810000,10451380000,42,84,126
4137840000,5051870000,617710000,2187910000,319010000,12314340000,44,85,129
4063930000,1136880000,120110000,4.3e+07,3269450000,8633370000,41,90,131
419900000,5084730000,432370000,712810000,2208540000,8858350000,41,94,135
4733950000,6592150000,425900000,436770000,985200000,13173970000,36,78,114
1771530000,843800000,440610000,110290000,5.895e+09,9061230000,44,92,136
2470770000,4241200000,275090000,1168240000,14583700000,2.2739e+10,43,92,135
4603210000,2452910000,970690000,1920740000,134130000,10081680000,42,84,126
576720000,6713600000,1108380000,79700000,312230000,8790630000,40,88,128
1790900000,7495570000,443510000,802910000,465830000,10998720000,41,91,132
3.575e+09,3994760000,696900000,1716190000,98510000,10081360000,46,83,129
3133870000,8608770000,255510000,846560000,3291180000,16135890000,52,101,153
693150000,3400310000,689440000,62120000,325250000,5170270000,48,96,144
485310000,3908930000,2129630000,3486500000,817400000,10827770000,40,86,126
2787040000,1276830000,147250000,1020000,812570000,5024710000,36,85,121
5294590000,7353350000,157670000,1101770000,2279940000,16187320000,44,82,126
2620200000,3910930000,1078650000,139200000,8629120000,16378100000,37,76,113
4471190000,7936280000,892380000,560550000,261360000,14121760000,52,93,145
7143630000,1258380000,181810000,149360000,1624340000,10357520000,38,90,128
1901960000,2484720000,340720000,5578370000,151960000,10457730000,38,85,123
6047270000,4836540000,634660000,3284620000,379320000,15182410000,48,91,139
653200000,5359050000,1618780000,4085560000,4109960000,15826550000,40,97,137
1537950000,2735520000,343760000,342440000,210620000,5170290000,41,85,126
3699880000,3617080000,621490000,1150770000,1338080000,10427300000,45,98,143
2748330000,5252200000,1282880000,974810000,455070000,10713290000,48,98,146
3871280000,3879640000,826100000,1962500000,225290000,10764810000,44,86,130
5251850000,1481720000,205630000,1747340000,379400000,9065940000,36,63,99
1954170000,13001650000,300380000,321490000,571550000,16149240000,44,88,132
3843800000,3135570000,273810000,900950000,820350000,8974480000,42,90,132
64700000,964260000,218880000,31470000,3355240000,4634550000,52,98,150
8119720000,3536740000,395840000,139070000,3353940000,15545310000,43,98,141
3399880000,2757440000,1014360000,2971730000,298610000,10442020000,42,97,139
4132350000,10150810000,447230000,1241320000,4873360000,20845070000,51,112,163
3152300000,4256640000,814740000,1538010000,319830000,10081520000,46,94,140
3293380000,4480360000,847620000,1387760000,67160000,10076280000,37,76,113
5343330000,2636530000,493800000,1226670000,997780000,10698110000,44,80,124
3296070000,4838490000,820130000,1042130000,350750000,10347570000,50,88,138
8210100000,5950000,43360000,20600000,7.887e+09,16167010000,26,75,101
3256580000,5132290000,625520000,599050000,323770000,9937210000,51,92,143
2772140000,459820000,47910000,1030000,1774190000,5055090000,34,76,110
1278180000,180330000,19770000,970000,3550520000,5029770000,27,69,96
6441590000,992760000,392690000,860000,2258580000,10086480000,37,95,132
3197600000,640460000,82370000,1039280000,370910000,5330620000,29,59,88
2035730000,1637100000,395140000,890840000,81150000,5039960000,36,69,105
3799680000,9353030000,1090880000,2793120000,3682300000,20719010000,55,96,151
2203670000,419030000,246600000,440550000,4455530000,7765380000,34,77,111
2701680000,2955690000,157520000,109970000,4437090000,10361950000,41,97,138
474330000,7173810000,1918090000,756810000,144740000,10467780000,43,94,137
3661020000,3755190000,229200000,2683830000,128420000,10457660000,38,83,121
8201510000,1004800000,212020000,0,3500090000,12918420000,42,95,137
9904460000,8045480000,628150000,235290000,12989710000,31803090000,41,79,120
2556880000,5671360000,568580000,1618380000,276920000,10692120000,50,94,144
3378510000,146120000,65910000,0,1444210000,5034750000,34,83,117
10544490000,94490000,47380000,0,4124600000,14810960000,33,97,130
2929340000,6554110000,585540000,577500000,2024020000,12670510000,46,92,138
2529650000,6403130000,812430000,1051930000,350330000,11147470000,38,86,124
1133340000,2248570000,91610000,271820000,4.405e+09,8150340000,52,94,146
4208820000,3977030000,573230000,510020000,297080000,9566180000,46,104,150
1593320000,5830620000,706830000,979360000,654270000,9764400000,44,93,137
1415450000,1948370000,327300000,1881480000,5672070000,11244670000,40,77,117
1969120000,3050800000,350380000,1372910000,4984230000,11727440000,49,97,146
939170000,6495460000,876580000,340270000,520130000,9171610000,49,96,145
1973760000,7957480000,170690000,3261970000,3718790000,17082690000,54,96,150
1592170000,1856350000,118160000,607080000,699680000,4873440000,49,102,151
1061500000,7975370000,807820000,326910000,9086270000,19257870000,40,93,133
3474780000,4858430000,658180000,1065190000,285300000,10341880000,49,92,141
287900000,5452270000,1981820000,2975210000,130710000,10827910000,36,72,108
565170000,231950000,1.15e+08,1549540000,7.752e+09,10213660000,26,68,94
712780000,8266090000,1282620000,91880000,4507270000,14860640000,45,104,149
3390320000,5004940000,516340000,826190000,4.222e+09,13959790000,30,66,96
2883380000,467840000,26850000,640000,9908700000,13287410000,32,89,121
4306050000,2659220000,1285400000,1682080000,149060000,10081810000,42,92,134
1409260000,5123510000,82970000,2065520000,2580990000,11262250000,46,92,138
2381080000,6219390000,909660000,956670000,344620000,10811420000,48,92,140
3605810000,3094790000,305250000,414530000,4468090000,11888470000,45,100,145
1634600000,1805480000,312590000,967140000,320250000,5040060000,48,82,130
5655950000,1380650000,363070000,1196200000,1730240000,10326110000,42,81,123
2553730000,3160760000,2602450000,1907910000,406900000,10631750000,48,88,136
1312900000,3004660000,367960000,442480000,207650000,5335650000,42,82,124
2363960000,9463960000,669330000,1603160000,314210000,14414620000,46,97,143
6438360000,3668490000,440880000,4642570000,489110000,15679410000,37,73,110
2995340000,759290000,140970000,2e+06,946860000,4844460000,41,86,127
2783450000,6098560000,823800000,804960000,296050000,10806820000,47,92,139
6905380000,848020000,122820000,137300000,4551420000,12564940000,44,103,147
1703920000,4287200000,898030000,201380000,5426540000,12517070000,42,80,122
130940000,476900000,447690000,4041900000,3687260000,8784690000,25,65,90
3223110000,3.874e+09,572290000,617670000,3705210000,11992280000,50,102,152
5820160000,3100450000,521890000,520050000,3752800000,13715350000,54,116,170
1246530000,72440000,23490000,3e+05,7452650000,8795410000,25,72,97
6192970000,3892510000,420390000,1604060000,2395540000,14505470000,50,96,146
597480000,7731530000,1077230000,2385700000,2706880000,14498820000,44,105,149
7217160000,106900000,12460000,0,3787480000,1.1124e+10,34,91,125
4122920000,116690000,19510000,0,18753710000,23012830000,34,94,128
341310000,8656260000,536620000,805690000,343190000,10683070000,44,98,142
5570710000,1256800000,309590000,1247790000,801760000,9186650000,29,59,88
8423840000,247660000,47620000,4160000,2416070000,11139350000,36,86,122
1457750000,7499630000,464050000,438400000,817030000,10676860000,44,85,129
1577860000,7172380000,838390000,1418400000,5879260000,16886290000,38,86,124
4264150000,3303440000,839180000,1469500000,205040000,10081310000,41,70,111
3211890000,6571400000,899780000,2802750000,305290000,13791110000,45,89,134
360520000,4872370000,2594360000,1364340000,377960000,9569550000,38,85,123
10092450000,892300000,146870000,0,3649550000,14781170000,42,99,141
9920880000,600980000,148800000,14880000,5196060000,15881600000,43,100,143
1043200000,6211680000,459910000,668470000,3794650000,12177910000,35,71,106
4359450000,1115740000,188140000,250920000,4867260000,10781510000,46,106,152
1405170000,2813050000,150050000,801920000,5578150000,10748340000,46,87,133
1147790000,997020000,184690000,162390000,6473560000,8965450000,39,100,139
5071680000,6047920000,491200000,240790000,1991240000,13842830000,44,89,133
2205480000,5328420000,367300000,1680760000,654150000,10236110000,46,90,136
1401100000,5509730000,1623210000,3959450000,1343790000,13837280000,47,96,143
3.459e+09,2904840000,433870000,1856920000,531640000,9186270000,43,80,123
3246560000,5517320000,610510000,882040000,456780000,10713210000,43,88,131
2369900000,6590760000,5.26e+08,798640000,171050000,10456350000,40,88,128
2104900000,278230000,36330000,1750000,2618850000,5040060000,30,79,109
3149400000,297340000,52800000,67190000,16480990000,20047720000,33,91,124
1805800000,540080000,800740000,29830000,5396880000,8573330000,39,92,131
1385390000,2807820000,395100000,439120000,142860000,5170290000,48,86,134
3457110000,6458370000,321030000,751460000,2837420000,13825390000,34,73,107
250680000,583180000,53760000,1354230000,6941610000,9183460000,25,62,87
5648170000,753090000,98950000,1346270000,2595600000,10442080000,42,75,117
2689220000,992970000,123070000,0,6286520000,10091780000,37,95,132
843360000,4252360000,1019700000,3631010000,3090810000,12837240000,39,88,127
6825290000,296390000,28410000,0,3964370000,11114460000,44,103,147
7022830000,1772890000,275570000,118660000,1171970000,10361920000,40,89,129
3027050000,5290810000,611570000,623770000,783730000,10336930000,46,89,135
4197230000,6301360000,575960000,938090000,13876580000,25889220000,38,77,115
852180000,10403990000,999670000,981040000,8149960000,21386840000,44,103,147
8431770000,247790000,28800000,0,2220290000,10928650000,40,97,137
43210000,1222440000,275840000,1676110000,4446200000,7663800000,48,105,153
3287880000,6145280000,534860000,222030000,147370000,10337420000,47,94,141
3762030000,7262440000,494130000,1577260000,233900000,13329760000,37,74,111
5183780000,4898750000,435310000,3477590000,2639490000,16634920000,38,80,118
2475340000,508950000,389040000,1832190000,3589330000,8794850000,44,79,123
3567550000,2379180000,475540000,1311030000,6098640000,13831940000,44,94,138
4960350000,580230000,124270000,7120000,6112770000,11784740000,41,92,133
104410000,625900000,737150000,1956250000,6238920000,9662630000,40,95,135
4023730000,3911520000,620570000,1898560000,291010000,10745390000,46,93,139
1694810000,4008460000,261130000,4399310000,93820000,10457530000,39,87,126
2976770000,3831520000,1198710000,2278050000,177080000,10462130000,45,87,132
2927870000,5470220000,526060000,688670000,1328050000,10940870000,45,93,138
1066180000,2071100000,1694010000,2858120000,3396270000,11085680000,37,81,118
7890670000,9080000,3570000,20000,6363220000,14266560000,29,83,112
2075150000,6969480000,78660000,1022140000,897970000,11043400000,39,78,117
6092680000,59050000,10780000,0,3160500000,9323010000,37,90,127
3794800000,3299680000,1463020000,1308490000,486010000,1.0352e+10,48,91,139
2015180000,604830000,89200000,1980000,7172450000,9883640000,31,86,117
22025410000,8934040000,694710000,8315100000,17895770000,57865030000,47,107,154
24512900000,2016020000,366360000,0,8669320000,35564600000,44,108,152
16547280000,13481010000,1566630000,18841630000,1465030000,51901580000,49,99,148
14600590000,51707500000,4232060000,5234480000,18358040000,94132670000,57,135,192
13205430000,10221690000,2179460000,5726100000,493340000,31826020000,50,97,147
15652550000,16983750000,1948490000,8775470000,9531950000,52892210000,62,122,184
10333200000,21767310000,1371710000,3.74e+09,962480000,38174700000,48,101,149
16075010000,26943490000,1832230000,6110880000,63234880000,114196490000,49,103,152
21426390000,2921820000,726950000,200200000,43652140000,68927500000,42,115,157
2878430000,21807060000,6772370000,8976150000,13818500000,54252510000,46,105,151
15593020000,27266850000,3236420000,8429640000,2620890000,57146820000,54,117,171
11576320000,23049290000,1800720000,2306280000,14849660000,53582270000,40,90,130
14502910000,14755110000,1589160000,3443160000,5369520000,39659860000,51,96,147
12128560000,44723220000,2062150000,12966300000,17264100000,89144330000,58,108,166
14609900000,21306610000,1599950000,1119930000,9922240000,48558630000,52,97,149
23230200000,21980840000,4826380000,4788050000,3064440000,57889910000,51,104,155
38334130000,46388820000,3541230000,10226760000,29434170000,127925110000,62,133,195
10041330000,11499890000,1118280000,1854460000,9514450000,34028410000,48,95,143
29747850000,87460000,60490000,286810000,22334930000,52517540000,35,94,129
25312080000,4474570000,686250000,530000,11839460000,42312890000,55,115,170
2979720000,10215890000,4126760000,19850220000,15866460000,53039050000,44,104,148
25616900000,1264400000,341400000,76210000,18053510000,45352420000,45,103,148
18505110000,24457130000,2066550000,3195650000,37887540000,86111980000,55,97,152
9372230000,23142320000,642740000,1842530000,14446290000,49446110000,66,110,176
9649960000,10230640000,850060000,2149480000,7148200000,30028340000,51,104,155
11554100000,26526470000,3041160000,3481470000,1407270000,46010470000,54,101,155
9122150000,13173540000,767980000,2023860000,6754230000,31841760000,57,110,167
17504240000,12333650000,1872920000,3378760000,15753710000,50843280000,66,108,174
1108450000,2245350000,204830000,9125410000,18483830000,31167870000,27,69,96
13965320000,9145460000,363580000,2278160000,6218530000,31971050000,53,106,159
18168670000,3073720000,249300000,222030000,40138980000,61852700000,45,110,155
11742330000,27053750000,2537890000,6465420000,853840000,48653230000,46,102,148
5159920000,22054660000,2423130000,13205180000,11736250000,54579140000,50,105,155
3850310000,14434680000,6975560000,8014710000,10703460000,43978720000,62,131,193
4803840000,1966650000,1342240000,8394670000,24870840000,41378240000,38,100,138
33537960000,1200680000,188180000,75180000,17081100000,52083100000,43,101,144
15339480000,5790240000,2521880000,12366880000,12823850000,48842330000,52,103,155
12214730000,27459980000,1673570000,7593200000,15976880000,64918360000,59,107,166
9677400000,13425150000,686630000,3330090000,2214160000,29333430000,55,110,165
16037150000,13207360000,2303710000,3535180000,1696780000,36780180000,54,101,155
10825530000,26231970000,1709840000,3063680000,2041730000,43872750000,49,99,148
15594440000,30271060000,4296200000,4043010000,3185500000,57390210000,56,115,171
10182920000,20859010000,2258540000,4658710000,10468300000,48427480000,51,107,158
2211470000,17081700000,1518840000,550970000,18236940000,39599920000,47,102,149
2150390000,8769430000,2377180000,12449440000,22374030000,48120470000,43,105,148
12920100000,14495340000,3712010000,4848100000,416990000,36392540000,48,96,144
16901770000,15772410000,2035610000,6288580000,2024040000,43022410000,57,105,162
4332490000,8149450000,433040000,1270240000,3558970000,17744190000,58,105,163
44864460000,275130000,156800000,51140000,23742660000,69090190000,40,112,152
20848260000,10472810000,1460980000,3582070000,16949220000,53313340000,56,121,177
8593220000,15775220000,4650280000,5158220000,934310000,35111250000,46,96,142
12056620000,12240670000,2587130000,7901890000,1683770000,36470080000,49,101,150
6993140000,15400490000,3099150000,3315100000,1062610000,29870490000,50,97,147
2919170000,18306910000,2096030000,2676100000,20339150000,46337360000,44,95,139
18676330000,13081740000,3713240000,7339390000,978610000,43789310000,51,101,152
33229420000,9590050000,2142260000,324100000,18724890000,64010720000,48,107,155
1454190000,20922280000,4657750000,8182070000,9879040000,45095330000,47,106,153
9236890000,17513950000,3142450000,5756610000,920400000,36570300000,52,104,156
19544690000,178150000,43220000,40000,44049510000,63815610000,39,111,150
9065790000,3190770000,328610000,1799480000,21898060000,36282710000,57,117,174
38507430000,1520810000,422110000,63780000,19783650000,60297780000,45,108,153
10837410000,16326100000,3010110000,3918370000,1255380000,35347370000,52,97,149
17114140000,9429520000,2163560000,834170000,18963600000,48504990000,51,109,160
22150060000,29549160000,1025310000,7333990000,12552160000,72610680000,61,113,174
12364650000,28695040000,3785360000,1251020000,9045620000,55141690000,60,117,177
33459030000,10334730000,1487590000,364410000,21345430000,66991190000,46,109,155
40414870000,5085090000,1.066e+09,25400000,26638110000,73229470000,46,111,157
10255770000,4979880000,1111350000,1418330000,16892340000,34657670000,55,120,175
9301080000,41634950000,1839260000,4088310000,25653150000,82516750000,61,117,178
1597980000,12818100000,1561880000,4976410000,14233940000,35188310000,53,106,159
30143040000,8051930000,995230000,844130000,18964300000,58998630000,50,110,160
37770360000,1345420000,422070000,34270000,22336990000,61909110000,53,120,173
11722080000,7651170000,3794480000,5216530000,539300000,28923560000,48,96,144
31742270000,2277030000,339270000,870000,11106960000,45466400000,47,110,157
11858370000,22572920000,914690000,5412620000,15771890000,56530490000,56,101,157
10813280000,21045650000,3294620000,3699450000,1658150000,40511150000,51,95,146
3030560000,837470000,239240000,3755330000,32685830000,40548430000,38,104,142
11188470000,9567410000,1816650000,4716530000,348660000,27637720000,47,88,135
10987490000,16287550000,1174710000,2211970000,2795480000,33457200000,56,110,166
4962280000,36666950000,2757040000,4436130000,2499370000,51321770000,48,110,158
25230670000,780060000,154690000,675830000,58904050000,85745300000,36,100,136
24592400000,8395940000,2405180000,8318890000,10726170000,54438580000,57,115,172
15022520000,27258430000,1865410000,2496860000,4627490000,51270710000,49,103,152
10759250000,16589800000,2189360000,5544040000,1200190000,36282640000,56,107,163
13594990000,12822400000,1680250000,11394520000,774140000,40266300000,51,106,157
6799180000,7352440000,290010000,3075870000,3921160000,21438660000,54,115,169
2947450000,4652720000,753200000,23606900000,20396800000,52357070000,30,74,104
21119370000,4302920000,348820000,19710000,11829960000,37620780000,53,118,171
17370890000,5273840000,463770000,2060000,9241850000,32352410000,51,119,170
13163070000,6715150000,2132780000,2959370000,16014270000,40984640000,59,113,172
12402760000,20184260000,2309060000,3264230000,1127830000,39288140000,56,107,163
1387650000,3542780000,1356320000,18814010000,18814540000,43915300000,32,80,112
2434760000,12587480000,2555420000,10747560000,7302210000,35627430000,56,123,179
16150110000,1056740000,5.6e+07,223160000,38348730000,55834740000,38,107,145
2.2502e+10,18911280000,3064630000,4642850000,2482400000,51603160000,56,116,172
3444290000,5.493e+09,1897650000,15119760000,18764500000,44719200000,44,104,148
30386610000,35838610000,3169440000,8010510000,4888490000,82293660000,55,112,167
12553060000,28615090000,1814350000,1552360000,32667980000,77202840000,44,86,130
11516850000,6121460000,1990580000,5918230000,10852120000,36399240000,54,99,153
13949710000,9081480000,2777230000,7475210000,6751430000,40035060000,54,113,167
13608390000,26756320000,3050470000,2972640000,1322710000,47710530000,56,110,166
12465910000,2566490000,316890000,34350000,50607210000,65990850000,42,103,145
17658970000,24867130000,2205930000,6848410000,10048400000,61628840000,53,105,158
5040950000,28607480000,5206620000,5331260000,7254250000,51440560000,53,108,161
33717330000,34496930000,5097880000,15596500000,4536170000,93444810000,50,112,162
12464750000,16838470000,3306770000,1401550000,9080730000,43092270000,53,114,167
7497950000,14203780000,1214050000,4826730000,9460150000,37202660000,52,105,157
10659940000,10930760000,3620210000,5969320000,777440000,31957670000,49,100,149
21244610000,9300830000,1316320000,7650000,10971280000,42840690000,55,119,174
13669600000,42606150000,2103690000,5237430000,31617750000,95234620000,59,102,161
7995380000,467450000,76620000,753740000,40291320000,49584510000,33,95,128
5222800000,28198180000,3008250000,9032100000,3133330000,48594660000,50,113,163
67972930000,80786410000,11186960000,27139040000,8831810000,195917150000,62,125,187
76002050000,95745410000,15568190000,22525430000,7746730000,217587810000,64,122,186
22806140000,97412170000,11661740000,34728170000,67834860000,234443080000,57,138,195
89633930000,4233150000,552570000,793350000,94780620000,189993620000,47,119,166
49232450000,98987940000,19012870000,40237410000,48844190000,256314860000,67,136,203
78767030000,118595260000,8305170000,26910020000,88033990000,320611470000,77,144,221
105073640000,17950610000,2358800000,5920000,45650070000,171039040000,60,125,185
40912900000,7795120000,1010650000,53600000,98074710000,147846980000,45,120,165
54207210000,30257130000,4683600000,2060510000,74554040000,165762490000,58,117,175
35155490000,23953760000,3127290000,862670000,67025680000,130124890000,58,128,186
8.0888e+10,91411470000,1.1896e+10,52738270000,31523550000,268457290000,75,148,223
75829660000,123706340000,10500060000,22673130000,18798720000,251507910000,59,129,188
20807570000,45761160000,14186860000,105142540000,195184240000,381082370000,56,140,196
78036350000,54804350000,9724420000,23089990000,24064180000,189719290000,68,143,211
65980720000,185163160000,8977690000,29195290000,128992850000,418309710000,75,133,208
42154900000,360070000,107150000,152120000,85001190000,127775430000,42,120,162
84310730000,69707660000,18313590000,43635800000,11427810000,227395590000,65,128,193
63490560000,113338060000,11305150000,21109700000,19360240000,228603710000,60,117,177
95513980000,14460990000,3023660000,428230000,51313330000,164740190000,52,119,171
26587240000,101848390000,27482200000,32349950000,40700270000,228968050000,70,149,219
63800260000,124461360000,11223690000,18882880000,36965410000,255333600000,66,145,211
52650100000,64864700000,9823800000,11863420000,60150980000,1.99353e+11,72,134,206
47609080000,1174790000,237960000,1465770000,93387450000,143875050000,38,112,150
24725320000,41376310000,2814050000,9047200000,85381720000,163344600000,58,124,182
43186500000,22527370000,2514150000,4260030000,61300630000,133788680000,62,126,188
42168980000,55413400000,3436060000,11315880000,24896410000,137230730000,63,123,186
7.9339e+10,3590280000,817710000,145740000,52830060000,136722790000,54,123,177
30850800000,61933910000,4997290000,8093900000,97167770000,203043670000,55,120,175
227911970000,331095270000,39841130000,68242870000,120013130000,787104370000,74,151,225
269502940000,425503410000,38992740000,86981020000,316869850000,1137849960000,75,161,236
227629860000,85623790000,12630700000,8029660000,316414860000,650328870000,65,145,210
389106510000,41598560000,6286290000,4833950000,405909310000,847734620000,69,152,221
317238410000,343279530000,67734030000,146383790000,142945020000,1017580780000,91,185,276
161645790000,333903310000,20310020000,69248680000,235976790000,821084590000,80,160,240
48276210000,187777140000,44461080000,160878720000,306051490000,747444640000,74,179,253
1596762660000,1695128470000,218143230000,526381830000,1963679440000,6000095630000,122,270,392
