"Forest","Agriculture","Urban","Grassland","Other","Area_Total","forest_sp","agriculture_sp","generalist_sp","Sp_Total"
124760000,247110000,482870000,31740000,1603660000,2490140000,25,17,64,106
145150000,388660000,58290000,3180000,1602760000,2198040000,22,15,52,89
181440000,1195730000,162710000,39290000,920830000,2.5e+09,23,15,60,98
477670000,685220000,10270000,72720000,1254120000,2.5e+09,25,17,58,100
346850000,449720000,70750000,50290000,1582390000,2.5e+09,25,20,69,114
167350000,1758200000,10530000,122360000,441560000,2.5e+09,26,21,64,111
696300000,498280000,40750000,46400000,1218270000,2.5e+09,20,16,52,88
200940000,1827710000,27910000,304620000,138820000,2.5e+09,25,21,65,111
309660000,1837590000,28830000,141160000,182760000,2.5e+09,28,24,71,123
507050000,1229450000,158270000,25780000,579450000,2.5e+09,24,20,68,112
610450000,1457110000,87300000,48260000,296880000,2.5e+09,27,19,70,116
690250000,557200000,47570000,8320000,1196660000,2.5e+09,22,14,57,93
1195260000,1019350000,10850000,29500000,245040000,2.5e+09,25,18,57,100
867320000,811630000,143720000,24960000,652370000,2.5e+09,22,15,57,94
727390000,344930000,25010000,5970000,1396700000,2.5e+09,22,12,46,80
122960000,800110000,38120000,52260000,1486550000,2.5e+09,29,21,66,116
428910000,710430000,11440000,174900000,1174320000,2.5e+09,22,16,55,93
268670000,836450000,80530000,47660000,1266690000,2.5e+09,30,28,69,127
247410000,1806490000,18310000,165970000,261820000,2.5e+09,27,24,62,113
380690000,1471040000,13210000,100790000,534270000,2.5e+09,28,22,64,114
168510000,1698900000,17780000,476480000,138330000,2.5e+09,22,20,59,101
123410000,1844420000,55760000,274740000,201670000,2.5e+09,31,27,77,135
367440000,968540000,27860000,57290000,1078870000,2.5e+09,25,20,61,106
267670000,1074310000,8220000,328670000,821130000,2.5e+09,26,24,71,121
39860000,768310000,119400000,15700000,1556730000,2.5e+09,35,35,85,155
15690000,31970000,80750000,5970000,1604950000,1739330000,27,24,60,111
572660000,767310000,23970000,88810000,1047250000,2.5e+09,28,23,66,117
902670000,960240000,17260000,17980000,601850000,2.5e+09,22,11,42,75
306960000,1560060000,13940000,284610000,334430000,2.5e+09,26,24,59,109
83550000,927110000,34210000,969640000,485490000,2.5e+09,29,25,72,126
106360000,1936770000,33960000,207110000,215800000,2.5e+09,29,31,79,139
105550000,1452780000,24520000,464250000,452900000,2.5e+09,31,30,77,138
221930000,150110000,7170000,6100000,1884600000,2269910000,18,10,33,61
378310000,291380000,266270000,9250000,1439510000,2384720000,23,16,56,95
393800000,1022140000,190390000,11680000,881990000,2.5e+09,24,13,49,86
717870000,615100000,41010000,10140000,1115880000,2.5e+09,23,10,44,77
790910000,449450000,187420000,14520000,1057700000,2.5e+09,26,18,56,100
395660000,676390000,137760000,9750000,1280440000,2.5e+09,20,12,53,85
939720000,490910000,44930000,28870000,995570000,2.5e+09,25,20,55,100
368620000,461670000,23690000,84030000,1561990000,2.5e+09,24,19,50,93
880200000,904580000,32810000,15950000,666460000,2.5e+09,24,16,48,88
1020590000,641400000,104260000,20620000,713130000,2.5e+09,29,18,54,101
959760000,1026110000,34220000,25420000,454490000,2.5e+09,22,15,45,82
330930000,781840000,37160000,28190000,1321880000,2.5e+09,24,19,58,101
426730000,772570000,23930000,208170000,1068600000,2.5e+09,25,19,61,105
231880000,1226180000,21870000,34830000,985240000,2.5e+09,26,19,54,99
300270000,1008810000,24740000,16590000,1149590000,2.5e+09,26,15,51,92
136740000,1328340000,16320000,81200000,937400000,2.5e+09,27,21,69,117
97310000,1087810000,11430000,191340000,1112110000,2.5e+09,27,24,66,117
658310000,631120000,18430000,38520000,1153620000,2.5e+09,29,20,67,116
289820000,1128300000,32400000,58280000,991200000,2.5e+09,26,21,58,105
278760000,1309910000,14390000,53810000,843130000,2.5e+09,25,22,59,106
936380000,973730000,14660000,6470000,568760000,2.5e+09,24,14,46,84
932320000,351770000,40870000,172930000,1002110000,2.5e+09,25,18,58,101
962640000,422910000,17520000,50010000,1046920000,2.5e+09,20,10,39,69
593010000,669810000,8110000,273350000,955720000,2.5e+09,29,29,76,134
86650000,1243240000,9950000,464260000,695900000,2.5e+09,31,22,73,126
138430000,1375380000,11360000,691490000,283340000,2.5e+09,27,23,65,115
324290000,883140000,7590000,252620000,1032360000,2.5e+09,28,23,70,121
663010000,186100000,4540000,337870000,1308480000,2.5e+09,26,18,60,104
887670000,241270000,21550000,295890000,1053620000,2.5e+09,29,17,61,107
9570000,28480000,3e+06,78790000,1720200000,1840040000,15,17,39,71
88650000,24020000,2800000,257130000,1964550000,2337150000,15,9,40,64
40170000,64350000,8810000,545610000,1841060000,2.5e+09,17,11,45,73
32590000,143050000,3040000,109030000,2212290000,2.5e+09,17,13,46,76
168700000,319410000,11830000,836180000,1163880000,2.5e+09,18,12,47,77
85680000,250090000,16430000,477660000,1670140000,2.5e+09,15,13,43,71
27190000,115700000,2390000,23680000,2324250000,2493210000,17,15,51,83
125210000,176200000,11700000,698600000,1488290000,2.5e+09,16,18,50,84
59540000,148750000,7580000,97180000,2122760000,2435810000,14,13,45,72
83130000,213150000,20830000,458070000,1724820000,2.5e+09,16,15,50,81
249280000,174700000,42650000,946390000,1086980000,2.5e+09,15,12,45,72
186730000,371930000,30640000,1065320000,845380000,2.5e+09,17,18,49,84
11450000,79630000,11290000,77760000,2157940000,2338070000,18,18,56,92
185020000,222810000,29250000,1902980000,159940000,2.5e+09,13,10,40,63
33070000,204340000,93150000,1099260000,1070180000,2.5e+09,14,13,43,70
96250000,261300000,24860000,832230000,1264960000,2479600000,17,14,45,76
111540000,91740000,74050000,2004100000,218570000,2.5e+09,15,12,45,72
194690000,186900000,20960000,1751400000,346050000,2.5e+09,16,13,46,75
225980000,165120000,22430000,1852520000,233950000,2.5e+09,14,10,42,66
66160000,70720000,33350000,1826770000,5.03e+08,2.5e+09,18,15,46,79
93020000,103460000,38200000,2055300000,210020000,2.5e+09,16,12,39,67
39980000,175990000,129700000,1931310000,223020000,2.5e+09,18,14,47,79
66270000,129390000,70730000,481710000,1701630000,2449730000,20,15,54,89
57760000,83090000,35880000,618560000,1704710000,2.5e+09,14,14,46,74
427510000,1482570000,22830000,64480000,502610000,2.5e+09,31,27,80,138
331760000,278140000,73720000,1108090000,708290000,2.5e+09,21,17,56,94
94130000,438020000,47510000,1095650000,824690000,2.5e+09,21,10,41,72
117750000,243400000,40320000,1722590000,375940000,2.5e+09,15,13,43,71
32940000,533740000,444530000,943570000,545220000,2.5e+09,19,16,51,86
147650000,0,2210000,279380000,2070760000,2.5e+09,18,16,53,87
577890000,1255140000,34650000,355410000,276910000,2.5e+09,30,32,77,139
159010000,1779690000,9710000,2.83e+08,268590000,2.5e+09,24,20,62,106
308990000,990360000,13390000,500240000,687020000,2.5e+09,32,30,80,142
49430000,1677780000,40800000,525660000,206330000,2.5e+09,30,29,78,137
347420000,1258790000,26480000,263550000,603760000,2.5e+09,36,31,92,159
386470000,1199360000,29100000,83130000,801940000,2.5e+09,29,25,72,126
132320000,42870000,117060000,39200000,1742840000,2074290000,20,17,57,94
117970000,1122780000,149450000,65290000,1044510000,2.5e+09,32,26,83,141
14980000,2381280000,28180000,38270000,37290000,2.5e+09,23,16,56,95
79960000,1949090000,4.5e+07,85190000,340760000,2.5e+09,30,23,74,127
597340000,1217810000,20650000,54580000,609620000,2.5e+09,23,16,60,99
495730000,836660000,7380000,314860000,845370000,2.5e+09,29,26,70,125
391010000,1080370000,10690000,416740000,601190000,2.5e+09,25,20,66,111
270240000,1802550000,59350000,180440000,187420000,2.5e+09,30,27,81,138
218760000,663520000,44120000,43240000,1530360000,2.5e+09,29,24,73,126
162640000,583640000,19030000,100140000,1634550000,2.5e+09,30,23,68,121
206750000,1913800000,44800000,100800000,233850000,2.5e+09,27,13,58,98
144930000,1989240000,126550000,64400000,174880000,2.5e+09,28,23,71,122
204330000,1515170000,10260000,303550000,466690000,2.5e+09,30,18,65,113
446810000,900080000,24050000,249420000,879640000,2.5e+09,26,16,63,105
2.46e+08,1700290000,19960000,147990000,385760000,2.5e+09,23,24,57,104
74790000,1985290000,56490000,93270000,290160000,2.5e+09,30,26,73,129
95100000,428510000,59720000,139280000,1777390000,2.5e+09,29,18,71,118
479700000,1153680000,13330000,347260000,506030000,2.5e+09,27,18,62,107
6.43e+08,684390000,5900000,225160000,941550000,2.5e+09,24,14,57,95
366020000,1394490000,5110000,253870000,480510000,2.5e+09,20,11,54,85
587690000,1228040000,10820000,315010000,358440000,2.5e+09,26,21,63,110
798820000,199300000,33920000,320520000,1147440000,2.5e+09,22,18,59,99
125380000,1131410000,156770000,189490000,896950000,2.5e+09,31,20,77,128
424860000,1273470000,33810000,507930000,259930000,2.5e+09,29,19,61,109
169180000,1389290000,219390000,516570000,205570000,2.5e+09,31,24,84,139
732110000,1314550000,11180000,134040000,308120000,2.5e+09,25,13,56,94
475490000,881890000,32260000,269110000,841250000,2.5e+09,27,15,63,105
637290000,661610000,16600000,320530000,863970000,2.5e+09,27,20,66,113
1009100000,289830000,3670000,618530000,578870000,2.5e+09,28,17,64,109
1031050000,465970000,4690000,273160000,725130000,2.5e+09,31,17,64,112
404490000,583170000,170520000,503700000,838120000,2.5e+09,29,20,71,120
64350000,830940000,324200000,114450000,1166060000,2.5e+09,34,24,85,143
80850000,1113790000,143980000,181250000,980130000,2.5e+09,28,19,77,124
536490000,688490000,104810000,309140000,861070000,2.5e+09,31,20,75,126
463330000,428390000,18300000,717750000,872230000,2.5e+09,28,27,73,128
103080000,1743410000,74820000,485700000,92990000,2.5e+09,27,30,70,127
579300000,880160000,94440000,378750000,567350000,2.5e+09,33,26,72,131
449190000,340460000,15920000,318750000,1375680000,2.5e+09,31,24,73,128
915490000,273480000,61770000,531530000,717730000,2.5e+09,30,22,70,122
159370000,2185960000,28820000,61870000,63980000,2.5e+09,26,27,68,121
142120000,1847340000,25440000,247590000,237510000,2.5e+09,25,30,72,127
977820000,1298490000,47690000,69670000,106330000,2.5e+09,27,26,69,122
434690000,1393530000,62050000,415730000,1.94e+08,2.5e+09,31,30,72,133
55150000,2375850000,17830000,26020000,25150000,2.5e+09,24,21,67,112
133050000,2230510000,41790000,30940000,63710000,2.5e+09,23,23,68,114
143210000,2192690000,41730000,30480000,91890000,2.5e+09,26,25,68,119
383530000,1736940000,112600000,89790000,177140000,2.5e+09,27,23,69,119
839510000,96120000,4320000,200740000,1359310000,2.5e+09,27,21,67,115
956870000,975960000,14180000,205340000,347650000,2.5e+09,28,27,71,126
820760000,115610000,3220000,437800000,1122610000,2.5e+09,27,19,67,113
696900000,1343060000,14700000,206460000,238880000,2.5e+09,31,25,72,128
280640000,283700000,16870000,67010000,1591580000,2239800000,24,18,53,95
58320000,47850000,13300000,70660000,1.49e+09,1680130000,24,18,57,99
437510000,776500000,655860000,324240000,305890000,2.5e+09,33,27,82,142
622660000,1291730000,14930000,356120000,214560000,2.5e+09,31,25,71,127
868580000,287810000,110100000,710050000,523460000,2.5e+09,32,28,78,138
703900000,725510000,7590000,464510000,598490000,2.5e+09,29,23,70,122
501120000,1002970000,48320000,318990000,628600000,2.5e+09,31,31,74,136
150420000,2086200000,55060000,122130000,86190000,2.5e+09,26,22,70,118
303870000,1960750000,26090000,38830000,170460000,2.5e+09,29,24,68,121
1168880000,554840000,11140000,196370000,568770000,2.5e+09,29,23,79,131
1049210000,999090000,11860000,101510000,338330000,2.5e+09,28,19,66,113
709120000,229390000,36320000,639190000,885980000,2.5e+09,32,23,73,128
593520000,1011830000,6450000,405280000,482920000,2.5e+09,29,21,74,124
1027430000,489380000,44520000,431330000,507340000,2.5e+09,30,23,72,125
686820000,1247940000,7900000,109560000,447780000,2.5e+09,30,21,73,124
15250000,89270000,34640000,4660000,1854180000,1.998e+09,23,17,50,90
174950000,495480000,153630000,63890000,1606980000,2494930000,26,23,68,117
536750000,1318270000,16620000,201940000,426420000,2.5e+09,32,25,72,129
1394690000,463320000,3330000,364200000,274460000,2.5e+09,25,20,63,108
527850000,1092820000,4710000,486960000,387660000,2.5e+09,28,23,66,117
868980000,894100000,8420000,408060000,320440000,2.5e+09,30,23,67,120
1156540000,439770000,2490000,423140000,478060000,2.5e+09,24,17,58,99
1122100000,428440000,30750000,298040000,620670000,2.5e+09,30,22,74,126
1368200000,537980000,15610000,213960000,364250000,2.5e+09,29,22,70,121
394660000,1167240000,39190000,142700000,756210000,2.5e+09,33,26,73,132
483180000,1254650000,5540000,270420000,486210000,2.5e+09,29,24,70,123
1521090000,202060000,139530000,305950000,331370000,2.5e+09,33,22,70,125
703080000,1359370000,91110000,52190000,294250000,2.5e+09,37,28,84,149
1461240000,61680000,98480000,553440000,325160000,2.5e+09,31,21,65,117
785680000,1205050000,33270000,141460000,334540000,2.5e+09,32,24,79,135
45480000,611760000,132320000,323010000,1387430000,2.5e+09,27,28,70,125
297240000,1115780000,176730000,237570000,672680000,2.5e+09,28,25,70,123
6830000,83910000,43910000,11300000,1970100000,2116050000,27,23,59,109
283020000,1612810000,129110000,381580000,93480000,2.5e+09,26,21,63,110
48540000,905470000,227950000,500810000,817230000,2.5e+09,31,30,80,141
645630000,832900000,19860000,224560000,777050000,2.5e+09,26,17,62,105
260690000,1646900000,11310000,14030000,567070000,2.5e+09,31,25,66,122
171150000,1840960000,49430000,36150000,402310000,2.5e+09,35,30,83,148
222340000,1590760000,33010000,83740000,570150000,2.5e+09,33,28,76,137
639090000,1333590000,11990000,31630000,483700000,2.5e+09,34,30,78,142
1273600000,181390000,20680000,877910000,146420000,2.5e+09,28,19,65,112
759080000,1106920000,78730000,33650000,521620000,2.5e+09,33,27,83,143
1066360000,449310000,31930000,814450000,137950000,2.5e+09,28,20,70,118
1437220000,305300000,4220000,173180000,580080000,2.5e+09,33,24,73,130
474780000,64510000,44660000,650000,1606300000,2190900000,26,19,56,101
536810000,499490000,220540000,207060000,1002840000,2466740000,33,25,71,129
626940000,497610000,74340000,9480000,1291630000,2.5e+09,27,18,56,101
556690000,1587300000,120800000,179790000,55420000,2.5e+09,28,20,67,115
263280000,1740000,39770000,660000,1439250000,1744700000,25,19,60,104
249130000,11390000,64390000,330000,1562220000,1887460000,20,18,53,91
868560000,469190000,427030000,106200000,629020000,2.5e+09,28,24,69,121
124150000,118150000,79590000,38090000,1815700000,2175680000,28,26,71,125
134070000,10370000,18450000,4170000,1420390000,1587450000,18,17,54,89
292300000,1659970000,144230000,297550000,105950000,2.5e+09,30,28,80,138
484060000,1109660000,69340000,239710000,597230000,2.5e+09,30,27,73,130
107100000,1830190000,157870000,387630000,17210000,2.5e+09,23,21,64,108
41810000,608100000,150890000,226200000,1.473e+09,2.5e+09,29,29,78,136
146690000,1710800000,108380000,524960000,9170000,2.5e+09,24,22,70,116
122810000,1940420000,155920000,269170000,11680000,2.5e+09,26,22,72,120
179490000,1739370000,87590000,4.66e+08,27550000,2.5e+09,24,18,66,108
91760000,1554270000,344830000,441150000,67990000,2.5e+09,30,28,82,140
141850000,1340220000,197460000,777910000,42560000,2.5e+09,29,25,76,130
131340000,1655790000,142580000,551810000,18480000,2.5e+09,26,25,73,124
1048150000,311990000,3830000,554740000,581290000,2.5e+09,29,16,62,107
130440000,1971240000,21030000,26530000,350760000,2.5e+09,33,26,66,125
548870000,1245710000,14010000,28330000,663080000,2.5e+09,33,25,80,138
181450000,1915610000,12800000,20690000,369450000,2.5e+09,30,23,69,122
838190000,567890000,114010000,717360000,262550000,2.5e+09,33,20,67,120
1027320000,141850000,14600000,478780000,837450000,2.5e+09,34,23,73,130
477980000,1449260000,242070000,233380000,97310000,2.5e+09,25,23,58,106
1215910000,737520000,66420000,104830000,375320000,2.5e+09,25,16,58,99
258990000,2033450000,139510000,56450000,11600000,2.5e+09,24,22,68,114
668630000,1570250000,52890000,107780000,100450000,2.5e+09,24,18,57,99
276380000,1748040000,117550000,335600000,22430000,2.5e+09,28,22,74,124
590890000,1233970000,102590000,542970000,29580000,2.5e+09,28,27,72,127
517110000,1589080000,145190000,189900000,58720000,2.5e+09,30,27,77,134
24740000,397660000,49300000,164700000,1863600000,2.5e+09,24,17,56,97
122420000,681520000,83560000,382530000,1229970000,2.5e+09,22,18,54,94
32180000,339550000,23850000,413090000,1431860000,2240530000,23,15,45,83
15360000,65020000,7170000,213030000,1484860000,1785440000,22,16,51,89
19470000,137360000,42730000,308490000,1836600000,2344650000,27,17,60,104
39010000,86620000,197480000,594250000,1582640000,2.5e+09,18,19,50,87
28440000,199220000,66490000,887320000,1318200000,2499670000,16,17,48,81
343600000,1770000,9070000,133160000,2012400000,2.5e+09,12,16,44,72
205810000,70210000,112730000,415200000,1696050000,2.5e+09,24,25,66,115
251290000,47160000,26380000,362150000,1813020000,2.5e+09,22,20,57,99
35330000,632450000,159170000,51590000,1621460000,2.5e+09,25,18,57,100
25450000,312910000,43600000,21090000,2094600000,2497650000,26,17,63,106
80320000,481030000,108150000,410380000,1419100000,2498980000,26,19,62,107
61820000,166480000,43940000,633900000,1593860000,2.5e+09,22,17,52,91
196740000,828050000,36920000,1206750000,231540000,2.5e+09,22,14,56,92
121820000,368040000,99610000,670330000,1240200000,2.5e+09,30,18,61,109
168850000,839830000,163110000,871350000,456860000,2.5e+09,25,19,65,109
256290000,12520000,15090000,1764150000,451950000,2.5e+09,21,19,57,97
135240000,68570000,222140000,1043860000,1030190000,2.5e+09,26,22,68,116
190250000,236680000,19540000,1619080000,434450000,2.5e+09,23,18,66,107
346070000,146770000,403740000,1112960000,490460000,2.5e+09,26,20,62,108
31830000,17750000,53760000,742320000,1654340000,2.5e+09,31,27,77,135
217060000,20470000,21240000,697360000,1542840000,2498970000,22,19,61,102
196220000,142730000,88450000,1583940000,488660000,2.5e+09,26,21,69,116
232460000,149730000,26760000,1847580000,243470000,2.5e+09,23,21,60,104
22290000,128890000,195230000,205090000,1.706e+09,2257500000,23,22,70,115
249730000,189050000,16900000,631880000,1412440000,2.5e+09,23,25,65,113
118950000,275020000,59430000,1025010000,1021590000,2.5e+09,23,21,69,113
165070000,53390000,40360000,845600000,1395580000,2.5e+09,24,24,69,117
231640000,1.57e+08,545880000,1117570000,447910000,2.5e+09,22,22,63,107
529380000,59880000,39280000,739360000,1132100000,2.5e+09,18,21,56,95
272820000,255550000,247330000,931650000,792650000,2.5e+09,22,20,61,103
480800000,180150000,59490000,1114660000,664900000,2.5e+09,21,21,58,100
241410000,1437030000,145850000,158180000,517530000,2.5e+09,29,20,57,106
189500000,1743080000,173640000,201560000,192220000,2.5e+09,25,19,62,106
289190000,1883750000,100990000,149870000,76200000,2.5e+09,26,15,53,94
443590000,1708900000,78400000,220880000,48230000,2.5e+09,22,14,52,88
20690000,234060000,66230000,10380000,1674930000,2006290000,24,18,53,95
81020000,807190000,108420000,867630000,635740000,2.5e+09,24,19,65,108
148310000,1259370000,159300000,927900000,5120000,2.5e+09,25,18,62,105
468300000,397840000,753430000,804410000,76020000,2.5e+09,26,21,63,110
270150000,616090000,231940000,488930000,892890000,2.5e+09,31,26,72,129
192330000,1451660000,88320000,759110000,8580000,2.5e+09,23,19,60,102
287400000,780810000,288860000,824800000,318130000,2.5e+09,28,23,70,121
74350000,1360080000,253520000,798840000,13210000,2.5e+09,21,18,61,100
112670000,1322400000,254180000,780070000,30680000,2.5e+09,28,22,65,115
69230000,876870000,227700000,1304690000,21510000,2.5e+09,22,19,59,100
174820000,1234590000,164490000,876410000,49690000,2.5e+09,25,18,64,107
107270000,356310000,291310000,1647940000,97170000,2.5e+09,27,23,71,121
81590000,969300000,917360000,466750000,6.5e+07,2.5e+09,29,22,67,118
22920000,93830000,213070000,680750000,1489430000,2.5e+09,32,25,73,130
94700000,111290000,450570000,1346490000,496950000,2.5e+09,25,20,70,115
130090000,145910000,6.25e+08,1035550000,563450000,2.5e+09,27,21,66,114
138670000,226980000,65010000,1367630000,701710000,2.5e+09,23,20,62,105
137380000,17590000,41900000,1419560000,883570000,2.5e+09,29,25,70,124
72880000,695710000,507090000,406720000,817600000,2.5e+09,28,29,74,131
96550000,1159340000,48940000,500800000,694370000,2.5e+09,27,26,71,124
544490000,176450000,13140000,1046420000,719500000,2.5e+09,23,17,54,94
43220000,440410000,116730000,251520000,1381990000,2233870000,28,27,75,130
160210000,1328430000,146280000,131290000,733790000,2.5e+09,25,21,58,104
246360000,1866660000,104420000,263650000,18910000,2.5e+09,21,16,52,89
136910000,1342230000,154390000,207710000,658760000,2.5e+09,27,25,66,118
308600000,1679690000,184300000,278310000,49100000,2.5e+09,25,21,64,110
19360000,215980000,49750000,218460000,1996450000,2.5e+09,25,18,64,107
195660000,362290000,348940000,464360000,1128750000,2.5e+09,28,25,70,123
89230000,360970000,183190000,304120000,1369620000,2307130000,27,21,70,118
47670000,1393130000,276240000,772330000,10630000,2.5e+09,22,17,60,99
179710000,1260380000,276860000,753490000,29560000,2.5e+09,26,20,65,111
172180000,582850000,1186620000,509930000,48420000,2.5e+09,25,21,67,113
114010000,1372130000,499110000,473970000,40780000,2.5e+09,28,22,65,115
39740000,1257560000,412760000,761640000,28300000,2.5e+09,24,19,61,104
54380000,2177850000,151290000,94640000,21840000,2.5e+09,21,18,65,104
88160000,1851680000,267850000,227660000,64650000,2.5e+09,25,19,67,111
57410000,1848760000,238690000,319840000,35300000,2.5e+09,28,22,69,119
116670000,1632300000,492980000,175140000,82910000,2.5e+09,27,23,71,121
78720000,1990880000,211960000,116100000,102340000,2.5e+09,23,16,61,100
239850000,816940000,64670000,500310000,878230000,2.5e+09,26,20,74,120
107510000,1338480000,93440000,776390000,184180000,2.5e+09,25,24,68,117
160740000,1683170000,158340000,472950000,24800000,2.5e+09,23,21,59,103
164850000,1023110000,69400000,1226840000,15800000,2.5e+09,25,19,68,112
146360000,1229350000,109150000,1000330000,14810000,2.5e+09,25,22,66,113
42400000,303720000,47650000,365090000,1709180000,2468040000,31,24,75,130
75480000,822390000,116380000,1267680000,218070000,2.5e+09,25,22,62,109
17900000,480040000,125630000,186570000,1470900000,2281040000,28,23,74,125
199450000,1215700000,150660000,923870000,10320000,2.5e+09,23,17,59,99
367630000,1047260000,70300000,999580000,15230000,2.5e+09,25,16,62,103
335340000,1117900000,162510000,865280000,18970000,2.5e+09,25,21,63,109
386850000,1830000,11390000,494370000,1605560000,2.5e+09,18,18,56,92
319150000,1600000,4600000,223350000,1951300000,2.5e+09,14,20,48,82
306480000,1920000,6440000,615340000,1569820000,2.5e+09,17,19,58,94
91360000,2880000,3510000,186050000,2216200000,2.5e+09,21,19,56,96
133030000,3450000,7320000,269450000,2086750000,2.5e+09,20,17,56,93
389670000,2990000,17350000,375530000,1714460000,2.5e+09,18,20,53,91
20100000,1990000,1800000,60390000,2371770000,2456050000,22,20,61,103
87980000,2620000,1780000,136250000,2271370000,2.5e+09,22,22,57,101
334490000,4900000,7100000,579030000,1574480000,2.5e+09,22,20,62,104
413290000,218660000,139600000,958100000,770350000,2.5e+09,26,23,66,115
369780000,587390000,92120000,648640000,802070000,2.5e+09,26,24,69,119
522470000,327900000,71790000,408600000,1169240000,2.5e+09,24,26,73,123
213540000,10140000,13560000,255330000,2007430000,2.5e+09,25,19,69,113
616180000,285580000,55510000,443400000,1099330000,2.5e+09,26,25,68,119
291150000,2840000,9720000,252740000,1943550000,2.5e+09,26,23,66,115
131490000,0,3490000,151890000,2213130000,2.5e+09,23,18,58,99
359220000,83220000,20500000,270890000,1766170000,2.5e+09,23,22,68,113
145390000,34300000,22210000,548360000,1749740000,2.5e+09,22,22,68,112
7750000,3280000,2230000,33920000,2248260000,2295440000,14,14,46,74
0,38070000,3070000,2.2e+08,2161480000,2422620000,17,16,52,85
711110000,1279340000,33400000,4710000,471440000,2.5e+09,27,18,68,113
129530000,739350000,41840000,185650000,1399890000,2496260000,32,20,78,130
493660000,1299530000,13120000,23510000,670180000,2.5e+09,34,25,75,134
807600000,1062060000,23650000,71580000,535110000,2.5e+09,32,20,73,125
994020000,711370000,11200000,26800000,756610000,2.5e+09,31,23,74,128
131970000,2088700000,48830000,30870000,199630000,2.5e+09,35,28,83,146
865650000,793500000,114710000,538730000,187410000,2.5e+09,32,23,69,124
949140000,55470000,12930000,607540000,874920000,2.5e+09,29,19,62,110
531340000,1722430000,37100000,82560000,126570000,2.5e+09,27,16,52,95
336210000,1866370000,44430000,241010000,11980000,2.5e+09,22,17,56,95
764230000,1392840000,112940000,184720000,45270000,2.5e+09,23,20,57,100
470920000,1731240000,90780000,113880000,93180000,2.5e+09,25,21,53,99
517270000,1550340000,170310000,236090000,25990000,2.5e+09,28,22,68,118
789830000,1481470000,36500000,154450000,37750000,2.5e+09,25,19,59,103
681520000,1301950000,65870000,16070000,434590000,2.5e+09,29,22,71,122
1840000,266140000,12480000,3240000,1761500000,2045200000,33,24,84,141
563220000,986670000,171650000,8070000,770390000,2.5e+09,26,19,68,113
1126160000,349890000,4110000,132750000,887090000,2.5e+09,33,22,70,125
2.44e+08,1854860000,55290000,10920000,334930000,2.5e+09,33,27,81,141
1721220000,197960000,11780000,130530000,438510000,2.5e+09,32,20,69,121
957550000,948090000,80160000,477100000,37100000,2.5e+09,33,23,67,123
931620000,26290000,11960000,707870000,822260000,2.5e+09,27,15,63,105
732680000,1200480000,69520000,435950000,61370000,2.5e+09,32,22,68,122
884480000,51110000,12670000,435330000,1116410000,2.5e+09,30,15,65,110
153900000,2138810000,98740000,77080000,31470000,2.5e+09,24,19,62,105
167320000,2098450000,51010000,164630000,18590000,2.5e+09,25,17,59,101
421940000,1754020000,144530000,127700000,51810000,2.5e+09,31,20,65,116
157450000,1767660000,496650000,27670000,50570000,2.5e+09,29,22,69,120
1137430000,977240000,55320000,289190000,40820000,2.5e+09,28,19,62,109
484850000,1692100000,80640000,215260000,27150000,2.5e+09,25,18,58,101
1105730000,789050000,73710000,439220000,92290000,2.5e+09,26,18,62,106
1036870000,868640000,44720000,337870000,211900000,2.5e+09,24,16,58,98
716470000,815380000,68290000,870900000,28960000,2.5e+09,24,22,63,109
1114930000,1010740000,89400000,236140000,48790000,2.5e+09,23,17,57,97
793600000,599960000,155520000,905490000,45430000,2.5e+09,28,19,63,110
654540000,1005430000,89090000,732270000,18670000,2.5e+09,26,19,64,109
565280000,1669170000,96820000,135630000,33100000,2.5e+09,29,25,73,127
277820000,1228390000,4.1e+07,916120000,36670000,2.5e+09,32,24,76,132
548580000,1160240000,49630000,627010000,114540000,2.5e+09,32,29,77,138
361210000,931060000,37930000,1148710000,21090000,2.5e+09,29,19,63,111
520100000,1472350000,149730000,314330000,43490000,2.5e+09,27,24,69,120
491950000,1589620000,163760000,190850000,63820000,2.5e+09,28,24,73,125
649440000,1607040000,145300000,55390000,42830000,2.5e+09,31,26,75,132
564230000,1668670000,57140000,193710000,16250000,2.5e+09,29,25,75,129
340400000,171910000,420840000,16590000,1523120000,2472860000,28,21,72,121
1495910000,280100000,39950000,214640000,469400000,2.5e+09,34,22,73,129
1034420000,410180000,28620000,693170000,333610000,2.5e+09,31,21,68,120
1328510000,614660000,238020000,16290000,302520000,2.5e+09,28,21,65,114
1674820000,557190000,57490000,41580000,168920000,2.5e+09,31,24,71,126
1425120000,315340000,181100000,9180000,569260000,2.5e+09,29,21,66,116
699210000,1373170000,84180000,204180000,139260000,2.5e+09,33,20,67,120
1284700000,154460000,29740000,529610000,501490000,2.5e+09,32,20,69,121
515710000,1155830000,84150000,71530000,672780000,2.5e+09,39,22,84,145
682640000,898420000,157970000,105470000,655500000,2.5e+09,38,25,91,154
564530000,1500100000,89600000,310650000,35120000,2.5e+09,28,20,63,111
541690000,1599820000,114280000,210490000,33720000,2.5e+09,30,22,69,121
731760000,1259680000,22700000,408540000,77320000,2.5e+09,27,18,68,113
1481660000,350130000,23840000,417770000,226600000,2.5e+09,28,17,62,107
1013620000,537770000,43130000,866940000,38540000,2.5e+09,25,19,59,103
700850000,1025500000,57090000,632500000,84060000,2.5e+09,26,22,63,111
639070000,467750000,47960000,1270700000,74520000,2.5e+09,26,21,69,116
7.03e+08,737600000,65240000,939280000,54880000,2.5e+09,26,19,64,109
1211450000,313360000,23840000,766950000,184400000,2.5e+09,24,19,64,107
1410360000,250770000,49860000,686980000,102030000,2.5e+09,24,20,64,108
804090000,519320000,40240000,1087760000,48590000,2.5e+09,26,20,69,115
670770000,223410000,32170000,1.508e+09,65650000,2.5e+09,25,19,75,119
339740000,1327600000,75360000,734590000,22710000,2.5e+09,28,24,73,125
458270000,8.59e+08,43740000,1125620000,13370000,2.5e+09,30,22,73,125
472460000,935810000,4.9e+07,1008310000,34420000,2.5e+09,30,26,70,126
353230000,697750000,88560000,1340760000,19700000,2.5e+09,29,21,65,115
1450670000,812020000,84340000,96840000,56130000,2.5e+09,30,25,74,129
772680000,1444500000,104580000,137210000,41030000,2.5e+09,29,23,74,126
715870000,1274080000,82440000,375020000,52590000,2.5e+09,28,26,75,129
433540000,1533630000,111800000,382070000,38960000,2.5e+09,29,25,78,132
43270000,382630000,49220000,5180000,1882080000,2362380000,33,21,77,131
18990000,461990000,106260000,18850000,1615370000,2221460000,33,24,82,139
748800000,1132880000,119810000,93290000,405220000,2.5e+09,37,23,77,137
1215140000,620990000,119360000,134390000,410120000,2.5e+09,33,19,64,116
181810000,675690000,273260000,58870000,1310370000,2.5e+09,35,28,83,146
911590000,516830000,26780000,872370000,172430000,2.5e+09,26,21,69,116
961840000,449860000,29640000,817270000,241390000,2.5e+09,32,21,77,130
827450000,493930000,57540000,965210000,155870000,2.5e+09,30,22,74,126
1486890000,184370000,27660000,297190000,503890000,2.5e+09,28,19,68,115
609670000,1065450000,244060000,529690000,51130000,2.5e+09,30,22,73,125
1054540000,604890000,57780000,686470000,96320000,2.5e+09,30,22,70,122
858520000,401040000,116290000,1027980000,96170000,2.5e+09,35,30,87,152
1132360000,562260000,100530000,642580000,62270000,2.5e+09,32,27,78,137
527640000,643190000,75970000,1193210000,59990000,2.5e+09,26,26,74,126
342880000,953820000,104120000,1061340000,37840000,2.5e+09,26,24,69,119
546480000,417540000,60400000,1448290000,27290000,2.5e+09,27,22,70,119
372200000,387170000,88670000,1627100000,24860000,2.5e+09,29,27,75,131
767680000,1359990000,74110000,286410000,11810000,2.5e+09,21,21,73,115
830650000,802460000,72450000,743930000,50510000,2.5e+09,27,24,76,127
824530000,1164690000,47270000,439550000,23960000,2.5e+09,24,22,71,117
1133620000,216710000,25750000,1083790000,40130000,2.5e+09,24,17,68,109
685490000,1198510000,279240000,31020000,305740000,2.5e+09,33,17,68,118
74270000,993400000,97180000,188850000,1146300000,2.5e+09,35,29,85,149
835800000,1209310000,168580000,47690000,238620000,2.5e+09,33,21,71,125
330160000,666530000,420650000,208060000,874600000,2.5e+09,37,28,84,149
1241600000,546590000,115960000,455220000,140630000,2.5e+09,32,22,72,126
998590000,845720000,159300000,210790000,285600000,2.5e+09,32,20,72,124
1133300000,848930000,99860000,243320000,174590000,2.5e+09,35,24,83,142
1144530000,867030000,32360000,113580000,342500000,2.5e+09,32,19,75,126
414870000,871720000,472680000,689460000,51270000,2.5e+09,31,26,83,140
849420000,788760000,301210000,475610000,8.5e+07,2.5e+09,30,22,71,123
612710000,1217910000,329110000,187590000,152680000,2.5e+09,33,31,97,161
691430000,1321580000,158210000,300820000,27960000,2.5e+09,29,25,80,134
593710000,706560000,182470000,963130000,54130000,2.5e+09,31,24,82,137
668950000,804020000,142250000,849070000,35710000,2.5e+09,33,25,80,138
583440000,1240690000,122670000,512350000,40850000,2.5e+09,28,23,83,134
693850000,1020110000,133240000,554020000,98780000,2.5e+09,32,29,95,156
1069750000,1034570000,34500000,341980000,19200000,2.5e+09,24,19,63,106
790170000,780640000,79390000,810400000,39400000,2.5e+09,27,22,71,120
873390000,1148750000,75230000,374210000,28420000,2.5e+09,27,21,72,120
712680000,1262280000,228100000,206680000,90260000,2.5e+09,31,23,87,141
94730000,35600000,161550000,1330000,1879030000,2172240000,28,17,59,104
1120260000,799420000,69410000,131350000,379560000,2.5e+09,34,20,76,130
1151500000,661670000,224980000,13800000,448050000,2.5e+09,36,20,73,129
1195970000,261440000,51140000,544690000,446760000,2.5e+09,28,22,77,127
1156930000,546160000,22260000,216690000,557960000,2.5e+09,34,21,75,130
1087380000,762680000,182130000,344700000,123110000,2.5e+09,31,25,85,141
1126870000,563680000,261680000,367010000,180760000,2.5e+09,29,22,79,130
1324310000,398270000,77300000,594570000,105550000,2.5e+09,32,25,83,140
1097080000,576280000,288350000,396830000,141460000,2.5e+09,29,26,88,143
973480000,914980000,83370000,478040000,50130000,2.5e+09,28,20,79,127
1092550000,743160000,164050000,464870000,35370000,2.5e+09,31,23,84,138
418530000,1222930000,52240000,795260000,11040000,2.5e+09,25,17,62,104
403310000,1364070000,75570000,647620000,9430000,2.5e+09,26,21,68,115
345260000,1926680000,149140000,64620000,14300000,2.5e+09,26,18,62,106
252770000,2112530000,57450000,61410000,15840000,2.5e+09,23,20,67,110
357620000,1020320000,222460000,752980000,146620000,2.5e+09,28,25,79,132
431130000,980800000,73890000,1004750000,9430000,2.5e+09,24,17,59,100
584670000,1194500000,301440000,348670000,70720000,2.5e+09,27,24,75,126
527480000,1634260000,225940000,86990000,25330000,2.5e+09,22,20,63,105
63180000,705630000,69390000,118430000,1342250000,2298880000,19,20,55,94
296090000,1129620000,121410000,467270000,485610000,2.5e+09,25,20,64,109
278910000,839480000,328920000,953930000,98760000,2.5e+09,27,22,69,118
88480000,202570000,104480000,443510000,1401870000,2240910000,23,19,69,111
99760000,787050000,194610000,233350000,1185230000,2.5e+09,25,21,71,117
60450000,1960910000,223660000,246460000,8520000,2.5e+09,26,19,72,117
64570000,1210400000,603050000,351470000,270510000,2.5e+09,26,24,70,120
61970000,782360000,93820000,146590000,1377970000,2462710000,28,23,76,127
9980000,298230000,50790000,54180000,2047130000,2460310000,21,19,61,101
191190000,1912840000,151360000,184050000,60560000,2.5e+09,29,27,79,135
60010000,615100000,48270000,85640000,1440740000,2249760000,25,24,74,123
115500000,1807610000,182160000,358250000,36480000,2.5e+09,26,20,69,115
582400000,1559040000,297910000,43070000,17580000,2.5e+09,27,23,75,125
426660000,1762880000,206660000,51250000,52550000,2.5e+09,27,25,71,123
795090000,1102670000,501170000,22570000,78500000,2.5e+09,30,27,76,133
437150000,1800920000,132030000,100340000,29560000,2.5e+09,29,20,72,121
349980000,1591790000,153390000,389160000,15680000,2.5e+09,23,16,66,105
641890000,1501060000,250300000,46530000,60220000,2.5e+09,28,21,78,127
137940000,831840000,114180000,214490000,1197640000,2496090000,30,28,86,144
300600000,1767600000,136370000,262550000,32880000,2.5e+09,23,20,67,110
109600000,1778680000,394730000,178820000,38170000,2.5e+09,21,20,69,110
145330000,2086380000,170160000,30730000,67400000,2.5e+09,25,21,75,121
58510000,793100000,122480000,102120000,1409740000,2485950000,29,25,80,134
64990000,2020230000,250500000,150850000,13430000,2.5e+09,27,27,82,136
24440000,345990000,77900000,167070000,1370400000,1985800000,22,20,68,110
406470000,1901560000,95170000,21530000,75270000,2.5e+09,27,26,78,131
649260000,1655660000,117780000,35440000,41860000,2.5e+09,26,22,76,124
217830000,2061840000,113840000,23440000,83050000,2.5e+09,23,23,76,122
788380000,1402180000,101930000,170120000,37390000,2.5e+09,24,24,79,127
743540000,1417980000,171080000,119040000,48360000,2.5e+09,28,25,77,130
552540000,1692020000,109960000,126930000,18550000,2.5e+09,25,19,69,113
324070000,1895270000,145500000,86890000,48270000,2.5e+09,26,21,77,124
504120000,1791320000,110050000,41860000,52650000,2.5e+09,26,19,75,120
216930000,1508320000,482570000,227120000,65060000,2.5e+09,27,25,79,131
142190000,2024170000,173970000,140250000,19420000,2.5e+09,26,21,74,121
388770000,1069500000,437660000,548740000,55330000,2.5e+09,26,22,78,126
478330000,952950000,119250000,934730000,14740000,2.5e+09,28,24,79,131
61750000,1315680000,375150000,207590000,539830000,2.5e+09,30,29,87,146
51660000,1524720000,744210000,155830000,23580000,2.5e+09,25,24,74,123
97840000,1262810000,587530000,123480000,428340000,2.5e+09,30,31,92,153
26330000,102840000,329390000,1.42e+08,1593690000,2194250000,27,26,78,131
49590000,1145740000,236940000,105950000,961780000,2.5e+09,29,32,92,153
701700000,1348660000,93470000,201250000,154920000,2.5e+09,29,27,85,141
1110530000,1166090000,56740000,135010000,31630000,2.5e+09,25,22,71,118
1038580000,1035250000,54560000,316690000,54920000,2.5e+09,27,19,69,115
884940000,840260000,74870000,674940000,24990000,2.5e+09,25,17,63,105
536950000,1263930000,46020000,590270000,62830000,2.5e+09,29,23,84,136
464810000,1630430000,76420000,195640000,132700000,2.5e+09,31,25,87,143
743180000,1054930000,126090000,537940000,37860000,2.5e+09,29,24,82,135
885510000,1119740000,64180000,383510000,47060000,2.5e+09,31,25,81,137
629750000,1170110000,458800000,198600000,42740000,2.5e+09,25,21,71,117
1359770000,402180000,152650000,524580000,60820000,2.5e+09,25,18,81,124
1115020000,673160000,193530000,463360000,54930000,2.5e+09,23,16,69,108
1155170000,692010000,123740000,479170000,49910000,2.5e+09,26,22,70,118
358030000,924580000,750240000,401400000,65750000,2.5e+09,28,23,82,133
487090000,1186940000,478300000,144780000,202890000,2.5e+09,29,30,90,149
240360000,1247180000,765920000,169080000,77460000,2.5e+09,30,24,88,142
40010000,337890000,654130000,1219840000,248130000,2.5e+09,31,26,93,150
210600000,1143490000,487180000,455170000,203560000,2.5e+09,31,31,91,153
7e+08,525300000,385500000,660820000,228380000,2.5e+09,30,34,91,155
282880000,1295390000,462510000,361410000,97810000,2.5e+09,31,29,91,151
14670000,355860000,55010000,117150000,1957310000,2.5e+09,26,28,78,132
72780000,407990000,474650000,698610000,845970000,2.5e+09,28,31,81,140
36720000,134710000,145610000,1339520000,843440000,2.5e+09,29,29,88,146
241260000,917970000,193010000,248650000,899110000,2.5e+09,33,33,97,163
4460000,178220000,30180000,321230000,1964230000,2498320000,27,32,82,141
729790000,810290000,200180000,655390000,104350000,2.5e+09,25,21,75,121
975380000,623670000,82780000,793140000,25030000,2.5e+09,28,18,73,119
108100000,282300000,11920000,15120000,1965040000,2382480000,23,21,67,111
32610000,129250000,46130000,28900000,2191060000,2427950000,24,21,69,114
0,15670000,0,0,1463900000,1479570000,12,16,54,82
759080000,261390000,8320000,37570000,1433640000,2.5e+09,24,23,70,117
349430000,587950000,130200000,95820000,1336600000,2.5e+09,30,28,87,145
660700000,138190000,105210000,2220000,1593680000,2.5e+09,26,19,71,116
513630000,215760000,31280000,8910000,1730420000,2.5e+09,27,21,71,119
609610000,86340000,1100000,9690000,1793260000,2.5e+09,21,21,69,111
1168520000,416040000,206470000,497780000,211190000,2.5e+09,28,23,76,127
695800000,269280000,79280000,4360000,1451280000,2.5e+09,24,22,76,122
193230000,88850000,5670000,4240000,2208010000,2.5e+09,25,20,58,103
553710000,127030000,9510000,440000,1809310000,2.5e+09,21,19,70,110
640000,19720000,550000,2260000,1739640000,1762810000,21,18,62,101
414420000,238640000,149250000,4740000,1692950000,2.5e+09,30,19,69,118
1040180000,493340000,39320000,238870000,688290000,2.5e+09,34,24,78,136
1238490000,549960000,141510000,109440000,460600000,2.5e+09,31,19,67,117
425610000,90270000,14990000,576050000,1393080000,2.5e+09,22,18,66,106
907330000,440130000,42190000,414850000,695500000,2.5e+09,31,21,75,127
1014620000,225930000,87220000,623310000,548920000,2.5e+09,29,20,78,127
1310080000,64310000,6170000,523360000,596080000,2.5e+09,27,19,69,115
751150000,186960000,352150000,154500000,1055240000,2.5e+09,30,18,72,120
1155640000,124580000,44390000,324250000,851140000,2.5e+09,27,15,71,113
69600000,25090000,147830000,11300000,1.646e+09,1899820000,25,16,62,103
832480000,39240000,34400000,451850000,1142030000,2.5e+09,23,17,65,105
636190000,58860000,18780000,492570000,1293600000,2.5e+09,24,18,61,103
660220000,1211800000,305020000,63510000,259450000,2.5e+09,26,25,78,129
913430000,998440000,89230000,81010000,417890000,2.5e+09,25,25,72,122
679890000,72440000,77770000,555090000,1114810000,2.5e+09,27,19,72,118
573650000,56500000,40870000,718080000,1110900000,2.5e+09,24,17,68,109
560470000,129780000,37640000,241310000,1530800000,2.5e+09,26,18,67,111
641600000,281420000,70710000,210930000,1295340000,2.5e+09,22,21,67,110
640210000,1210870000,210020000,209350000,229550000,2.5e+09,32,27,92,151
980110000,217910000,182550000,478370000,641060000,2.5e+09,30,28,84,142
646080000,670430000,177910000,711180000,294400000,2.5e+09,30,23,80,133
595110000,174580000,117290000,602870000,1010150000,2.5e+09,28,22,74,124
1209080000,606010000,236980000,396160000,51770000,2.5e+09,31,21,76,128
983190000,579200000,100330000,747040000,90240000,2.5e+09,27,20,75,122
846320000,1118110000,377750000,104030000,53790000,2.5e+09,32,23,90,145
933110000,992900000,249030000,240080000,84880000,2.5e+09,28,27,87,142
944110000,269240000,55180000,101930000,1129540000,2.5e+09,28,17,64,109
517880000,1795080000,130910000,41300000,14830000,2.5e+09,22,21,59,102
1064310000,1190360000,69110000,94390000,81830000,2.5e+09,24,17,53,94
190850000,2074520000,133470000,5330000,95830000,2.5e+09,27,22,65,114
935320000,478700000,118770000,63370000,903840000,2.5e+09,22,16,56,94
1041540000,82170000,60100000,180050000,1136140000,2.5e+09,24,17,62,103
396060000,1708930000,174090000,59150000,161770000,2.5e+09,28,24,83,135
1110260000,485770000,545500000,30970000,327500000,2.5e+09,29,23,84,136
183600000,1961030000,272590000,4360000,78420000,2.5e+09,26,24,70,120
724880000,182280000,47990000,650160000,894690000,2.5e+09,29,20,74,123
594390000,61630000,58730000,362350000,1422900000,2.5e+09,27,18,69,114
402410000,27610000,25530000,707570000,1336880000,2.5e+09,27,20,66,113
1270130000,78660000,71810000,2.03e+08,876400000,2.5e+09,27,22,80,129
1301920000,503400000,236430000,413480000,44770000,2.5e+09,28,19,79,126
794460000,1120330000,297100000,207770000,80340000,2.5e+09,31,23,77,131
842490000,1061330000,324970000,223770000,47440000,2.5e+09,27,23,81,131
714450000,680780000,325300000,409320000,370150000,2.5e+09,33,25,86,144
6.29e+08,238150000,142810000,13610000,1433430000,2.457e+09,23,23,70,116
597670000,1616530000,86150000,19730000,179920000,2.5e+09,30,25,79,134
1550980000,281200000,42230000,90970000,534620000,2.5e+09,21,18,57,96
243830000,1966070000,144260000,5060000,140780000,2.5e+09,29,23,70,122
1606910000,654120000,22760000,58620000,157590000,2.5e+09,20,16,59,95
1024410000,578300000,506500000,111330000,279460000,2.5e+09,28,23,84,135
34550000,1713660000,627560000,67520000,56710000,2.5e+09,25,22,65,112
1239530000,447660000,231950000,208350000,372510000,2.5e+09,28,22,84,134
37280000,2119880000,290270000,17970000,34600000,2.5e+09,23,24,63,110
690020000,57130000,51870000,790670000,910310000,2.5e+09,27,16,70,113
1031840000,98560000,62750000,309060000,997790000,2.5e+09,29,20,76,125
400140000,8950000,27680000,615840000,1447390000,2.5e+09,27,16,61,104
783390000,121970000,39750000,312080000,1242810000,2.5e+09,28,21,76,125
480140000,921750000,293630000,298340000,506140000,2.5e+09,29,24,88,141
878650000,236710000,177340000,878080000,329220000,2.5e+09,29,22,78,129
798640000,60840000,166370000,1402310000,71840000,2.5e+09,33,24,81,138
853310000,27900000,105900000,949500000,563390000,2.5e+09,29,20,63,112
501390000,542470000,48050000,35740000,1372350000,2.5e+09,21,19,54,94
1216750000,996140000,34010000,125340000,127760000,2.5e+09,22,14,53,89
409460000,1089130000,34230000,41680000,925500000,2.5e+09,26,19,63,108
1541900000,612110000,143750000,70700000,131540000,2.5e+09,31,27,79,137
536460000,1284280000,192190000,18610000,468460000,2.5e+09,26,27,63,116
1343560000,826630000,179890000,50340000,99580000,2.5e+09,26,23,62,111
893740000,1404890000,127550000,20650000,53170000,2.5e+09,23,16,56,95
44820000,2109150000,230960000,1980000,113090000,2.5e+09,25,24,64,113
803680000,1391890000,117390000,36230000,150810000,2.5e+09,24,23,68,115
18500000,2292360000,123270000,290000,65580000,2.5e+09,25,18,64,107
483710000,1619160000,226820000,40020000,130290000,2.5e+09,29,22,74,125
1428450000,266610000,66760000,194930000,543250000,2.5e+09,25,19,71,115
94710000,1807480000,287090000,66250000,244470000,2.5e+09,29,24,70,123
1412780000,471920000,150930000,308240000,156130000,2.5e+09,25,19,75,119
216350000,1928740000,293880000,32100000,28930000,2.5e+09,24,19,58,101
551600000,83850000,17380000,380760000,1466410000,2.5e+09,26,18,71,115
1087540000,200940000,46720000,388230000,776570000,2.5e+09,25,21,73,119
1528790000,402640000,104810000,117480000,346280000,2.5e+09,27,20,76,123
986300000,3360000,98690000,1140540000,271110000,2.5e+09,30,21,75,126
841060000,2.1e+07,79390000,684330000,874220000,2.5e+09,27,14,62,103
1280930000,11660000,78960000,668090000,460360000,2.5e+09,30,23,78,131
850970000,74050000,122150000,562270000,890560000,2.5e+09,28,17,68,113
204720000,872360000,38150000,43350000,1256580000,2415160000,25,18,66,109
575720000,1643750000,53900000,102440000,124190000,2.5e+09,23,21,60,104
728890000,1435370000,23080000,150140000,162520000,2.5e+09,25,21,60,106
1473480000,824930000,32540000,38630000,130420000,2.5e+09,25,14,53,92
1292470000,924620000,81160000,65730000,136020000,2.5e+09,28,20,63,111
9930000,2292730000,143100000,60000,54180000,2.5e+09,20,20,57,97
67570000,2184610000,119070000,21630000,107120000,2.5e+09,26,25,70,121
828810000,1162140000,271950000,186950000,50150000,2.5e+09,26,19,75,120
116080000,2033440000,333240000,1010000,16230000,2.5e+09,22,18,48,88
1175420000,81250000,31650000,404920000,806760000,2.5e+09,25,17,68,110
1394590000,207740000,59530000,267080000,571060000,2.5e+09,28,20,74,122
1415590000,43110000,135640000,717110000,188550000,2.5e+09,30,24,78,132
680840000,14600000,58560000,783460000,962540000,2.5e+09,22,14,56,92
1074340000,252850000,106630000,1006450000,59730000,2.5e+09,23,18,73,114
969480000,745490000,192550000,563080000,29400000,2.5e+09,23,17,67,107
1156350000,752920000,208610000,324090000,58030000,2.5e+09,24,19,69,112
1264620000,588790000,125410000,478070000,43110000,2.5e+09,22,16,65,103
276810000,1327810000,654140000,142820000,98420000,2.5e+09,28,25,83,136
640730000,958310000,390170000,351510000,159280000,2.5e+09,26,27,83,136
692870000,252330000,745040000,740290000,69470000,2.5e+09,25,22,72,119
793160000,413980000,606950000,631350000,54560000,2.5e+09,24,23,78,125
214440000,1127880000,217020000,903460000,37200000,2.5e+09,29,31,94,154
283850000,1175320000,380810000,538030000,121990000,2.5e+09,29,28,83,140
255720000,1658200000,295060000,271940000,19080000,2.5e+09,28,23,76,127
446520000,934250000,845020000,232050000,42160000,2.5e+09,26,20,75,121
263940000,715570000,218310000,1138680000,163500000,2.5e+09,30,34,95,159
205840000,610980000,229380000,1333910000,119890000,2.5e+09,30,33,93,156
166910000,1707590000,2.24e+08,327800000,73700000,2.5e+09,32,28,85,145
365600000,1534670000,191840000,298550000,109340000,2.5e+09,27,25,83,135
15230000,436570000,71790000,567370000,1409040000,2.5e+09,31,32,93,156
22180000,601810000,157140000,759490000,959380000,2.5e+09,30,28,84,142
964370000,806040000,130130000,532050000,67410000,2.5e+09,29,26,80,135
1468510000,411360000,163830000,407130000,49170000,2.5e+09,25,18,68,111
1327370000,752710000,184180000,180160000,55580000,2.5e+09,25,21,76,122
1067810000,1.002e+09,217170000,159120000,53900000,2.5e+09,30,23,86,139
806860000,855670000,302640000,455840000,78990000,2.5e+09,29,24,78,131
467430000,1280980000,202040000,499250000,50300000,2.5e+09,31,24,82,137
956170000,459100000,368280000,695720000,20730000,2.5e+09,21,19,66,106
922820000,792310000,201790000,563810000,19270000,2.5e+09,27,20,78,125
1136900000,647150000,220770000,450160000,45020000,2.5e+09,23,18,70,111
683540000,1293670000,275910000,190220000,56660000,2.5e+09,27,24,74,125
859130000,905500000,428680000,288310000,18380000,2.5e+09,29,28,84,141
789370000,822960000,483990000,338400000,65280000,2.5e+09,29,25,83,137
1288110000,140890000,265990000,562300000,242710000,2.5e+09,23,18,66,107
1264570000,62770000,303670000,796880000,72110000,2.5e+09,21,22,72,115
1222410000,375670000,119380000,653880000,128660000,2.5e+09,22,19,72,113
1125080000,523750000,224270000,585820000,41080000,2.5e+09,24,21,79,124
318550000,1485600000,331360000,343360000,21130000,2.5e+09,30,19,80,129
264370000,1628380000,342490000,236660000,28100000,2.5e+09,28,20,78,126
354230000,1293010000,527320000,299370000,26070000,2.5e+09,25,23,82,130
661100000,1125350000,259300000,390500000,63750000,2.5e+09,29,20,76,125
269150000,1348830000,247130000,533400000,101490000,2.5e+09,27,24,86,137
303880000,1820060000,129390000,220410000,26260000,2.5e+09,29,27,83,139
232610000,1069780000,392860000,765310000,39440000,2.5e+09,28,25,84,137
212030000,1713210000,112200000,335260000,127300000,2.5e+09,28,26,83,137
127890000,505330000,191240000,1326470000,349070000,2.5e+09,29,28,79,136
28320000,298730000,56270000,264680000,1.852e+09,2.5e+09,29,31,84,144
204620000,470980000,159850000,1287030000,377520000,2.5e+09,29,29,85,143
35070000,631080000,76390000,335360000,1422100000,2.5e+09,31,32,91,154
32010000,4790000,18570000,14850000,1437070000,1507290000,27,21,59,107
180130000,1746720000,95580000,57850000,419720000,2.5e+09,31,30,83,144
39690000,967930000,79390000,51850000,1361140000,2.5e+09,30,29,82,141
1029850000,810560000,321840000,224810000,112940000,2.5e+09,29,23,86,138
1351690000,405250000,170490000,557340000,15230000,2.5e+09,28,21,73,122
1238160000,675910000,205930000,339360000,40640000,2.5e+09,27,17,72,116
1080860000,450890000,227300000,717820000,23130000,2.5e+09,24,20,68,112
1300710000,713230000,2.2e+08,253590000,12470000,2.5e+09,22,21,71,114
1127600000,877270000,261180000,157040000,76910000,2.5e+09,26,23,89,138
883170000,812090000,492860000,237460000,74420000,2.5e+09,28,26,89,143
1004760000,918320000,367050000,178260000,31610000,2.5e+09,25,22,81,128
1211980000,368600000,148410000,737320000,33690000,2.5e+09,21,17,77,115
1407410000,542010000,217560000,302100000,30920000,2.5e+09,25,19,69,113
1085970000,742850000,117660000,539460000,14060000,2.5e+09,24,19,76,119
566870000,1534910000,234390000,139690000,24140000,2.5e+09,27,21,78,126
955100000,922870000,270380000,305810000,45840000,2.5e+09,23,23,78,124
1059450000,707110000,122080000,576890000,34470000,2.5e+09,22,17,69,108
974220000,963370000,124890000,420620000,16900000,2.5e+09,24,21,80,125
1001140000,600140000,164640000,715380000,18700000,2.5e+09,24,25,78,127
749020000,1307250000,241040000,178630000,24060000,2.5e+09,26,22,75,123
984680000,1010610000,139350000,341820000,23540000,2.5e+09,23,22,72,117
532150000,1502560000,312100000,114920000,38270000,2.5e+09,28,24,83,135
908530000,1112960000,194900000,253160000,30450000,2.5e+09,25,26,78,129
476110000,1209880000,168500000,626410000,19100000,2.5e+09,28,23,81,132
530840000,1250530000,246550000,382440000,89640000,2.5e+09,27,27,90,144
1231720000,754020000,125310000,231510000,157440000,2.5e+09,27,25,80,132
887240000,1007720000,265220000,286990000,52830000,2.5e+09,29,29,86,144
160830000,942900000,156250000,1050920000,189100000,2.5e+09,29,26,87,142
257620000,1150380000,197980000,799670000,94350000,2.5e+09,31,29,85,145
340200000,1237640000,229590000,619450000,73120000,2.5e+09,28,23,86,137
456670000,738670000,752670000,461030000,90960000,2.5e+09,31,28,87,146
147200000,1516480000,140270000,439530000,256520000,2.5e+09,30,26,79,135
152640000,1039260000,167320000,1012260000,128520000,2.5e+09,32,27,88,147
31540000,505340000,45350000,51810000,1865960000,2.5e+09,30,26,82,138
172310000,980360000,179390000,392610000,775330000,2.5e+09,30,31,86,147
198830000,1818670000,196930000,33910000,251660000,2.5e+09,30,27,74,131
90200000,1672980000,132900000,20120000,583800000,2.5e+09,29,28,79,136
71080000,758850000,74570000,10100000,1585400000,2.5e+09,27,28,78,133
924050000,726400000,366640000,474530000,8380000,2.5e+09,23,17,75,115
894270000,895140000,133560000,519870000,57160000,2.5e+09,26,23,79,128
794200000,1063030000,262100000,346240000,34430000,2.5e+09,29,22,83,134
674350000,822520000,189990000,757470000,55670000,2.5e+09,25,24,77,126
990520000,1126850000,149040000,219840000,13750000,2.5e+09,22,17,68,107
796390000,1030520000,420250000,229580000,23260000,2.5e+09,25,20,70,115
556370000,1586080000,83140000,260290000,14120000,2.5e+09,25,17,68,110
923410000,705260000,187450000,668230000,15650000,2.5e+09,24,18,74,116
987320000,972950000,128820000,402230000,8680000,2.5e+09,27,22,83,132
1003420000,974470000,167250000,337830000,17030000,2.5e+09,32,24,85,141
1110350000,680680000,133220000,518950000,56800000,2.5e+09,24,19,74,117
1104810000,694970000,104220000,575650000,20350000,2.5e+09,27,24,77,128
397850000,1757560000,165610000,149610000,29370000,2.5e+09,27,25,82,134
1170090000,648810000,237330000,412740000,31030000,2.5e+09,25,22,79,126
327990000,1832170000,156090000,137870000,45880000,2.5e+09,26,31,85,142
1052370000,896820000,159100000,363010000,28700000,2.5e+09,25,21,81,127
387090000,1676860000,232130000,166010000,37910000,2.5e+09,28,24,80,132
1304160000,748530000,153380000,220870000,73060000,2.5e+09,26,27,83,136
248220000,1736240000,268990000,181130000,65420000,2.5e+09,27,27,91,145
261390000,1836180000,224500000,115410000,62520000,2.5e+09,28,28,92,148
777340000,1308020000,92100000,306860000,15680000,2.5e+09,27,25,85,137
676480000,1190880000,161200000,445360000,26080000,2.5e+09,27,26,86,139
682640000,1116580000,75310000,578670000,46800000,2.5e+09,29,27,92,148
733430000,1157540000,85840000,405310000,117880000,2.5e+09,29,29,90,148
214660000,1254410000,173850000,284510000,572570000,2.5e+09,28,29,88,145
642520000,1178310000,97820000,514300000,67050000,2.5e+09,30,28,90,148
323390000,1351510000,83310000,301590000,440200000,2.5e+09,30,30,91,151
694180000,1147540000,127850000,451490000,78940000,2.5e+09,28,25,85,138
98180000,671680000,53850000,152110000,1524180000,2.5e+09,31,28,84,143
13100000,72780000,13820000,20370000,2379930000,2.5e+09,24,24,64,112
649260000,1215730000,263580000,309080000,62350000,2.5e+09,27,20,75,122
620120000,678750000,190940000,959390000,50800000,2.5e+09,28,22,81,131
507820000,1505190000,166580000,301020000,19390000,2.5e+09,26,19,74,119
777180000,541720000,491770000,534260000,155070000,2.5e+09,29,25,87,141
752940000,1057330000,260910000,421650000,7170000,2.5e+09,26,19,74,119
747380000,1133410000,121080000,451250000,46880000,2.5e+09,29,25,84,138
1098130000,715280000,153030000,519700000,13860000,2.5e+09,27,21,79,127
907070000,1189870000,161340000,211980000,29740000,2.5e+09,30,21,86,137
416480000,1641940000,175160000,243050000,23370000,2.5e+09,28,24,79,131
762960000,633690000,189110000,864560000,49680000,2.5e+09,28,23,81,132
1262090000,118760000,10770000,210000,1108170000,2.5e+09,27,23,66,116
308070000,63710000,15930000,0,1726890000,2114600000,28,27,71,126
210500000,26710000,7900000,590000,2254300000,2.5e+09,23,17,58,98
265160000,30460000,4220000,3e+05,2199860000,2.5e+09,19,12,52,83
383690000,1.9e+07,5950000,0,2091360000,2.5e+09,16,16,53,85
606570000,70190000,6670000,0,1816570000,2.5e+09,25,20,63,108
670290000,110220000,13100000,970000,1705420000,2.5e+09,21,12,57,90
718380000,129570000,8820000,0,1643230000,2.5e+09,19,14,55,88
43040000,83950000,4180000,0,2174740000,2305910000,13,16,48,77
652630000,147160000,48140000,1530000,1650540000,2.5e+09,20,17,61,98
8020000,68250000,24080000,15620000,1396730000,1512700000,23,23,64,110
105770000,1436530000,84230000,25020000,848450000,2.5e+09,30,29,76,135
222050000,1818210000,110470000,10710000,338560000,2.5e+09,28,25,72,125
1968860000,135570000,23380000,0,372190000,2.5e+09,25,23,69,117
566180000,51510000,61260000,0,1585830000,2264780000,24,23,71,118
1381980000,114950000,56420000,0,946650000,2.5e+09,28,24,80,132
38630000,5380000,880000,0,1054060000,1098950000,14,13,44,71
1128660000,35670000,7160000,0,1328510000,2.5e+09,20,16,51,87
1078440000,23910000,5880000,0,1391770000,2.5e+09,19,14,50,83
1724200000,57340000,7140000,0,711320000,2.5e+09,23,18,62,103
1982860000,30920000,9490000,0,476730000,2.5e+09,21,16,62,99
567120000,22190000,13320000,0,1897370000,2.5e+09,21,17,54,92
1146720000,51540000,20790000,0,1280950000,2.5e+09,23,18,63,104
583630000,46890000,6620000,270000,1862590000,2.5e+09,17,17,57,91
400680000,82100000,15480000,0,2001740000,2.5e+09,18,20,52,90
1077190000,127230000,33570000,3900000,1258110000,2.5e+09,25,21,64,110
429670000,98220000,2750000,1810000,1967550000,2.5e+09,20,13,57,90
688480000,271630000,28330000,0,1511560000,2.5e+09,27,18,68,113
617480000,99070000,8050000,450000,1774950000,2.5e+09,23,18,63,104
826390000,146600000,5240000,3e+05,1521470000,2.5e+09,29,21,71,121
272410000,50790000,7450000,0,2169350000,2.5e+09,19,14,49,82
551760000,95740000,1220000,0,1851280000,2.5e+09,23,21,74,118
152900000,1703390000,1.11e+08,115890000,416820000,2.5e+09,29,29,74,132
4.34e+08,1621480000,139720000,26720000,278080000,2.5e+09,27,25,76,128
200640000,1324940000,107960000,23150000,843310000,2.5e+09,29,26,76,131
192750000,1326190000,227250000,30820000,722990000,2.5e+09,29,28,75,132
100920000,1144010000,79320000,62250000,1113500000,2.5e+09,29,28,84,141
109420000,1193370000,152640000,64070000,980500000,2.5e+09,28,30,79,137
24420000,910000,220000,0,1034740000,1060290000,12,10,29,51
1842920000,221370000,68390000,1060000,366260000,2.5e+09,30,25,72,127
1145350000,61760000,38070000,0,1242630000,2487810000,29,26,76,131
776810000,552920000,147630000,0,1022640000,2.5e+09,32,28,84,144
76930000,72320000,33750000,0,1678640000,1861640000,23,21,62,106
1705560000,96110000,19090000,440000,678800000,2.5e+09,22,19,51,92
1823960000,176220000,42540000,0,457280000,2.5e+09,31,24,72,127
1576720000,328880000,40700000,0,553700000,2.5e+09,27,27,75,129
1293810000,383590000,277430000,420000,544750000,2.5e+09,29,27,80,136
985690000,138840000,19650000,0,1355820000,2.5e+09,21,22,58,101
1466770000,93490000,16950000,0,922790000,2.5e+09,23,18,53,94
1186140000,360780000,60470000,2820000,889790000,2.5e+09,29,31,77,137
1270100000,361550000,30720000,1030000,836600000,2.5e+09,28,23,70,121
562990000,116090000,7950000,1e+06,1811970000,2.5e+09,27,20,61,108
1105580000,138590000,16210000,1750000,1237870000,2.5e+09,30,20,72,122
1054430000,116720000,24840000,870000,1303140000,2.5e+09,22,21,63,106
650470000,152580000,5290000,0,1691660000,2.5e+09,29,24,69,122
367460000,87210000,7660000,610000,2037060000,2.5e+09,27,22,65,114
769750000,151120000,3890000,0,1575240000,2.5e+09,30,21,68,119
708870000,102100000,3420000,0,1685610000,2.5e+09,25,27,65,117
169700000,181010000,10090000,0,2139200000,2.5e+09,27,21,68,116
884890000,234800000,11720000,0,1368590000,2.5e+09,31,26,78,135
803980000,194620000,3140000,0,1498260000,2.5e+09,26,22,68,116
802550000,370130000,97770000,0,1229550000,2.5e+09,30,26,82,138
47800000,212970000,20040000,3980000,1939440000,2224230000,23,17,63,103
56380000,196370000,29440000,6790000,2174730000,2463710000,23,22,69,114
1106740000,416820000,70640000,22740000,883060000,2.5e+09,33,33,85,151
497720000,269980000,102170000,36570000,1580390000,2486830000,32,32,83,147
1310580000,600840000,129060000,0,459520000,2.5e+09,30,29,83,142
892930000,204960000,26980000,12950000,1362180000,2.5e+09,31,29,76,136
1827770000,156840000,10080000,2e+06,503310000,2.5e+09,26,22,67,115
1792380000,3.44e+08,19090000,3910000,340620000,2.5e+09,28,25,67,120
1.282e+09,702750000,83350000,1020000,430880000,2.5e+09,27,26,72,125
1485930000,572130000,62300000,0,379640000,2.5e+09,30,27,79,136
1403140000,115130000,24880000,1350000,955500000,2.5e+09,28,26,71,125
1273730000,404060000,31780000,0,790430000,2.5e+09,32,26,79,137
984550000,39410000,1030000,0,1475010000,2.5e+09,27,23,62,112
1484930000,29750000,10240000,0,975080000,2.5e+09,25,18,64,107
552550000,90260000,1820000,0,1855370000,2.5e+09,27,23,57,107
950920000,115990000,7810000,0,1425280000,2.5e+09,26,23,65,114
629070000,489730000,19630000,0,1361570000,2.5e+09,34,27,79,140
624900000,147020000,6550000,420000,1721110000,2.5e+09,32,22,70,124
53310000,14980000,0,0,2377420000,2445710000,12,13,47,72
448360000,49270000,0,0,2002370000,2.5e+09,20,20,66,106
734460000,173720000,11020000,0,1580800000,2.5e+09,19,19,60,98
1089910000,229300000,10880000,0,1169910000,2.5e+09,28,20,68,116
242530000,53230000,0,0,2204240000,2.5e+09,12,16,51,79
340980000,414640000,54310000,45180000,1643620000,2498730000,22,17,54,93
541710000,336020000,29580000,22640000,1403850000,2333800000,17,11,44,72
265500000,255450000,15930000,11450000,1687430000,2235760000,17,14,40,71
1045640000,415830000,37670000,100630000,900230000,2.5e+09,20,16,56,92
784890000,791750000,51330000,20620000,851410000,2.5e+09,15,9,41,65
827240000,1193430000,71370000,19080000,388880000,2.5e+09,27,23,57,107
1353660000,783320000,99070000,20700000,243250000,2.5e+09,22,18,54,94
193080000,1060360000,52140000,14350000,1180070000,2.5e+09,21,14,56,91
451610000,1765220000,111150000,1.8e+07,154020000,2.5e+09,22,18,60,100
69130000,700600000,393590000,12720000,1283050000,2459090000,23,17,58,98
705190000,1410250000,129390000,9080000,246090000,2.5e+09,23,19,55,97
725910000,1592440000,58020000,17420000,106210000,2.5e+09,20,18,54,92
481230000,1564240000,129520000,35880000,289130000,2.5e+09,27,23,59,109
1238460000,892460000,39070000,125720000,204290000,2.5e+09,22,15,54,91
18440000,345760000,21200000,320000,1915060000,2300780000,26,25,69,120
36860000,1199530000,94920000,0,1168690000,2.5e+09,27,26,71,124
348410000,1740180000,315900000,37500000,58010000,2.5e+09,25,20,72,117
8390000,1114030000,258070000,1880000,1117630000,2.5e+09,25,22,62,109
74290000,764520000,77670000,14070000,1484040000,2414590000,14,15,48,77
352620000,745790000,51070000,9750000,1340770000,2.5e+09,15,15,45,75
1163150000,997550000,58890000,48820000,231590000,2.5e+09,22,20,56,98
584210000,1469330000,210950000,17120000,218390000,2.5e+09,21,18,52,91
616170000,694140000,70500000,633840000,485350000,2.5e+09,25,16,58,99
1004160000,977020000,80360000,91600000,346860000,2.5e+09,23,15,58,96
907690000,1164570000,73230000,147880000,206630000,2.5e+09,23,19,58,100
1231250000,798090000,55670000,159460000,255530000,2.5e+09,22,17,58,97
337490000,1799530000,96990000,85730000,180260000,2.5e+09,25,17,58,100
1137290000,689480000,43030000,297440000,332760000,2.5e+09,22,14,59,95
41310000,724320000,110560000,1530000,1404020000,2281740000,22,17,53,92
648860000,1510710000,75150000,69990000,195290000,2.5e+09,24,18,60,102
35690000,2026440000,276270000,7530000,154070000,2.5e+09,31,24,73,128
267740000,1101210000,200230000,9870000,920950000,2.5e+09,37,27,86,150
159640000,282030000,49660000,7450000,1665710000,2164490000,28,22,66,116
1344560000,71200000,51680000,535560000,4.97e+08,2.5e+09,27,16,59,102
1329850000,515690000,79200000,112730000,462530000,2.5e+09,32,22,81,135
1524580000,183190000,88550000,406870000,296810000,2.5e+09,29,22,67,118
1332070000,547030000,121230000,98150000,401520000,2.5e+09,29,23,78,130
1447230000,15280000,135340000,598970000,303180000,2.5e+09,29,19,67,115
720170000,10860000,61610000,946830000,760530000,2.5e+09,25,19,62,106
1413060000,16730000,141730000,465140000,463340000,2.5e+09,28,22,69,119
991320000,7930000,91670000,795100000,613980000,2.5e+09,25,18,59,102
45920000,220230000,35270000,5250000,1867180000,2173850000,19,14,40,73
750580000,1299360000,87460000,101500000,261100000,2.5e+09,25,20,62,107
762160000,1177710000,297320000,44430000,218380000,2.5e+09,20,14,56,90
473080000,1431420000,86440000,111540000,397520000,2.5e+09,25,17,61,103
1219970000,496620000,24570000,402750000,356090000,2.5e+09,23,15,57,95
52680000,710660000,44890000,9320000,1465770000,2283320000,19,15,53,87
505630000,1741450000,34510000,56080000,162330000,2.5e+09,22,18,61,101
13540000,180320000,25780000,0,1330820000,1550460000,16,13,39,68
57550000,890800000,87610000,0,1271430000,2307390000,19,12,38,69
418830000,125340000,36500000,178100000,1741230000,2.5e+09,22,17,63,102
1532740000,485950000,89130000,162760000,229420000,2.5e+09,37,25,89,151
1369870000,543220000,57640000,146540000,382730000,2.5e+09,37,26,90,153
1635300000,494930000,71910000,214790000,83070000,2.5e+09,35,29,90,154
1801770000,80300000,86930000,89350000,441650000,2.5e+09,26,21,71,118
1465620000,333710000,166610000,345690000,188370000,2.5e+09,30,21,75,126
1675880000,317490000,49340000,132090000,325200000,2.5e+09,28,21,77,126
1373870000,623800000,110880000,313620000,77830000,2.5e+09,30,22,72,124
1585150000,477370000,107310000,166300000,163870000,2.5e+09,33,26,83,142
1411150000,18600000,71150000,329450000,669650000,2.5e+09,29,20,63,112
1251960000,53590000,43800000,788480000,362170000,2.5e+09,28,16,54,98
1759600000,10470000,45840000,317860000,366230000,2.5e+09,28,19,67,114
1535670000,154350000,78890000,536020000,195070000,2.5e+09,30,20,66,116
980560000,1079210000,53530000,122880000,263820000,2.5e+09,24,19,61,104
1121870000,911160000,41370000,152830000,272770000,2.5e+09,23,18,61,102
236810000,2124850000,52930000,38050000,47360000,2.5e+09,17,14,47,78
771090000,1371290000,50660000,109410000,197550000,2.5e+09,24,19,59,102
8550000,1999790000,49610000,40410000,401640000,2.5e+09,18,20,54,92
379330000,1964080000,37640000,40600000,78350000,2.5e+09,18,16,49,83
65220000,1748290000,28860000,41830000,615800000,2.5e+09,16,16,58,90
546460000,560720000,38990000,163820000,1190010000,2.5e+09,19,20,56,95
113990000,485980000,130800000,228190000,1541040000,2.5e+09,22,18,60,100
380550000,545860000,31230000,661690000,880670000,2.5e+09,27,19,59,105
1661730000,334760000,15690000,174290000,313530000,2.5e+09,22,18,55,95
1368060000,903600000,53030000,101050000,74260000,2.5e+09,30,24,80,134
1461750000,628480000,45470000,101590000,262710000,2.5e+09,26,20,72,118
699520000,1130120000,305550000,167510000,197300000,2.5e+09,28,22,72,122
1.002e+09,939930000,21770000,167630000,368670000,2.5e+09,21,21,60,102
1406180000,660310000,119620000,271220000,42670000,2.5e+09,30,24,75,129
1269430000,894900000,81810000,221820000,32040000,2.5e+09,32,26,79,137
784740000,1514270000,112630000,54830000,33530000,2.5e+09,28,24,85,137
854970000,1263790000,79340000,174720000,127180000,2.5e+09,30,28,89,147
1879650000,44750000,69890000,276700000,229010000,2.5e+09,28,19,60,107
1481500000,364600000,235820000,383290000,34790000,2.5e+09,30,21,69,120
1536440000,544800000,145670000,220140000,52950000,2.5e+09,27,21,68,116
996100000,1290410000,142480000,62460000,8550000,2.5e+09,27,21,79,127
378680000,1706240000,3e+07,40190000,344890000,2.5e+09,21,16,64,101
62630000,780800000,102810000,42720000,1495680000,2484640000,16,12,47,75
132650000,1940250000,59080000,287680000,80340000,2.5e+09,18,17,48,83
195530000,1873440000,115170000,18810000,297050000,2.5e+09,13,13,49,75
406370000,248240000,29870000,30680000,1784840000,2.5e+09,21,16,53,90
558110000,457040000,114500000,301710000,1068640000,2.5e+09,26,18,59,103
1199030000,954200000,28800000,193230000,124740000,2.5e+09,22,19,59,100
1677690000,270440000,7880000,379890000,164100000,2.5e+09,22,13,47,82
978130000,1363680000,51840000,33150000,73200000,2.5e+09,24,18,72,114
704170000,1361440000,74070000,110240000,250080000,2.5e+09,24,19,63,106
796040000,983290000,76750000,220410000,423510000,2.5e+09,25,23,72,120
857100000,1228190000,71400000,145310000,1.98e+08,2.5e+09,27,20,71,118
1102070000,888360000,51180000,150590000,307800000,2.5e+09,26,22,67,115
1001090000,1081520000,116560000,163230000,137600000,2.5e+09,29,24,75,128
656820000,1352140000,144250000,152160000,194630000,2.5e+09,26,20,75,121
648140000,964160000,139750000,313980000,433970000,2.5e+09,31,29,84,144
834930000,1123650000,80810000,110460000,350150000,2.5e+09,26,19,78,123
634850000,1333050000,163870000,114080000,254150000,2.5e+09,32,32,93,157
737350000,1478290000,139870000,77180000,67310000,2.5e+09,28,23,75,126
355140000,1678380000,172830000,162930000,130720000,2.5e+09,30,28,84,142
627450000,1.349e+09,121990000,215160000,186400000,2.5e+09,27,19,73,119
628980000,1251470000,223850000,274390000,121310000,2.5e+09,28,33,92,153
276940000,579830000,50820000,114860000,1477550000,2.5e+09,30,25,73,128
1013320000,310780000,34580000,267030000,874290000,2.5e+09,27,19,69,115
967500000,1308240000,25430000,116150000,82680000,2.5e+09,18,17,47,82
1521030000,537750000,27820000,319280000,94120000,2.5e+09,18,11,50,79
643310000,1448220000,52280000,110750000,245440000,2.5e+09,26,25,68,119
1077270000,1059650000,78300000,73830000,210950000,2.5e+09,26,25,72,123
440600000,1598380000,113580000,68450000,278990000,2.5e+09,26,27,77,130
780220000,1278020000,151170000,139890000,150700000,2.5e+09,23,20,72,115
402720000,1702470000,173320000,94070000,127420000,2.5e+09,28,27,86,141
727620000,924260000,161810000,337010000,349300000,2.5e+09,28,26,78,132
291110000,426020000,78160000,181760000,1522950000,2.5e+09,28,26,81,135
234220000,1016020000,66980000,251550000,931230000,2.5e+09,31,34,92,157
77750000,1121030000,276850000,69060000,955310000,2.5e+09,30,32,86,148
2570000,343850000,46670000,15600000,1694590000,2103280000,27,23,66,116
481590000,1598240000,97330000,309780000,13060000,2.5e+09,25,20,72,117
644060000,840360000,158080000,715590000,141910000,2.5e+09,31,25,82,138
563470000,1282630000,155610000,450880000,47410000,2.5e+09,27,23,77,127
783720000,910570000,196660000,529440000,79610000,2.5e+09,28,22,79,129
1124670000,677650000,90300000,579560000,27820000,2.5e+09,34,28,86,148
651060000,1225110000,132490000,448250000,43090000,2.5e+09,32,24,85,141
824080000,1070640000,76490000,506610000,22180000,2.5e+09,28,22,82,132
1414200000,109140000,78290000,708420000,189950000,2.5e+09,26,22,71,119
1249270000,505120000,160970000,437120000,147520000,2.5e+09,30,29,87,146
1130730000,681330000,97800000,535140000,5.5e+07,2.5e+09,28,31,84,143
739140000,909360000,103810000,4.51e+08,296690000,2.5e+09,30,28,94,152
921180000,1188830000,137800000,206930000,45260000,2.5e+09,27,25,84,136
449400000,1293200000,345270000,380320000,31810000,2.5e+09,26,25,88,139
309600000,1728750000,188070000,230870000,42710000,2.5e+09,26,25,87,138
745250000,855620000,269260000,520750000,109120000,2.5e+09,24,26,80,130
1084270000,932670000,95150000,317540000,70370000,2.5e+09,26,24,83,133
1032440000,852640000,157070000,347950000,109900000,2.5e+09,27,25,88,140
849860000,1131160000,114940000,355210000,48830000,2.5e+09,27,28,90,145
1182250000,680050000,105180000,389880000,142640000,2.5e+09,27,25,87,139
582900000,587070000,840320000,359670000,130040000,2.5e+09,28,28,91,147
369660000,1428180000,124160000,501650000,76350000,2.5e+09,28,27,83,138
643140000,1134480000,66900000,367080000,288400000,2.5e+09,27,28,85,140
309990000,1563920000,86290000,429220000,110580000,2.5e+09,30,31,86,147
807070000,1081140000,84810000,350790000,176190000,2.5e+09,28,30,86,144
90440000,105480000,25620000,63860000,2023800000,2309200000,26,25,71,122
435700000,836690000,51520000,104720000,1071370000,2.5e+09,32,31,86,149
18410000,399790000,28680000,23750000,1371050000,1841680000,24,23,68,115
975490000,722320000,125220000,600110000,76860000,2.5e+09,25,22,77,124
582280000,1428500000,286750000,162980000,39490000,2.5e+09,32,24,79,135
1211520000,864940000,84330000,310830000,28380000,2.5e+09,25,20,75,120
839790000,1068090000,171150000,377720000,43250000,2.5e+09,29,23,79,131
766350000,1287300000,85420000,299080000,61850000,2.5e+09,32,30,94,156
1156960000,594180000,42400000,563440000,143020000,2.5e+09,36,33,95,164
707480000,1432960000,95860000,221670000,42030000,2.5e+09,29,25,87,141
948640000,915730000,135360000,364810000,135460000,2.5e+09,34,33,96,163
416980000,1791730000,188510000,49900000,52880000,2.5e+09,29,27,91,147
1144790000,968020000,171190000,177370000,38630000,2.5e+09,29,26,87,142
525890000,1606570000,267310000,44140000,56090000,2.5e+09,29,25,89,143
687550000,1273670000,367290000,128200000,43290000,2.5e+09,28,23,88,139
816030000,933170000,323680000,363760000,63360000,2.5e+09,25,27,89,141
1021450000,637360000,221760000,493080000,126350000,2.5e+09,27,26,89,142
802790000,983060000,176370000,344620000,193160000,2.5e+09,26,29,94,149
1075150000,676130000,174190000,494340000,80190000,2.5e+09,28,24,86,138
1297360000,570550000,153270000,363170000,115650000,2.5e+09,27,27,86,140
946720000,7.29e+08,193690000,376980000,253610000,2.5e+09,29,31,91,151
1490040000,594250000,122780000,196990000,95940000,2.5e+09,28,29,88,145
1.241e+09,584560000,176810000,242080000,255550000,2.5e+09,29,28,89,146
968050000,954140000,120860000,328510000,128440000,2.5e+09,29,33,92,154
913740000,964270000,377780000,177770000,66440000,2.5e+09,28,28,93,149
708290000,1325780000,88350000,249310000,128270000,2.5e+09,28,27,90,145
791520000,1245420000,96870000,305920000,60270000,2.5e+09,30,32,97,159
393540000,737660000,78010000,423750000,867040000,2.5e+09,31,33,92,156
482550000,1426630000,79780000,421880000,89160000,2.5e+09,28,31,88,147
487020000,375540000,57720000,235300000,1344420000,2.5e+09,27,29,89,145
949280000,701200000,209560000,387120000,252840000,2.5e+09,30,31,90,151
27890000,40310000,26170000,19850000,1266300000,1380520000,25,26,73,124
306260000,485620000,85390000,130250000,1280500000,2288020000,26,27,85,138
1184390000,1114920000,101050000,67890000,31750000,2.5e+09,27,24,82,133
1165950000,879770000,141640000,287920000,24720000,2.5e+09,30,24,72,126
514690000,1751810000,195970000,2430000,35100000,2.5e+09,27,27,78,132
1360620000,586090000,347890000,184940000,20460000,2.5e+09,29,23,79,131
740190000,1454290000,97630000,183910000,23980000,2.5e+09,28,26,85,139
846850000,1394420000,97600000,130300000,30830000,2.5e+09,27,25,84,136
777900000,1414100000,107130000,165990000,34880000,2.5e+09,30,26,88,144
648100000,1671860000,120660000,15290000,44090000,2.5e+09,30,29,91,150
552410000,1648970000,149690000,121360000,27570000,2.5e+09,30,29,93,152
598910000,1593680000,146690000,93540000,67180000,2.5e+09,29,28,91,148
727690000,1274720000,203100000,228230000,66260000,2.5e+09,28,27,91,146
661330000,1424610000,175730000,203480000,34850000,2.5e+09,30,28,90,148
1141720000,998910000,185320000,85370000,88680000,2.5e+09,28,25,83,136
1045930000,724970000,201160000,353420000,174520000,2.5e+09,29,25,86,140
596970000,1502470000,208720000,113530000,78310000,2.5e+09,27,26,89,142
926920000,881280000,213580000,379250000,98970000,2.5e+09,29,29,85,143
1422860000,739120000,111730000,156040000,70250000,2.5e+09,27,26,84,137
1230820000,898100000,134860000,133770000,102450000,2.5e+09,28,23,81,132
918880000,1105290000,111240000,295280000,69310000,2.5e+09,26,24,83,133
885510000,1153930000,1.25e+08,215430000,120130000,2.5e+09,26,28,88,142
965230000,1187530000,58760000,202330000,86150000,2.5e+09,28,27,85,140
1257440000,778310000,107340000,275900000,81010000,2.5e+09,29,30,88,147
1588450000,559260000,42820000,232750000,76720000,2.5e+09,28,26,86,140
1199320000,1051280000,52600000,113710000,83090000,2.5e+09,26,27,86,139
773560000,1206140000,81570000,310600000,128130000,2.5e+09,26,29,87,142
741960000,1309430000,93160000,235090000,120360000,2.5e+09,27,29,85,141
1087640000,1054870000,75120000,206860000,75510000,2.5e+09,26,27,79,132
1244340000,807730000,69250000,146590000,232090000,2.5e+09,27,29,86,142
1062840000,1021350000,88840000,209260000,117710000,2.5e+09,27,28,87,142
455470000,392940000,31590000,197280000,1338260000,2415540000,27,28,87,142
1103760000,1033810000,76800000,153510000,132120000,2.5e+09,26,25,80,131
446640000,1789840000,189860000,31900000,41760000,2.5e+09,30,28,91,149
361850000,1544410000,368850000,35060000,189830000,2.5e+09,30,28,96,154
941890000,1266640000,165010000,61150000,65310000,2.5e+09,27,27,86,140
307580000,1730770000,312790000,18630000,130230000,2.5e+09,28,31,92,151
1045110000,1094210000,198050000,85360000,77270000,2.5e+09,27,25,83,135
326190000,1870520000,210360000,14100000,78830000,2.5e+09,33,28,98,159
592680000,1480780000,253560000,95440000,77540000,2.5e+09,33,30,98,161
786430000,1295070000,182830000,198010000,37660000,2.5e+09,32,30,96,158
1045930000,904470000,97230000,322440000,129930000,2.5e+09,30,29,87,146
921180000,1106970000,159680000,282980000,29190000,2.5e+09,28,28,88,144
602910000,1469760000,1.66e+08,161320000,100010000,2.5e+09,30,31,91,152
700630000,863180000,110900000,569810000,255480000,2.5e+09,32,28,88,148
513130000,1454970000,321090000,140850000,69960000,2.5e+09,28,27,88,143
408770000,1834220000,170220000,50070000,36720000,2.5e+09,28,28,90,146
754660000,1310440000,151290000,194950000,88660000,2.5e+09,29,30,86,145
733390000,1418370000,165560000,113980000,68700000,2.5e+09,28,26,87,141
472420000,1600660000,149970000,218070000,58880000,2.5e+09,27,30,91,148
591120000,1523580000,141890000,196690000,46720000,2.5e+09,28,31,88,147
437790000,1726200000,113660000,193850000,28500000,2.5e+09,27,29,86,142
734250000,1350080000,133520000,212780000,69370000,2.5e+09,30,29,87,146
818650000,1191460000,105200000,325710000,58980000,2.5e+09,27,30,87,144
686500000,1294130000,315960000,104060000,99350000,2.5e+09,27,27,85,139
489850000,1503870000,126820000,271950000,107510000,2.5e+09,28,27,83,138
423180000,1797640000,108630000,69310000,101240000,2.5e+09,28,28,80,136
1381970000,733660000,53510000,162050000,168810000,2.5e+09,27,26,80,133
1146400000,1004440000,70420000,140590000,138150000,2.5e+09,27,28,82,137
1308090000,659170000,53330000,168930000,310480000,2.5e+09,26,29,82,137
614750000,1577220000,66420000,112090000,129520000,2.5e+09,27,23,85,135
531840000,1676900000,248480000,9730000,33050000,2.5e+09,26,26,81,133
86830000,2162830000,201460000,7260000,41620000,2.5e+09,29,25,85,139
156190000,482620000,181380000,15270000,1653830000,2489290000,27,30,75,132
891460000,677120000,109800000,46930000,774690000,2.5e+09,32,34,86,152
823970000,1057310000,160410000,75110000,383200000,2.5e+09,30,31,80,141
754140000,249480000,217420000,29530000,1249430000,2.5e+09,31,31,82,144
68680000,223550000,37470000,26320000,1837520000,2193540000,29,32,84,145
1827970000,279210000,73780000,15630000,303410000,2.5e+09,29,28,75,132
1723890000,416410000,30930000,10600000,318170000,2.5e+09,32,25,74,131
512640000,1264250000,47170000,12470000,663470000,2.5e+09,31,31,87,149
1606720000,559140000,64580000,28930000,240630000,2.5e+09,29,29,76,134
1678520000,327990000,24950000,8090000,460450000,2.5e+09,32,29,78,139
573350000,216250000,14810000,1690000,1693900000,2.5e+09,27,28,80,135
2031290000,80010000,10580000,0,378120000,2.5e+09,26,24,63,113
1849520000,206140000,26430000,2680000,415230000,2.5e+09,31,26,74,131
1584710000,13050000,18700000,490000,883050000,2.5e+09,26,25,65,116
1941870000,21010000,3980000,0,533140000,2.5e+09,28,24,65,117
1341380000,15480000,10960000,690000,1131490000,2.5e+09,30,23,69,122
674990000,11210000,1320000,21770000,1790710000,2.5e+09,22,21,57,100
861590000,7660000,8210000,42390000,1580150000,2.5e+09,28,25,63,116
1749780000,243850000,37110000,19590000,449670000,2.5e+09,31,27,74,132
1553200000,602760000,92860000,112870000,138310000,2.5e+09,31,30,84,145
1553780000,249390000,21170000,24470000,651190000,2.5e+09,32,26,78,136
1215810000,384870000,79260000,67390000,752670000,2.5e+09,34,35,89,158
1927420000,211260000,53630000,9860000,297830000,2.5e+09,30,28,74,132
1631100000,243060000,52330000,15620000,557890000,2.5e+09,31,27,77,135
1811430000,360630000,50800000,35130000,242010000,2.5e+09,30,28,78,136
1738250000,237720000,58190000,16520000,449320000,2.5e+09,30,27,77,134
1062820000,1111470000,64070000,90200000,171440000,2.5e+09,33,31,85,149
1484920000,648640000,56440000,61510000,248490000,2.5e+09,31,28,84,143
692870000,518010000,39660000,20420000,1229040000,2.5e+09,32,32,82,146
1257050000,374710000,56610000,42160000,769470000,2.5e+09,31,29,84,144
676320000,294220000,81480000,6540000,1441440000,2.5e+09,31,31,83,145
396340000,230140000,19370000,3650000,1850500000,2.5e+09,31,29,77,137
1734910000,322920000,61900000,8520000,371750000,2.5e+09,32,30,86,148
1494110000,291730000,25290000,8250000,680620000,2.5e+09,33,30,81,144
1821420000,60310000,14150000,8e+05,603320000,2.5e+09,23,23,62,108
1869170000,195800000,17960000,4950000,412120000,2.5e+09,30,26,72,128
1876480000,14440000,10590000,530000,597960000,2.5e+09,26,24,74,124
1930770000,40240000,27550000,1810000,499630000,2.5e+09,27,26,70,123
1802420000,26820000,23020000,2760000,644980000,2.5e+09,28,22,66,116
1763600000,28360000,16710000,3360000,687970000,2.5e+09,27,26,70,123
1863240000,63130000,43140000,9600000,520890000,2.5e+09,32,28,77,137
1493640000,3090000,5220000,1500000,996550000,2.5e+09,23,19,52,94
1658450000,930000,3790000,310000,836520000,2.5e+09,18,20,59,97
1687400000,16970000,9840000,2520000,783270000,2.5e+09,23,19,60,102
1717430000,280000,1510000,0,780780000,2.5e+09,21,21,51,93
1200820000,2760000,6940000,30950000,1258530000,2.5e+09,24,21,55,100
1587340000,8750000,12430000,4640000,886840000,2.5e+09,27,20,64,111
1675540000,163180000,7600000,740000,652940000,2.5e+09,25,25,66,116
1704180000,23550000,10740000,2360000,759170000,2.5e+09,25,20,67,112
1650980000,65240000,13610000,10070000,760100000,2.5e+09,29,24,72,125
2009820000,158960000,26680000,12120000,292420000,2.5e+09,26,26,70,122
778870000,175930000,49010000,30700000,1465420000,2499930000,32,35,96,163
204290000,393420000,58350000,153520000,1688990000,2498570000,35,32,97,164
1973960000,264810000,40260000,22690000,198280000,2.5e+09,30,26,73,129
2.055e+09,122390000,18780000,17210000,286620000,2.5e+09,28,26,76,130
1976500000,180640000,26300000,17320000,299240000,2.5e+09,30,31,82,143
1669970000,193220000,41200000,9880000,585730000,2.5e+09,30,30,80,140
1009490000,1076010000,115390000,52470000,246640000,2.5e+09,32,31,85,148
1869470000,211590000,18140000,41740000,359060000,2.5e+09,30,27,78,135
818750000,477560000,18570000,21100000,1164020000,2.5e+09,32,32,85,149
1023020000,888930000,105450000,18490000,464110000,2.5e+09,34,31,84,149
1842220000,337160000,37770000,22790000,260060000,2.5e+09,31,28,77,136
1134200000,769820000,91350000,21340000,483290000,2.5e+09,33,29,83,145
1499220000,499680000,47860000,18760000,434480000,2.5e+09,31,30,84,145
1850240000,200880000,59920000,2100000,386860000,2.5e+09,32,28,81,141
1837730000,220080000,27780000,2810000,411600000,2.5e+09,31,27,76,134
1666110000,428600000,39960000,9080000,356250000,2.5e+09,31,28,80,139
1208750000,735010000,108830000,17060000,430350000,2.5e+09,35,32,84,151
1893960000,43760000,10850000,4910000,546520000,2.5e+09,26,25,70,121
1790190000,158690000,21080000,2070000,527970000,2.5e+09,29,29,75,133
1818020000,154460000,44610000,5600000,477310000,2.5e+09,31,26,77,134
1763640000,38700000,5600000,590000,691470000,2.5e+09,26,23,62,111
1800840000,36250000,9200000,1100000,652610000,2.5e+09,32,23,73,128
1868380000,102600000,17920000,3320000,507780000,2.5e+09,27,25,77,129
1908060000,223160000,25080000,2500000,341200000,2.5e+09,30,27,77,134
1805820000,27070000,4240000,820000,662050000,2.5e+09,21,21,56,98
1798940000,32660000,6100000,1760000,660540000,2.5e+09,26,23,62,111
1888550000,56420000,6530000,3710000,544790000,2.5e+09,24,19,64,107
1767690000,93450000,9740000,720000,628400000,2.5e+09,24,25,67,116
1447050000,39990000,7470000,16650000,988840000,2.5e+09,26,24,67,117
1735330000,47470000,3710000,4420000,709070000,2.5e+09,25,23,64,112
1611180000,36330000,5880000,4370000,842240000,2.5e+09,20,18,49,87
1962160000,71470000,3860000,3240000,459270000,2.5e+09,20,19,61,100
109630000,81420000,5180000,32250000,2256160000,2484640000,32,29,86,147
1167480000,513680000,71030000,24070000,723740000,2.5e+09,32,30,83,145
1114620000,590400000,68030000,14220000,712730000,2.5e+09,32,32,91,155
925470000,314030000,648890000,17100000,594510000,2.5e+09,31,32,78,141
357170000,111220000,32300000,7590000,1921200000,2429480000,29,31,85,145
1490020000,5.43e+08,28820000,14680000,423480000,2.5e+09,35,31,85,151
1031920000,1069900000,128710000,43730000,225740000,2.5e+09,34,32,84,150
456260000,14490000,33770000,1470000,1722370000,2228360000,27,28,78,133
1123560000,101460000,89820000,13050000,1172110000,2.5e+09,34,33,91,158
891540000,93950000,13530000,320000,1500660000,2.5e+09,32,31,83,146
522640000,45560000,25780000,5840000,1860710000,2460530000,35,31,77,143
1929070000,111940000,32600000,1200000,425190000,2.5e+09,30,30,76,136
1292110000,185460000,92090000,5980000,924360000,2.5e+09,33,32,87,152
1691890000,18800000,2190000,1990000,785130000,2.5e+09,16,18,51,85
1872590000,110160000,15430000,2440000,499380000,2.5e+09,28,25,69,122
772070000,102910000,2520000,0,1622500000,2.5e+09,22,13,61,96
778310000,74540000,1590000,0,1645560000,2.5e+09,24,19,57,100
314120000,120450000,6860000,0,2058570000,2.5e+09,15,17,55,87
647960000,70510000,1280000,0,1780250000,2.5e+09,19,17,51,87
171540000,112860000,6450000,640000,2208510000,2.5e+09,20,20,67,107
777570000,22560000,1470000,2680000,1695720000,2.5e+09,18,22,60,100
499010000,13540000,310000,6210000,1980930000,2.5e+09,23,22,57,102
1118180000,5570000,1600000,58960000,1315690000,2.5e+09,21,19,54,94
1306910000,4370000,50000,6030000,1182640000,2.5e+09,27,24,63,114
782120000,31470000,890000,0,1685520000,2.5e+09,21,14,42,77
813150000,21290000,1410000,26770000,1637380000,2.5e+09,18,19,44,81
501700000,6350000,1340000,59310000,1931300000,2.5e+09,21,21,55,97
317120000,46320000,0,0,2136560000,2.5e+09,19,17,59,95
776980000,144070000,11950000,0,1.567e+09,2.5e+09,28,23,66,117
640110000,29650000,16700000,0,1813540000,2.5e+09,25,20,61,106
171440000,32040000,1880000,0,2116180000,2321540000,22,22,63,107
268210000,56210000,20800000,460000,2154320000,2.5e+09,23,20,61,104
561970000,54830000,2380000,0,1880820000,2.5e+09,25,18,58,101
1459470000,8160000,560000,6690000,1025120000,2.5e+09,20,24,55,99
1686400000,30700000,1390000,8380000,773130000,2.5e+09,23,20,55,98
1369560000,27100000,5060000,4610000,1093670000,2.5e+09,24,24,69,117
1559760000,24210000,3730000,7110000,905190000,2.5e+09,25,23,58,106
1270680000,3950000,4800000,23450000,1197120000,2.5e+09,21,21,48,90
1435920000,3330000,5410000,20920000,1034420000,2.5e+09,23,22,55,100
1828470000,6820000,910000,1120000,662680000,2.5e+09,19,20,53,92
1602790000,4980000,2560000,0,889670000,2.5e+09,23,20,63,106
148930000,1660000,0,44510000,2304900000,2.5e+09,14,16,46,76
355280000,460000,0,148810000,1995450000,2.5e+09,20,22,56,98
1120690000,0,0,18720000,1360590000,2.5e+09,17,15,51,83
609670000,28740000,4800000,18540000,1838250000,2.5e+09,29,22,62,113
483770000,30130000,2650000,0,1983450000,2.5e+09,18,17,52,87
675400000,60090000,960000,0,1763550000,2.5e+09,17,17,47,81
622100000,48290000,13870000,5640000,1810100000,2.5e+09,21,21,56,98
453630000,37060000,1620000,0,2007690000,2.5e+09,17,15,48,80
761390000,127380000,15960000,0,1595270000,2.5e+09,25,21,61,107
1457570000,15980000,520000,970000,1024960000,2.5e+09,21,18,57,96
1592700000,19470000,4590000,850000,882390000,2.5e+09,22,21,59,102
1434560000,19040000,8740000,2390000,1035270000,2.5e+09,18,20,58,96
263040000,0,570000,67920000,2168470000,2.5e+09,17,16,50,83
1006040000,3e+05,0,23960000,1469700000,2.5e+09,15,13,44,72
792240000,71800000,7970000,27210000,1600780000,2.5e+09,17,9,45,71
119170000,250490000,21460000,66120000,2042760000,2.5e+09,16,13,46,75
130900000,438690000,49720000,201530000,1679160000,2.5e+09,26,21,66,113
477400000,681630000,53930000,299100000,987940000,2.5e+09,21,19,51,91
105220000,618700000,55360000,95120000,1625600000,2.5e+09,24,20,60,104
1183190000,281070000,11270000,237090000,787380000,2.5e+09,23,18,60,101
56870000,557200000,10180000,5340000,1870410000,2.5e+09,14,8,39,61
24260000,893750000,38190000,0,1543800000,2.5e+09,12,9,41,62
330770000,1033690000,14810000,165320000,955410000,2.5e+09,19,11,47,77
221650000,1157330000,28450000,131030000,961540000,2.5e+09,11,4,43,58
461250000,886360000,50590000,131020000,970780000,2.5e+09,23,19,60,102
35260000,588260000,15310000,22680000,1838490000,2.5e+09,22,14,54,90
1303310000,305530000,20620000,69660000,800880000,2.5e+09,20,10,45,75
262930000,735460000,61660000,87710000,1352240000,2.5e+09,22,14,59,95
616920000,513390000,16490000,123640000,1229560000,2.5e+09,21,15,56,92
169070000,1400280000,103680000,387490000,439480000,2.5e+09,21,15,58,94
451330000,878040000,14020000,368090000,788520000,2.5e+09,15,14,52,81
187880000,615780000,11790000,152610000,1531940000,2.5e+09,20,14,46,80
0,47470000,540000,17550000,1991160000,2056720000,10,5,28,43
50260000,439800000,12370000,62630000,1934940000,2.5e+09,9,7,37,53
397970000,721050000,26160000,175570000,1179250000,2.5e+09,21,16,56,93
530020000,640780000,24200000,292780000,1012220000,2.5e+09,17,17,48,82
127700000,801320000,60600000,84530000,1425850000,2.5e+09,14,11,37,62
83730000,239270000,20150000,137010000,2019840000,2.5e+09,17,7,39,63
725820000,541060000,35700000,219260000,978160000,2.5e+09,26,21,68,115
245250000,389020000,18580000,84840000,1762310000,2.5e+09,22,14,52,88
147220000,1008300000,44080000,37020000,1263380000,2.5e+09,14,14,42,70
306530000,505730000,55530000,74540000,1557670000,2.5e+09,14,13,42,69
6180000,1937490000,99890000,179900000,276540000,2.5e+09,16,14,44,74
177070000,1199990000,62220000,88640000,972080000,2.5e+09,26,21,71,118
374120000,405150000,55230000,51260000,1.565e+09,2450760000,23,22,65,110
382710000,485980000,46260000,55430000,1529620000,2.5e+09,13,9,41,63
673700000,366980000,8630000,409420000,1041270000,2.5e+09,25,17,46,88
222490000,214280000,44190000,73620000,1945420000,2.5e+09,23,17,54,94
830930000,1377630000,86230000,105780000,99430000,2.5e+09,24,17,64,105
435160000,1712920000,85770000,78380000,187770000,2.5e+09,27,22,70,119
6.36e+08,1498810000,91100000,81610000,192480000,2.5e+09,25,19,67,111
1202170000,512060000,9360000,277100000,499310000,2.5e+09,25,17,60,102
314840000,1889230000,1.62e+08,6e+06,127930000,2.5e+09,27,23,68,118
358670000,1647110000,92910000,82170000,319140000,2.5e+09,30,31,77,138
313360000,1796120000,142110000,21050000,227360000,2.5e+09,27,18,63,108
5910000,2268320000,127110000,55560000,43100000,2.5e+09,24,18,66,108
249670000,1937590000,118290000,42860000,151590000,2.5e+09,27,26,71,124
305390000,1789600000,122090000,151460000,131460000,2.5e+09,30,30,82,142
534780000,1635340000,111310000,72230000,146340000,2.5e+09,26,24,72,122
337350000,1218090000,87280000,506850000,350430000,2.5e+09,29,30,77,136
489750000,1445250000,94510000,199450000,271040000,2.5e+09,27,24,75,126
768790000,1053190000,308960000,146240000,222820000,2.5e+09,30,27,82,139
181310000,1736630000,260750000,159370000,161940000,2.5e+09,29,33,87,149
451520000,1128250000,5.94e+08,119690000,206540000,2.5e+09,27,28,77,132
444560000,1194570000,185360000,400330000,275180000,2.5e+09,30,29,82,141
774510000,1548840000,69480000,4.9e+07,58170000,2.5e+09,19,14,57,90
1280690000,732240000,37850000,85980000,363240000,2.5e+09,23,15,56,94
231790000,1889420000,203100000,31470000,144220000,2.5e+09,27,28,70,125
104510000,1814790000,301320000,49090000,230290000,2.5e+09,28,30,77,135
15560000,2.048e+09,111940000,218610000,105890000,2.5e+09,27,26,74,127
118690000,1832470000,182600000,148320000,217920000,2.5e+09,32,36,86,154
5650000,2276610000,112360000,74410000,30970000,2.5e+09,24,20,66,110
14020000,1961030000,118010000,255750000,151190000,2.5e+09,28,27,64,119
268700000,1623180000,107860000,360990000,139270000,2.5e+09,30,30,83,143
254650000,1618250000,176400000,294900000,155800000,2.5e+09,31,35,85,151
35840000,2.187e+09,99400000,154970000,22790000,2.5e+09,26,22,67,115
33570000,2154280000,108850000,173390000,29910000,2.5e+09,27,29,79,135
169700000,1829550000,153980000,218760000,128010000,2.5e+09,26,26,72,124
106090000,1566320000,128980000,475880000,222730000,2.5e+09,32,34,81,147
612460000,994960000,30560000,280590000,581430000,2.5e+09,26,19,75,120
744960000,832580000,36840000,284620000,6.01e+08,2.5e+09,39,27,98,164
843330000,509850000,14850000,474020000,657950000,2.5e+09,32,25,66,123
811520000,734850000,49750000,320840000,583040000,2.5e+09,29,19,75,123
737680000,1480700000,116800000,22330000,142490000,2.5e+09,24,20,57,101
479230000,1465210000,79910000,199020000,276630000,2.5e+09,34,33,82,149
1794860000,312840000,32580000,3.19e+08,40720000,2.5e+09,22,20,56,98
1721180000,417870000,14300000,99510000,247140000,2.5e+09,26,18,61,105
220590000,1676420000,187930000,356580000,58480000,2.5e+09,26,22,62,110
159970000,1895810000,99470000,301470000,43280000,2.5e+09,26,24,60,110
881870000,1021920000,105500000,404440000,86270000,2.5e+09,22,20,55,97
1268350000,696540000,70590000,416210000,48310000,2.5e+09,19,20,52,91
134790000,1684670000,146590000,429770000,104180000,2.5e+09,30,32,77,139
86870000,2003600000,170990000,192940000,45600000,2.5e+09,26,24,65,115
701340000,1279800000,107340000,364740000,46780000,2.5e+09,27,22,70,119
1199140000,868670000,88090000,293640000,50460000,2.5e+09,25,22,56,103
91580000,1392620000,148540000,690170000,177090000,2.5e+09,31,33,87,151
60010000,1760910000,91750000,521270000,66060000,2.5e+09,30,30,81,141
722230000,1203200000,154620000,199340000,220610000,2.5e+09,25,26,78,129
271730000,1658860000,195610000,306760000,67040000,2.5e+09,31,23,76,130
441530000,1274430000,88580000,16860000,678600000,2.5e+09,26,25,74,125
118710000,918090000,127630000,18930000,1316640000,2.5e+09,26,24,64,114
789160000,723550000,42380000,198920000,745990000,2.5e+09,30,25,70,125
378760000,1775280000,92630000,91440000,161890000,2.5e+09,19,21,60,100
895120000,1002800000,6.4e+07,119320000,418760000,2.5e+09,39,34,94,167
355380000,1352440000,135030000,183120000,474030000,2.5e+09,25,17,64,106
1188270000,623260000,31810000,327010000,329650000,2.5e+09,28,24,79,131
879890000,839650000,86690000,344190000,349580000,2.5e+09,35,25,85,145
1182050000,592900000,36040000,286860000,402150000,2.5e+09,33,24,78,135
999170000,600020000,70850000,425280000,404680000,2.5e+09,30,28,90,148
441800000,1166930000,350290000,263870000,277110000,2.5e+09,35,26,88,149
144730000,1867100000,145500000,136270000,206400000,2.5e+09,31,24,68,123
1434170000,368640000,53520000,549470000,94200000,2.5e+09,22,17,49,88
457890000,1646510000,100900000,272900000,21800000,2.5e+09,22,18,50,90
1584840000,221110000,25620000,422510000,245920000,2.5e+09,24,16,54,94
1481110000,402860000,53440000,475980000,86610000,2.5e+09,24,20,64,108
1640900000,438470000,63330000,300260000,57040000,2.5e+09,19,17,50,86
1279140000,418460000,55240000,669150000,78010000,2.5e+09,24,21,64,109
231200000,1750720000,182720000,295840000,39520000,2.5e+09,25,21,65,111
892260000,606310000,37180000,298640000,665610000,2.5e+09,30,25,75,130
396610000,1313360000,60670000,22760000,706600000,2.5e+09,21,20,55,96
1585060000,438900000,45160000,133760000,297120000,2.5e+09,33,27,80,140
906630000,883910000,96050000,267650000,345760000,2.5e+09,28,24,68,120
1216440000,727890000,104090000,175760000,275820000,2.5e+09,30,25,80,135
237100000,1813140000,109240000,173860000,166660000,2.5e+09,31,28,77,136
364850000,1281540000,148790000,643710000,61110000,2.5e+09,28,27,70,125
1303630000,329190000,83100000,736290000,47790000,2.5e+09,21,21,56,98
751980000,1166730000,329210000,103190000,148890000,2.5e+09,28,30,86,144
393450000,1300640000,517020000,142450000,146440000,2.5e+09,35,30,95,160
897310000,524170000,620300000,283780000,174440000,2.5e+09,26,28,84,138
825150000,958740000,421540000,151400000,143170000,2.5e+09,33,30,91,154
547560000,1614550000,120650000,185590000,31650000,2.5e+09,26,21,76,123
1253530000,897580000,104730000,183910000,60250000,2.5e+09,31,31,87,149
741120000,1120290000,1.44e+08,333670000,160920000,2.5e+09,27,23,76,126
811110000,988330000,268560000,316340000,115660000,2.5e+09,27,26,78,131
528890000,1334950000,130520000,378700000,126940000,2.5e+09,28,28,88,144
446370000,1613610000,144140000,218660000,77220000,2.5e+09,27,27,85,139
217050000,1860520000,101090000,268680000,52660000,2.5e+09,28,26,80,134
542350000,1336420000,349360000,220280000,51590000,2.5e+09,28,26,81,135
761390000,1.28e+09,212470000,158850000,87290000,2.5e+09,25,26,83,134
243690000,1909870000,72240000,95690000,178510000,2.5e+09,27,26,87,140
608100000,1664970000,68750000,93960000,64220000,2.5e+09,28,29,90,147
534220000,1636820000,77920000,88240000,162800000,2.5e+09,30,28,90,148
1058940000,1134270000,73920000,151690000,81180000,2.5e+09,26,25,80,131
790250000,1.394e+09,72420000,137690000,105640000,2.5e+09,26,27,84,137
379250000,1745790000,116710000,155920000,102330000,2.5e+09,28,29,90,147
460950000,1741170000,89870000,98350000,109660000,2.5e+09,28,30,90,148
388230000,326410000,98540000,133830000,1524320000,2471330000,29,27,81,137
746250000,1.097e+09,280670000,102370000,273710000,2.5e+09,28,30,89,147
80980000,8.89e+08,82100000,30730000,1417190000,2.5e+09,27,31,85,143
1387350000,780940000,131100000,152590000,48020000,2.5e+09,26,24,73,123
519760000,1780750000,130730000,29800000,38960000,2.5e+09,28,26,84,138
1353780000,744280000,95650000,251020000,55270000,2.5e+09,27,24,78,129
904040000,1132080000,111340000,224230000,128310000,2.5e+09,30,26,82,138
1505600000,522150000,150160000,208920000,113170000,2.5e+09,30,23,77,130
993130000,901640000,188510000,294770000,121950000,2.5e+09,29,30,85,144
1410670000,653960000,147250000,194700000,93420000,2.5e+09,31,27,87,145
1310700000,486290000,108330000,330170000,264510000,2.5e+09,28,28,72,128
1645580000,342950000,99940000,267130000,144400000,2.5e+09,28,26,77,131
389630000,1796860000,201050000,99460000,1.3e+07,2.5e+09,29,24,72,125
725120000,1158030000,395910000,141450000,79490000,2.5e+09,30,26,82,138
222940000,1712480000,173220000,334660000,56700000,2.5e+09,32,29,85,146
736190000,1398240000,172060000,101380000,92130000,2.5e+09,29,25,81,135
820410000,1140610000,137860000,272270000,128850000,2.5e+09,28,25,85,138
847850000,1134050000,99900000,338160000,80040000,2.5e+09,29,26,84,139
1180250000,780500000,157760000,217470000,164020000,2.5e+09,29,27,83,139
774410000,1122960000,231460000,296520000,74650000,2.5e+09,30,29,82,141
303530000,1792710000,157460000,184750000,61550000,2.5e+09,27,28,82,137
612020000,1489560000,186750000,131140000,80530000,2.5e+09,28,25,82,135
547260000,1254800000,423230000,156240000,118470000,2.5e+09,30,29,90,149
503400000,1664140000,79130000,187540000,65790000,2.5e+09,27,25,84,136
634790000,1283280000,67090000,465960000,48880000,2.5e+09,27,28,87,142
355390000,1851060000,87610000,99800000,106140000,2.5e+09,27,25,87,139
472500000,1591200000,86460000,298280000,51560000,2.5e+09,27,24,79,130
497340000,1594400000,138140000,179370000,90750000,2.5e+09,27,29,86,142
774980000,1309730000,82450000,125430000,207410000,2.5e+09,27,30,82,139
689060000,1424290000,97570000,157640000,131440000,2.5e+09,27,26,82,135
747120000,1306660000,113380000,182730000,150110000,2.5e+09,29,30,86,145
1302370000,700370000,73070000,251970000,172220000,2.5e+09,28,27,85,140
0,0,0,0,2.24e+08,2.24e+08,28,30,84,142
469100000,847330000,37960000,50620000,556140000,1961150000,27,27,89,143
0,0,0,0,0,0,28,30,83,141
346770000,818750000,25230000,74730000,71100000,1336580000,29,28,86,143
10470000,0,880000,0,918630000,929980000,22,20,63,105
1225890000,940640000,78100000,141790000,113580000,2.5e+09,29,25,80,134
1293710000,594350000,128230000,283080000,200630000,2.5e+09,27,25,74,126
1198500000,761530000,83860000,261980000,194130000,2.5e+09,27,26,79,132
826770000,1056540000,202760000,227430000,186500000,2.5e+09,28,29,83,140
1010750000,622940000,155910000,454650000,255750000,2.5e+09,31,26,82,139
1269990000,380770000,77250000,267350000,504640000,2.5e+09,26,23,69,118
1304550000,785940000,125720000,246110000,37680000,2.5e+09,29,25,75,129
1314150000,706970000,103050000,201170000,174660000,2.5e+09,27,24,73,124
676160000,1400430000,172240000,143450000,107720000,2.5e+09,30,26,82,138
649820000,1578450000,153610000,83560000,34560000,2.5e+09,30,25,77,132
651960000,1302080000,238510000,162540000,144910000,2.5e+09,30,27,82,139
527080000,1567260000,185830000,116490000,103340000,2.5e+09,29,25,83,137
473400000,1678770000,152430000,118640000,76760000,2.5e+09,30,31,86,147
880820000,1193850000,155880000,156390000,113060000,2.5e+09,30,26,82,138
751610000,898040000,498560000,236310000,115480000,2.5e+09,28,31,90,149
891620000,1070270000,154550000,243370000,140190000,2.5e+09,31,31,87,149
587370000,1280350000,158790000,407640000,65850000,2.5e+09,28,29,87,144
603050000,1376070000,1.34e+08,310450000,76430000,2.5e+09,29,30,89,148
809680000,1008030000,85710000,540500000,56080000,2.5e+09,28,28,89,145
810380000,1039120000,180690000,351980000,117830000,2.5e+09,30,32,92,154
530110000,1397160000,109200000,412640000,50890000,2.5e+09,29,32,91,152
712660000,1311530000,111300000,317630000,46880000,2.5e+09,27,26,86,139
651520000,1316130000,74530000,1.48e+08,309820000,2.5e+09,31,33,87,151
1238950000,484970000,38940000,631480000,105660000,2.5e+09,30,29,82,141
708530000,1247490000,61130000,180350000,302500000,2.5e+09,30,31,85,146
647510000,1193230000,74680000,475110000,109470000,2.5e+09,30,34,89,153
0,0,0,0,0,0,32,31,89,152
203250000,730630000,18140000,74530000,60340000,1086890000,29,31,84,144
7210000,2710000,1740000,8320000,5220000,25200000,28,29,78,135
391240000,646550000,16760000,61970000,37980000,1154500000,30,32,87,149
643020000,1114020000,158920000,145320000,438720000,2.5e+09,29,32,91,152
238140000,514770000,26100000,230950000,539780000,1549740000,35,33,99,167
802660000,1121160000,42360000,385350000,148470000,2.5e+09,27,30,81,138
735830000,1103740000,64790000,317190000,172280000,2393830000,31,33,95,159
878240000,1160570000,177120000,152680000,131390000,2.5e+09,28,29,83,140
199360000,1629880000,141040000,343070000,186650000,2.5e+09,30,30,82,142
223810000,1477550000,153660000,163820000,95370000,2114210000,33,34,88,155
388970000,1476740000,226760000,171780000,2.35e+08,2499250000,28,26,79,133
1462070000,647630000,75790000,297120000,17390000,2.5e+09,28,24,68,120
1214160000,970480000,162780000,105650000,46930000,2.5e+09,27,24,71,122
1417520000,678970000,119950000,247700000,35860000,2.5e+09,30,21,71,122
1374430000,821770000,129340000,72570000,101890000,2.5e+09,28,27,82,137
1068180000,1006460000,125110000,225560000,74690000,2.5e+09,32,30,86,148
546090000,1224580000,165820000,155430000,72590000,2164510000,29,24,83,136
592190000,740650000,53460000,139390000,28120000,1553810000,32,34,92,158
8880000,4010000,350000,1730000,0,14970000,31,32,83,146
375130000,1645800000,208370000,214250000,56450000,2.5e+09,28,33,88,149
803370000,1402850000,103820000,164100000,25860000,2.5e+09,31,31,87,149
505270000,1076980000,77330000,324680000,93270000,2077530000,32,34,93,159
345530000,1724790000,128110000,275510000,26060000,2.5e+09,30,29,89,148
585330000,1355920000,123450000,381070000,42590000,2488360000,30,28,87,145
608010000,1247960000,115180000,444270000,84580000,2.5e+09,31,29,90,150
298390000,464960000,36670000,189010000,42590000,1031620000,29,37,93,159
541530000,5.44e+08,35540000,197740000,57650000,1376460000,33,36,92,161
560030000,1242090000,176850000,435170000,85860000,2.5e+09,31,31,91,153
709920000,1296550000,85090000,352960000,55480000,2.5e+09,30,26,89,145
1157810000,574240000,46910000,408670000,137140000,2324770000,32,33,92,157
593800000,322580000,43240000,145370000,52810000,1157800000,34,33,95,162
873410000,1238350000,65120000,186390000,136730000,2.5e+09,28,30,86,144
658350000,905420000,5.7e+07,580580000,298650000,2.5e+09,32,34,95,161
1023170000,374530000,28650000,121250000,104710000,1652310000,34,33,95,162
568870000,753070000,39480000,203210000,51250000,1615880000,29,37,90,156
251160000,1492180000,68190000,51300000,50190000,1913020000,27,27,78,132
363840000,1621920000,31610000,159160000,90880000,2267410000,30,32,85,147
823620000,1145720000,214990000,89460000,226210000,2.5e+09,30,33,92,155
440330000,1436800000,78320000,290530000,254020000,2.5e+09,32,32,90,154
689920000,1299650000,56050000,185250000,269130000,2.5e+09,29,31,86,146
516830000,1649090000,80180000,73220000,180680000,2.5e+09,23,25,71,119
563580000,1668420000,78730000,47710000,141560000,2.5e+09,28,24,69,121
0,3340000,0,3190000,0,6530000,29,28,76,133
137890000,1045790000,94090000,241200000,122700000,1641670000,31,29,80,140
413650000,468410000,67470000,187300000,31720000,1168550000,31,26,75,132
910690000,148210000,22250000,178460000,44330000,1303940000,28,22,70,120
693720000,45260000,7150000,85440000,10420000,841990000,26,19,72,117
372200000,159130000,45050000,181120000,32920000,790420000,26,21,67,114
430520000,46040000,106600000,1210000,1915630000,2.5e+09,28,29,80,137
951810000,220530000,42320000,11790000,1273550000,2.5e+09,33,33,84,150
1326570000,436960000,97360000,22550000,616560000,2.5e+09,33,33,89,155
1912370000,27410000,2470000,980000,556770000,2.5e+09,21,22,60,103
1858960000,167190000,16030000,1390000,456430000,2.5e+09,31,30,83,144
545960000,40200000,9740000,650000,1688770000,2285320000,27,28,74,129
1036900000,117210000,66800000,2940000,1276150000,2.5e+09,34,34,83,151
745040000,909340000,64140000,239110000,542370000,2.5e+09,31,34,93,158
738820000,1189310000,57170000,144950000,369750000,2.5e+09,30,30,94,154
833890000,979740000,43510000,115410000,527450000,2.5e+09,29,30,83,142
702810000,1424340000,83870000,134100000,154880000,2.5e+09,24,27,77,128
592630000,359420000,11620000,127360000,1408970000,2.5e+09,32,31,89,152
1006910000,653540000,39080000,147950000,652520000,2.5e+09,30,29,84,143
155900000,30440000,3230000,35840000,2274590000,2.5e+09,28,28,83,139
875470000,378680000,81800000,1420000,1162630000,2.5e+09,35,33,88,156
905530000,309990000,68690000,0,1215790000,2.5e+09,32,35,94,161
880820000,400040000,25480000,1630000,1192030000,2.5e+09,33,36,94,163
1288530000,777730000,75540000,0,358200000,2.5e+09,34,34,90,158
1.209e+09,924720000,183170000,9e+05,182210000,2.5e+09,34,35,89,158
1150070000,143100000,12210000,1140000,1193480000,2.5e+09,37,40,98,175
666400000,204610000,94800000,1720000,1532470000,2.5e+09,37,39,97,173
1604130000,425830000,19840000,0,450200000,2.5e+09,33,31,85,149
1780020000,388620000,24630000,0,306730000,2.5e+09,37,33,87,157
1.15e+09,382800000,76360000,0,890840000,2.5e+09,36,38,94,168
1266550000,433050000,43940000,0,756460000,2.5e+09,35,40,97,172
1243760000,933410000,94670000,0,228160000,2.5e+09,32,31,84,147
1406270000,650310000,34670000,0,408750000,2.5e+09,33,31,84,148
516080000,66810000,31660000,0,1885450000,2.5e+09,35,38,90,163
438540000,119520000,46920000,460000,1762160000,2367600000,37,36,94,167
1284010000,540650000,34490000,0,640850000,2.5e+09,37,37,96,170
667290000,1286900000,51370000,120350000,374090000,2.5e+09,30,30,82,142
662970000,1439590000,84540000,52470000,260430000,2.5e+09,26,24,80,130
604440000,1437550000,95400000,95600000,267010000,2.5e+09,29,28,82,139
689090000,770490000,38070000,169140000,833210000,2.5e+09,33,33,93,159
370270000,152270000,188100000,78060000,1673610000,2462310000,30,31,89,150
423320000,214200000,7130000,154670000,1641010000,2440330000,32,29,83,144
657460000,279850000,10430000,94190000,1458070000,2.5e+09,36,37,100,173
31430000,35150000,6650000,17930000,2135360000,2226520000,30,31,85,146
64480000,8080000,0,6800000,2072240000,2151600000,24,21,73,118
370980000,114900000,14080000,155010000,1845030000,2.5e+09,32,33,94,159
801290000,214780000,52900000,160820000,1270210000,2.5e+09,35,31,91,157
1146920000,498970000,16860000,342540000,494710000,2.5e+09,35,33,93,161
1460660000,563630000,71620000,0,404090000,2.5e+09,33,33,93,159
282510000,18020000,12410000,0,1919480000,2232420000,32,31,90,153
1330350000,894060000,37550000,0,238040000,2.5e+09,33,32,83,148
1146090000,1117030000,52530000,460000,183890000,2.5e+09,32,31,82,145
1.884e+09,157230000,13800000,0,444970000,2.5e+09,33,32,83,148
1270770000,460380000,198290000,0,570560000,2.5e+09,36,34,91,161
1623060000,491990000,35620000,0,349330000,2.5e+09,33,32,85,150
1687920000,358880000,19670000,920000,432610000,2.5e+09,34,31,84,149
1554350000,423850000,63870000,460000,457470000,2.5e+09,34,35,95,164
1525520000,438230000,25760000,0,510490000,2.5e+09,35,33,83,151
1668680000,18300000,11870000,2140000,799010000,2.5e+09,25,23,67,115
1661370000,19200000,1320000,840000,817270000,2.5e+09,20,19,58,97
1251250000,7370000,1670000,730000,1238980000,2.5e+09,20,20,59,99
794870000,0,0,2100000,1703030000,2.5e+09,13,13,40,66
1203470000,146900000,11320000,0,1138310000,2.5e+09,27,20,58,105
404730000,14670000,720000,6050000,2073830000,2.5e+09,18,13,43,74
370090000,21930000,1240000,29340000,2077400000,2.5e+09,27,19,55,101
159380000,0,0,35760000,2304860000,2.5e+09,19,13,45,77
479480000,62940000,23570000,250000,1933760000,2.5e+09,28,21,63,112
127090000,13430000,2520000,0,2356960000,2.5e+09,14,13,34,61
3.87e+08,65830000,5540000,0,2041630000,2.5e+09,16,12,40,68
1765060000,11530000,3370000,1060000,718980000,2.5e+09,25,23,62,110
1855410000,53050000,6130000,320000,585090000,2.5e+09,26,22,58,106
1909370000,199790000,31890000,3390000,355560000,2.5e+09,29,26,73,128
1948770000,163250000,5480000,1060000,381440000,2.5e+09,31,28,76,135
1581060000,6090000,9620000,6820000,896410000,2.5e+09,22,24,65,111
1710280000,20060000,4720000,12440000,752500000,2.5e+09,29,27,67,123
1919420000,30270000,5370000,3110000,541830000,2.5e+09,23,18,54,95
1644780000,470000,1350000,1370000,852030000,2.5e+09,16,12,44,72
1688960000,5100000,7300000,2850000,795790000,2.5e+09,21,23,63,107
1758530000,0,770000,2030000,738670000,2.5e+09,18,19,57,94
1691520000,1720000,11660000,260000,794840000,2.5e+09,21,18,55,94
745830000,0,2800000,5310000,1746060000,2.5e+09,16,12,45,73
1302990000,1120000,3490000,5440000,1186960000,2.5e+09,22,15,53,90
1476140000,820000,1690000,2640000,1018710000,2.5e+09,12,11,45,68
465920000,0,0,38100000,1995980000,2.5e+09,22,17,56,95
835890000,7250000,2120000,0,1654740000,2.5e+09,14,10,42,66
1137950000,1930000,0,0,1360120000,2.5e+09,18,15,47,80
459920000,1930000,0,0,2038150000,2.5e+09,15,13,43,71
496670000,55660000,22360000,4e+05,1696420000,2271510000,29,30,71,130
470950000,58840000,2e+06,320000,1562790000,2094900000,30,30,74,134
491290000,24270000,40520000,3270000,1940650000,2.5e+09,32,34,75,141
1672710000,63460000,12260000,16550000,735020000,2.5e+09,29,26,68,123
1604750000,2380000,3320000,6640000,882910000,2.5e+09,19,11,50,80
1302700000,8600000,6080000,4090000,1178530000,2.5e+09,18,20,52,90
1584420000,5850000,1910000,0,907820000,2.5e+09,31,27,71,129
1765180000,1310000,11490000,2950000,719070000,2.5e+09,30,30,67,127
621650000,0,0,0,1878350000,2.5e+09,20,16,48,84
495850000,160930000,25670000,1280000,1619350000,2303080000,36,35,92,163
1622430000,59050000,12710000,19920000,785890000,2.5e+09,27,30,73,130
1763610000,13040000,13090000,770000,709490000,2.5e+09,29,30,69,128
1713870000,14540000,7210000,12670000,751710000,2.5e+09,28,28,72,128
1377820000,353250000,35020000,226190000,507720000,2.5e+09,30,25,69,124
214810000,573480000,52500000,69630000,1589580000,2.5e+09,27,22,72,121
1866070000,281230000,25310000,121220000,206170000,2.5e+09,26,19,73,118
797410000,1158150000,75450000,224170000,244820000,2.5e+09,26,24,66,116
1394870000,555150000,49570000,275030000,225380000,2.5e+09,28,22,75,125
944680000,669720000,101140000,680240000,104220000,2.5e+09,27,23,71,121
1383720000,440390000,38510000,101570000,535810000,2.5e+09,29,20,69,118
100590000,650500000,34620000,30380000,1582890000,2398980000,31,27,71,129
940180000,804260000,42030000,116540000,596990000,2.5e+09,28,23,76,127
198580000,696010000,26490000,40900000,1516570000,2478550000,26,27,65,118
1612470000,400360000,40430000,131620000,315120000,2.5e+09,30,23,76,129
678790000,1089260000,91550000,297200000,343200000,2.5e+09,36,28,77,141
1155960000,728540000,84630000,292750000,238120000,2.5e+09,36,26,88,150
1422230000,652280000,118130000,120810000,186550000,2.5e+09,28,27,78,133
1441570000,395720000,117480000,406220000,139010000,2.5e+09,27,19,64,110
636740000,1113610000,197280000,479580000,72790000,2.5e+09,29,25,76,130
1375380000,469430000,77380000,358980000,218830000,2.5e+09,26,21,69,116
899420000,775240000,78770000,597250000,149320000,2.5e+09,31,25,77,133
1414400000,107660000,42100000,619570000,229350000,2413080000,22,18,50,90
1444860000,122330000,58900000,527260000,241680000,2395030000,21,16,50,87
1561920000,237240000,33040000,359280000,308520000,2.5e+09,21,17,51,89
1055950000,880360000,21210000,106080000,436400000,2.5e+09,29,24,73,126
394200000,1033970000,47890000,94340000,929600000,2.5e+09,38,33,85,156
1.11e+08,2009410000,63640000,139890000,176060000,2.5e+09,22,18,50,90
538350000,1328860000,61710000,245310000,325770000,2.5e+09,38,29,75,142
334210000,1629120000,95200000,257710000,183760000,2.5e+09,31,25,70,126
159540000,1800420000,65130000,268900000,206010000,2.5e+09,29,23,67,119
929140000,1102540000,107410000,147510000,213400000,2.5e+09,25,24,67,116
1100730000,909450000,104700000,153990000,231130000,2.5e+09,32,30,78,140
869390000,1218840000,133940000,127760000,150070000,2.5e+09,27,26,71,124
659460000,1426690000,105340000,200460000,108050000,2.5e+09,34,30,82,146
229460000,1846010000,170640000,104310000,149580000,2.5e+09,34,27,74,135
460740000,1604110000,124170000,140250000,170730000,2.5e+09,33,26,77,136
313830000,1827980000,119950000,86790000,151450000,2.5e+09,36,30,86,152
508950000,1664570000,133730000,106900000,85850000,2.5e+09,23,24,62,109
243800000,1511030000,517980000,101790000,125400000,2.5e+09,28,22,65,115
1072620000,880830000,117790000,331750000,97010000,2.5e+09,24,25,65,114
1557890000,354920000,112020000,401960000,73210000,2.5e+09,21,17,52,90
1834750000,181550000,47670000,336150000,99880000,2.5e+09,19,19,52,90
1639740000,267750000,66740000,317640000,208130000,2.5e+09,23,19,51,93
1679170000,279360000,99820000,298220000,143430000,2.5e+09,22,20,55,97
493480000,1374900000,219790000,356460000,55370000,2.5e+09,26,23,62,111
1221370000,871020000,49250000,134090000,224270000,2.5e+09,39,32,84,155
653550000,130190000,22760000,22980000,1452920000,2282400000,36,28,89,153
749980000,1323080000,122910000,156660000,147370000,2.5e+09,28,25,75,128
460640000,1384670000,127620000,2.49e+08,278070000,2.5e+09,37,38,97,172
466270000,632970000,117910000,49130000,1233720000,2.5e+09,38,28,85,151
295230000,209590000,34390000,38370000,1673040000,2250620000,35,31,88,154
446440000,1609410000,146990000,109040000,188120000,2.5e+09,37,34,92,163
394760000,1777070000,128390000,110860000,88920000,2.5e+09,21,18,60,99
213140000,1939640000,156470000,71360000,119390000,2.5e+09,26,27,73,126
39730000,2014370000,103040000,299140000,43720000,2.5e+09,23,19,57,99
177350000,1416020000,81780000,222800000,35020000,1932970000,30,31,76,137
560420000,1453190000,162730000,270690000,52970000,2.5e+09,23,19,47,89
340870000,1293820000,137880000,264880000,63560000,2101010000,26,23,70,119
108510000,958340000,88240000,287240000,51260000,1493590000,30,29,75,134
417450000,1310970000,230650000,390300000,111810000,2461180000,31,29,74,134
159560000,362480000,66900000,61800000,43470000,694210000,30,26,67,123
31320000,1023590000,64040000,86690000,1283230000,2488870000,32,31,84,147
568380000,1339700000,98010000,273270000,220640000,2.5e+09,34,27,81,142
58730000,299180000,25670000,61220000,2055200000,2.5e+09,32,31,72,135
206100000,401590000,45290000,50500000,165340000,868820000,36,37,83,156
104880000,375250000,17700000,63240000,968030000,1529100000,35,35,81,151
739740000,1190160000,127640000,173580000,268880000,2.5e+09,28,33,90,151
1078540000,949170000,60550000,160100000,251640000,2.5e+09,29,28,86,143
832530000,980940000,232550000,253990000,199990000,2.5e+09,31,34,88,153
1123630000,687430000,35200000,208040000,170580000,2224880000,33,32,92,157
719440000,1502280000,90490000,82350000,105440000,2.5e+09,29,28,76,133
725650000,1433330000,73450000,8.3e+07,184570000,2.5e+09,27,24,72,123
744620000,1340850000,58660000,174900000,180970000,2.5e+09,30,27,80,137
584740000,1473800000,61590000,190660000,189210000,2.5e+09,29,29,76,134
271700000,120000,340000,71290000,53190000,396640000,27,20,58,105
235390000,38590000,17790000,23810000,22740000,338320000,27,19,57,103
0,0,0,0,0,0,30,32,84,146
15930000,55070000,3360000,21080000,560000,9.6e+07,28,27,80,135
715160000,90110000,7630000,37750000,137980000,988630000,33,33,91,157
720190000,310710000,40380000,89480000,158380000,1319140000,31,35,87,153
0,0,0,0,0,0,31,38,90,159
789570000,1111460000,40810000,289020000,269140000,2.5e+09,29,36,90,155
1162320000,709390000,60500000,240260000,327530000,2.5e+09,35,36,95,166
702580000,527090000,69230000,249240000,360670000,1908810000,33,35,97,165
270090000,634400000,21790000,128950000,176910000,1232140000,34,38,96,168
139510000,1331990000,160110000,423330000,44240000,2099180000,27,27,73,127
229830000,226530000,11410000,98320000,96760000,662850000,34,38,97,169
11950000,222140000,19080000,49660000,36790000,339620000,25,25,66,116
935590000,1014360000,49770000,194670000,305610000,2.5e+09,29,28,81,138
338580000,1984890000,73650000,28840000,74040000,2.5e+09,28,24,76,128
1133590000,563940000,36060000,224420000,541990000,2.5e+09,33,31,82,146
7.76e+08,1330400000,41020000,136180000,216400000,2.5e+09,30,29,86,145
742130000,245580000,341820000,140920000,1029550000,2.5e+09,32,32,89,153
963090000,790170000,19180000,126520000,601040000,2.5e+09,30,32,85,147
1092250000,614420000,40010000,243020000,510300000,2.5e+09,32,30,80,142
1183430000,431710000,42780000,103920000,738160000,2.5e+09,32,32,100,164
1144310000,602020000,16850000,105700000,631120000,2.5e+09,33,33,94,160
893500000,478570000,229300000,416150000,482480000,2.5e+09,34,32,91,157
1322890000,579590000,30230000,223680000,343610000,2.5e+09,29,28,81,138
908280000,335860000,447570000,1310000,806980000,2.5e+09,33,36,102,171
1461880000,497040000,7.7e+07,0,464080000,2.5e+09,33,35,88,156
1461930000,697120000,122470000,720000,217760000,2.5e+09,34,34,89,157
1823920000,142940000,24870000,0,508270000,2.5e+09,34,34,83,151
1507040000,335700000,25510000,0,631750000,2.5e+09,33,32,86,151
1889930000,169140000,9870000,0,431060000,2.5e+09,31,30,86,147
2034880000,56180000,12700000,0,396240000,2.5e+09,33,31,84,148
1565040000,412400000,22020000,0,500540000,2.5e+09,33,31,84,148
1699900000,175090000,6700000,0,618310000,2.5e+09,29,32,82,143
981600000,636350000,35230000,280140000,566680000,2.5e+09,32,28,82,142
681660000,841260000,12800000,285430000,678850000,2.5e+09,33,36,99,168
1145060000,675030000,34230000,187880000,457800000,2.5e+09,30,29,82,141
1022710000,450400000,11300000,444090000,571500000,2.5e+09,32,31,79,142
1265020000,5.69e+08,12090000,280260000,373630000,2.5e+09,32,27,77,136
1156110000,612520000,25500000,306050000,399820000,2.5e+09,32,29,88,149
1061920000,816590000,34230000,106740000,480520000,2.5e+09,30,31,80,141
1125130000,776270000,33370000,124540000,440690000,2.5e+09,31,30,83,144
911680000,1025610000,71660000,124740000,366310000,2.5e+09,32,34,92,158
1076330000,1088370000,32490000,138640000,164170000,2.5e+09,30,28,84,142
1247620000,569800000,26740000,182480000,473360000,2.5e+09,32,33,88,153
1147540000,877580000,36650000,156500000,281730000,2.5e+09,30,26,74,130
1036770000,764380000,46680000,184930000,467240000,2.5e+09,33,33,90,156
1308100000,721810000,29670000,134780000,305640000,2.5e+09,32,31,83,146
548300000,185780000,66040000,350000,1663320000,2463790000,32,37,96,165
206080000,29220000,5760000,15870000,1882340000,2139270000,30,32,87,149
145650000,7790000,9040000,0,2006560000,2169040000,28,31,80,139
1391380000,443480000,135420000,0,529720000,2.5e+09,31,34,82,147
1357030000,921630000,61410000,530000,159400000,2.5e+09,31,34,86,151
1599160000,242250000,54390000,0,604200000,2.5e+09,33,32,89,154
1356460000,740120000,96920000,0,306500000,2.5e+09,35,35,97,167
1663310000,158360000,47540000,0,630790000,2.5e+09,34,31,80,145
1355740000,182160000,12860000,0,949240000,2.5e+09,30,32,78,140
1753930000,81260000,9850000,0,654960000,2.5e+09,31,31,79,141
1689760000,76080000,9920000,0,724240000,2.5e+09,29,29,71,129
1698720000,102280000,13440000,0,685560000,2.5e+09,32,30,77,139
1731170000,208040000,117330000,0,443460000,2.5e+09,34,33,80,147
1472860000,135760000,4120000,0,887260000,2.5e+09,30,31,78,139
1626890000,151920000,10050000,0,711140000,2.5e+09,31,30,83,144
1802560000,399900000,12490000,370000,284680000,2.5e+09,33,33,82,148
1822590000,125780000,7620000,0,544010000,2.5e+09,30,32,85,147
1743440000,345240000,10720000,0,400600000,2.5e+09,31,32,78,141
1796250000,181150000,4520000,0,518080000,2.5e+09,31,30,76,137
651380000,903760000,35570000,508090000,401200000,2.5e+09,29,32,83,144
833790000,683140000,16450000,411750000,548120000,2493250000,30,29,82,141
349010000,169640000,4560000,177730000,211360000,912300000,34,37,96,167
9.04e+08,390140000,14630000,129120000,275350000,1713240000,29,27,76,132
936890000,626610000,16840000,295370000,509720000,2385430000,31,29,86,146
395750000,245880000,6590000,26540000,837480000,1512240000,33,32,87,152
852270000,684800000,37210000,82920000,306510000,1963710000,31,28,84,143
1010280000,250480000,53550000,1.21e+08,1064690000,2.5e+09,35,32,91,158
333560000,71540000,7040000,26180000,1167430000,1605750000,34,31,79,144
1752710000,199070000,14650000,0,533570000,2.5e+09,29,31,83,143
1557400000,311350000,60140000,0,560710000,2489600000,34,39,99,172
1009820000,286330000,105580000,0,835960000,2237690000,34,36,90,160
1718860000,166800000,11660000,0,602680000,2.5e+09,33,31,80,144
1678070000,93630000,37420000,0,690880000,2.5e+09,32,34,81,147
1320860000,148090000,12950000,0,1018100000,2.5e+09,31,30,76,137
1556160000,46090000,3970000,0,893780000,2.5e+09,28,28,74,130
1369210000,196190000,72240000,0,862360000,2.5e+09,32,32,78,142
1701140000,105370000,44750000,0,648740000,2.5e+09,34,31,83,148
1636050000,177150000,10330000,0,676470000,2.5e+09,30,30,77,137
1689820000,41470000,12300000,0,756410000,2.5e+09,26,27,71,124
1827920000,205730000,6310000,870000,459170000,2.5e+09,31,31,70,132
1582050000,397670000,24290000,0,495990000,2.5e+09,34,31,81,146
2056060000,86210000,2210000,0,355520000,2.5e+09,31,28,75,134
1906270000,116480000,12640000,0,464610000,2.5e+09,30,30,76,136
1393290000,111710000,23730000,0,971270000,2.5e+09,31,32,85,148
951240000,159340000,11290000,0,628750000,1750620000,35,34,87,156
1625560000,186390000,40770000,0,647280000,2.5e+09,32,34,89,155
1207080000,259010000,51540000,0,982370000,2.5e+09,34,34,87,155
2124260000,43090000,0,0,331580000,2498930000,28,29,77,134
1479670000,117750000,12640000,0,889940000,2.5e+09,31,30,80,141
861500000,151020000,36900000,3610000,1437450000,2490480000,38,37,101,176
1682100000,473130000,39890000,0,304880000,2.5e+09,37,33,90,160
280210000,9930000,41830000,2050000,2147600000,2481620000,35,35,88,158
1423930000,28460000,970000,70000,1046570000,2.5e+09,26,28,64,118
1637180000,209060000,54400000,12230000,587130000,2.5e+09,33,30,82,145
1338160000,625210000,41750000,11310000,483570000,2.5e+09,40,33,98,171
1745170000,318210000,12330000,0,424290000,2.5e+09,33,32,79,144
1465510000,149400000,9640000,0,875450000,2.5e+09,34,32,84,150
1626360000,146720000,5010000,0,721910000,2.5e+09,34,34,79,147
1274850000,57610000,6900000,0,1160640000,2.5e+09,33,35,84,152
1016530000,93600000,172750000,4010000,1213110000,2.5e+09,41,39,101,181
1339800000,32240000,270000,0,1127690000,2.5e+09,27,30,66,123
1632090000,39420000,2400000,0,826090000,2.5e+09,28,30,79,137
1627820000,15120000,53860000,0,803200000,2.5e+09,32,34,81,147
1568530000,73170000,2230000,310000,855760000,2.5e+09,31,31,72,134
1926960000,12480000,3280000,0,557280000,2.5e+09,29,28,74,131
1505280000,25800000,3030000,0,965890000,2.5e+09,25,27,65,117
1657770000,5890000,1480000,0,834860000,2.5e+09,25,25,62,112
1948690000,11220000,720000,0,539370000,2.5e+09,22,26,63,111
1543270000,20650000,10250000,0,925830000,2.5e+09,25,24,67,116
1728010000,6020000,0,0,765970000,2.5e+09,23,21,61,105
1560510000,1850000,0,0,937640000,2.5e+09,24,16,59,99
1514210000,10610000,14140000,0,961040000,2.5e+09,28,24,65,117
1.619e+09,0,0,0,8.81e+08,2.5e+09,19,19,56,94
1364050000,1300000,0,0,1134650000,2.5e+09,26,25,59,110
1677250000,770000,0,0,821980000,2.5e+09,16,9,43,68
1460080000,0,0,20000,1039900000,2.5e+09,23,17,51,91
1344920000,0,0,0,1155080000,2.5e+09,27,19,55,101
1867040000,290000,1380000,0,631290000,2.5e+09,28,24,62,114
417940000,13190000,4720000,0,2064150000,2.5e+09,27,24,62,113
1122940000,2490000,0,0,1374570000,2.5e+09,20,14,43,77
194710000,0,0,0,2305290000,2.5e+09,18,13,50,81
629530000,4070000,0,0,1866400000,2.5e+09,28,21,62,111
1170000,0,6e+05,0,2498230000,2.5e+09,15,9,33,57
181240000,8300000,1120000,0,2309340000,2.5e+09,19,11,45,75
1649640000,27300000,3170000,0,819890000,2.5e+09,29,29,75,133
1773910000,22110000,7030000,0,696950000,2.5e+09,27,29,75,131
1773280000,68320000,11230000,0,647170000,2.5e+09,30,33,80,143
1812220000,18560000,0,0,669220000,2.5e+09,28,32,74,134
1520250000,14560000,0,0,965190000,2.5e+09,25,29,71,125
1463120000,17120000,5070000,0,1014690000,2.5e+09,28,28,71,127
1758190000,19920000,11010000,0,710880000,2.5e+09,24,26,66,116
1851790000,15380000,1710000,0,631120000,2.5e+09,26,30,64,120
1748710000,19790000,0,0,731410000,2499910000,28,28,71,127
1560760000,9360000,0,0,929880000,2.5e+09,27,27,62,116
1692170000,16160000,7310000,0,784360000,2.5e+09,29,30,73,132
1720930000,5610000,1140000,0,772320000,2.5e+09,25,25,64,114
1768500000,320000,1820000,0,729360000,2.5e+09,28,23,63,114
1.18e+09,0,0,0,1.32e+09,2.5e+09,26,19,57,102
1719010000,0,0,0,775720000,2494730000,19,17,56,92
1258820000,0,0,0,1241180000,2.5e+09,28,22,62,112
1852610000,3380000,10250000,0,633760000,2.5e+09,32,28,72,132
737140000,33650000,2400000,0,1726810000,2.5e+09,25,20,61,106
4.42e+08,0,0,0,2.058e+09,2.5e+09,24,23,57,104
410590000,23670000,5050000,0,2060690000,2.5e+09,25,20,57,102
1111720000,3080000,960000,0,1384240000,2.5e+09,32,27,64,123
304470000,18440000,230000,0,2176860000,2.5e+09,18,13,42,73
86450000,7430000,2370000,0,2403750000,2.5e+09,19,14,49,82
1543740000,9130000,280000,0,756450000,2309600000,25,24,61,110
1746770000,22260000,6630000,0,718560000,2494220000,30,29,74,133
1430440000,8650000,0,0,477980000,1917070000,29,29,61,119
1033180000,4970000,0,0,624090000,1662240000,24,27,68,119
1483150000,51760000,18150000,0,618210000,2171270000,35,35,85,155
720540000,1382320000,249050000,88850000,59240000,2.5e+09,29,23,75,127
1863370000,31950000,7380000,0,597300000,2.5e+09,33,31,89,153
1911620000,92500000,6460000,0,394790000,2405370000,34,35,87,156
1585430000,21980000,10070000,0,435780000,2053260000,31,32,82,145
3700000,706980000,98280000,32150000,1503430000,2344540000,27,22,65,114
887140000,565650000,62850000,340930000,643430000,2.5e+09,33,28,83,144
0,6450000,280000,0,2238680000,2245410000,17,14,44,75
1295320000,5747200000,1830530000,1090840000,111790000,10075680000,40,31,92,163
6641200000,2488720000,637060000,1170550000,734420000,11671950000,33,26,80,139
2697290000,22480000,6610000,0,1656350000,4382730000,29,20,65,114
2510020000,4036270000,1106910000,2445820000,347370000,10446390000,35,35,86,156
3494620000,2447030000,1067070000,1977530000,325630000,9311880000,31,25,73,129
4806940000,1720000,20950000,2570000,2582620000,7414800000,31,25,78,134
493150000,884660000,105380000,501050000,2981370000,4965610000,31,34,87,152
2816320000,4677890000,883630000,489310000,1203820000,10070970000,29,22,75,126
1114980000,2264620000,1799110000,2986490000,2518420000,10683620000,31,21,76,128
7634070000,1336810000,51540000,370000,2086150000,11108940000,33,33,80,146
1734010000,1836600000,523750000,840570000,180160000,5115090000,16,15,57,88
10544490000,94490000,47380000,0,4124600000,14810960000,29,33,96,158
6519150000,438210000,100980000,6590000,5446970000,12511900000,29,23,78,130
6719890000,3491260000,407400000,127780000,7220820000,17967150000,30,25,87,142
3432740000,3302740000,66450000,1339590000,2610490000,10752010000,33,33,89,155
5.527e+09,2803710000,1081400000,118930000,4503550000,14034590000,40,37,94,171
817150000,6459620000,323170000,391340000,2308430000,10299710000,29,30,78,137
2493510000,651100000,63770000,9920000,11080580000,14298880000,31,25,73,129
4958770000,384060000,32090000,83410000,7154810000,12613140000,31,27,90,148
3487270000,6749880000,639780000,2059300000,381190000,13317420000,35,30,78,143
5572960000,2905120000,564950000,760240000,539230000,10342500000,36,37,98,171
1933700000,6794250000,476230000,1136320000,120910000,10461410000,37,34,84,155
3346150000,4874940000,651480000,1078700000,747010000,10698280000,32,36,90,158
9560040000,1647760000,232750000,318780000,7173880000,18933210000,31,32,95,158
3474780000,4858430000,658180000,1065190000,285300000,10341880000,37,29,91,157
4421140000,810260000,224830000,21120000,13394710000,18872060000,33,29,87,149
3739300000,6.176e+09,396450000,948850000,3267190000,14527790000,27,22,79,128
202980000,3189130000,285660000,1247240000,420650000,5345660000,34,37,99,170
2472990000,3701680000,999870000,1397940000,222620000,8795100000,26,23,81,130
658630000,3345840000,247720000,134740000,4829360000,9216290000,35,35,85,155
3484190000,4217570000,197980000,1801720000,3110910000,12812370000,35,26,93,154
2218180000,6969500000,326880000,802940000,395170000,10712670000,32,38,97,167
2153340000,260030000,58760000,4170000,6319630000,8795930000,29,24,77,130
854160000,2712810000,610070000,3841160000,1108270000,9126470000,38,37,103,178
1166460000,7446580000,581060000,1793600000,123540000,11111240000,31,23,65,119
2111060000,5940930000,763700000,1235670000,250900000,10302260000,32,34,72,138
2741360000,365120000,547450000,774980000,3761820000,8190730000,36,37,99,172
433370000,8609130000,607090000,860070000,178770000,10688430000,30,31,80,141
1248450000,5138410000,1064960000,887700000,741460000,9080980000,37,30,84,151
3063600000,5921630000,399610000,518930000,921140000,10824910000,31,26,72,129
1790700000,8388070000,346980000,1082140000,1255080000,12862970000,30,23,74,127
7235450000,2524770000,601560000,2069140000,491460000,12922380000,31,34,95,160
7540190000,1549590000,149330000,1450000,2461660000,11702220000,29,21,69,119
11066540000,89750000,23540000,46710000,7234790000,18461330000,31,30,83,144
8526630000,5476450000,1844390000,3459540000,793990000,2.0101e+10,35,31,84,150
7834480000,284350000,45390000,22300000,2586760000,10773280000,40,31,92,163
3742140000,6240880000,1399320000,598120000,9002020000,20982480000,27,23,79,129
2722320000,6829560000,837340000,311470000,241600000,10942290000,37,38,101,176
250680000,583180000,53760000,1354230000,6941610000,9183460000,28,17,63,108
447120000,655340000,169170000,2619970000,9297790000,13189390000,36,35,87,158
7650290000,3.114e+09,682550000,962750000,6367810000,18777400000,31,35,96,162
1383480000,2364860000,160110000,331880000,4307340000,8547670000,28,28,83,139
4070960000,880860000,1938650000,2742430000,442720000,10075620000,24,17,56,97
1898880000,530390000,141200000,959730000,90860000,3621060000,27,23,64,114
7733090000,355790000,77020000,10480000,2185980000,10362360000,32,30,88,150
6.787e+09,375340000,17250000,870000,1326850000,8507310000,34,37,88,159
2621760000,2836190000,145170000,845330000,976130000,7424580000,38,30,81,149
9364150000,124970000,75370000,32510000,4086380000,13683380000,31,28,88,147
1017680000,880940000,84740000,381270000,479280000,2843910000,32,32,91,155
3455930000,2496310000,406830000,336870000,3268440000,9964380000,29,26,87,142
2046400000,5319900000,253910000,330990000,721660000,8672860000,40,31,101,172
1657370000,2696480000,382430000,55810000,3763160000,8555250000,43,37,99,179
6825800000,1080710000,234740000,0,2947610000,11088860000,34,31,83,148
398540000,2056010000,755700000,1188910000,2773090000,7172250000,25,20,64,109
3.459e+09,2904840000,433870000,1856920000,531640000,9186270000,36,34,98,168
684560000,829850000,793670000,3803560000,4706720000,10818360000,40,31,98,169
6694770000,3508010000,383520000,1879600000,3.51e+08,12816900000,29,25,90,144
3869920000,911490000,288800000,1060000,4354260000,9425530000,35,32,82,149
4207100000,2878360000,419800000,2371880000,459760000,10336900000,37,33,106,176
3228210000,4764020000,292730000,177480000,613800000,9076240000,33,36,97,166
327190000,8118300000,953560000,35920000,1472480000,10907450000,31,26,81,138
2973840000,5576380000,548320000,946950000,301450000,10346940000,28,30,88,146
1941600000,9879980000,999760000,1501930000,1403040000,15726310000,32,30,89,151
6207320000,4239060000,1395450000,1705330000,284590000,13831750000,34,33,88,155
307190000,5244440000,913060000,1705800000,2616800000,10787290000,26,26,67,119
2202760000,235050000,33830000,6170000,6442980000,8920790000,32,30,84,146
5269340000,2281910000,232140000,5943310000,457340000,14184040000,39,36,100,175
3205760000,4764860000,259730000,688940000,1813950000,10733240000,21,18,65,104
3146380000,64320000,18150000,0,1199430000,4428280000,35,29,85,149
4446840000,1094440000,174220000,47860000,4432280000,10195640000,31,19,70,120
3834430000,3371560000,934570000,1735410000,471440000,10347410000,38,35,96,169
7597390000,610700000,30260000,0,2865630000,11103980000,34,33,102,169
3715610000,427010000,80490000,0,1568880000,5791990000,27,33,93,153
1639170000,7754630000,99220000,2428350000,3120720000,15042090000,33,27,78,138
4823400000,571140000,19020000,0,8693400000,14106960000,34,31,97,162
2855680000,5523820000,435940000,402340000,782530000,10000310000,33,34,97,164
1962680000,7.396e+09,94260000,508660000,825440000,10787040000,27,20,64,111
1359900000,1055770000,46090000,117980000,1162530000,3742270000,32,28,102,162
2579150000,6624360000,871430000,540980000,286900000,10902820000,36,34,91,161
2819570000,451710000,275370000,1391940000,5142490000,10081080000,34,34,98,166
8357670000,6940060000,308370000,1320380000,1187540000,18114020000,33,26,73,132
3498010000,3693380000,1424310000,1277560000,188480000,10081740000,36,26,91,153
5984950000,503760000,408220000,1254220000,765080000,8916230000,40,36,99,175
438100000,4071430000,1894880000,3164750000,1263800000,10832960000,37,37,105,179
1129950000,3835490000,266250000,805650000,1.45e+08,6182340000,35,40,103,178
8935150000,1646460000,198500000,31580000,6229540000,17041230000,25,18,56,99
1053100000,4794840000,425240000,212830000,2554970000,9040980000,37,33,88,158
2971220000,4.622e+09,712140000,851480000,451110000,9607950000,31,32,80,143
305920000,562220000,88100000,3427080000,1177780000,5561100000,35,22,83,140
4890830000,691550000,44320000,1478730000,3340860000,10446290000,35,31,91,157
2002210000,5298550000,77110000,805850000,3596930000,11780650000,34,27,91,152
164690000,1328660000,122630000,394500000,87090000,2097570000,32,31,96,159
2803360000,1554850000,225840000,456930000,465010000,5505990000,30,28,92,150
2191800000,272690000,36480000,30130000,11117220000,13648320000,35,37,106,178
4396880000,2440350000,558300000,2583810000,102240000,10081580000,25,18,73,116
2178680000,4642040000,192060000,162600000,4741660000,11917040000,32,28,86,146
5073290000,2719060000,339630000,1043300000,1908160000,11083440000,34,35,87,156
5694550000,510420000,92090000,12100000,4462690000,10771850000,42,36,96,174
8728350000,211140000,51220000,44080000,5079140000,14113930000,28,21,77,126
4725650000,1984920000,662910000,420000,2134840000,9508740000,38,28,93,159
2378990000,4052830000,1051620000,1180900000,131540000,8795880000,36,36,96,168
2762270000,6248660000,664780000,737040000,294890000,10707640000,33,37,102,172
1999620000,1096120000,33400000,466400000,839530000,4435070000,33,25,79,137
1043500000,6776470000,389200000,488220000,5851830000,14549220000,35,40,101,176
3267090000,3808320000,549670000,1180130000,339340000,9144550000,30,22,78,130
1613830000,376650000,124960000,1935880000,13777250000,17828570000,32,22,71,125
3216730000,7416990000,478820000,351730000,986710000,12450980000,30,28,78,136
1334950000,9613300000,971950000,353060000,11951330000,24224590000,31,25,75,131
3360730000,9212570000,789040000,1390950000,392530000,15145820000,40,28,100,168
1338720000,8480600000,221910000,267540000,1360170000,11668940000,30,32,90,152
1031290000,3011780000,331840000,600520000,131570000,5.107e+09,33,27,88,148
2171940000,1515100000,146740000,811290000,245970000,4891040000,31,28,74,133
4140720000,3422370000,33840000,1500650000,1665670000,10763250000,22,17,54,93
1043200000,6211680000,459910000,668470000,3794650000,12177910000,31,31,97,159
2447490000,3935120000,683530000,1270030000,579630000,8915800000,34,26,87,147
7223150000,100400000,26150000,4210000,3013680000,10367590000,37,35,96,168
2173530000,6997880000,395450000,1409300000,6308260000,17284420000,32,31,92,155
2166540000,1969640000,60560000,1256990000,1398970000,6852700000,28,31,92,151
748630000,3946530000,367550000,227240000,3568330000,8858280000,27,24,72,123
134320000,1516980000,262630000,1473220000,5952450000,9339600000,33,30,89,152
5570710000,1256800000,309590000,1247790000,801760000,9186650000,30,32,96,158
4834810000,2299520000,142720000,2022880000,1472080000,10772010000,34,29,85,148
3405890000,10218180000,1453500000,2824920000,2859160000,20761650000,35,32,99,166
5126960000,2611630000,336170000,3087290000,2487850000,13649900000,23,16,58,97
6825290000,296390000,28410000,0,3964370000,11114460000,33,37,95,165
681390000,6459870000,182010000,104920000,1667230000,9095420000,32,38,103,173
5363920000,3287410000,545020000,2496230000,141510000,11834090000,38,30,101,169
590160000,3681040000,384190000,255150000,108870000,5019410000,31,34,88,153
4157350000,3421190000,294770000,500100000,1507700000,9881110000,25,16,50,91
843360000,4252360000,1019700000,3631010000,3090810000,12837240000,31,26,87,144
7091490000,3078120000,243400000,807270000,5156950000,16377230000,22,22,65,109
4082350000,181650000,82040000,0,4103620000,8449660000,27,23,85,135
4867390000,7458870000,403200000,486020000,4014030000,17229510000,35,29,79,143
4122920000,116690000,19510000,0,18753710000,23012830000,36,37,93,166
975760000,2594920000,200850000,509940000,3853800000,8135270000,33,37,104,174
2181900000,1863810000,285360000,504620000,425230000,5260920000,31,33,78,142
3566390000,906200000,249740000,22880000,4175970000,8921180000,32,33,99,164
2160710000,6221530000,626480000,243810000,3667550000,12920080000,29,28,80,137
9042020000,2533460000,602110000,166840000,6773350000,19117780000,33,35,96,164
4636470000,3424330000,713630000,1813260000,130450000,10718140000,33,33,91,157
1468410000,5282420000,928680000,2124990000,277360000,10081860000,37,40,101,178
2107330000,4417370000,244620000,510290000,642370000,7921980000,43,42,106,191
6357470000,7351620000,956680000,4172480000,361410000,19199660000,28,28,65,121
14140850000,5183140000,512440000,370680000,3552600000,23759710000,32,20,68,120
3861230000,45980000,3640000,74250000,6392340000,10377440000,25,19,56,100
390930000,265840000,96440000,4285010000,512850000,5551070000,30,28,80,138
3447830000,5165590000,679530000,870110000,550260000,10713320000,32,22,76,130
2405200000,1835170000,138580000,542280000,509600000,5430830000,33,35,101,169
5701120000,914740000,144410000,68720000,11767680000,18596670000,36,29,93,158
3973700000,3757960000,458780000,717680000,163320000,9071440000,33,31,86,150
3453910000,4744440000,682160000,1326640000,500580000,10707730000,35,35,94,164
3756110000,4673510000,484390000,1248990000,173880000,10336880000,37,30,96,163
3752400000,1773270000,166700000,1430330000,5234440000,12357140000,34,27,74,135
905890000,4898510000,802690000,2916620000,3033180000,12556890000,28,21,66,115
7807530000,22440000,20800000,13420000,4472600000,12336790000,30,32,94,156
3625010000,3666880000,110310000,992120000,2373930000,10768250000,34,35,92,161
6948800000,2463380000,397260000,0,2275580000,12085020000,38,26,93,157
211040000,551890000,112330000,2125420000,2550400000,5551080000,32,35,97,164
2459160000,6658800000,424540000,600660000,579620000,10722780000,24,19,66,109
2461510000,6313470000,964990000,404880000,197670000,10342520000,37,32,101,170
3249880000,4970440000,228100000,588710000,1208160000,10245290000,28,28,81,137
3246420000,9979080000,697130000,297290000,1040080000,1.526e+10,37,34,92,163
542600000,4412710000,565980000,460490000,7584060000,13565840000,40,34,96,170
5269820000,4416400000,627970000,3135140000,287630000,13736960000,34,29,80,143
2079940000,3923910000,292480000,630750000,4.435e+09,11362080000,30,25,88,143
3682840000,6689900000,635090000,878890000,695440000,12582160000,28,29,89,146
3404740000,3012730000,153620000,640750000,770830000,7982670000,40,40,108,188
1089480000,2661100000,603330000,6972310000,3211940000,14538160000,36,35,103,174
2477840000,1072030000,257380000,760310000,778090000,5345650000,37,38,98,173
423330000,1751970000,119700000,131850000,3129230000,5556080000,38,31,87,156
4.243e+09,87750000,25830000,0,20785720000,25142300000,31,31,91,153
3022490000,258070000,114070000,1221280000,501780000,5117690000,35,33,92,160
4640010000,4141190000,184350000,547930000,1560370000,11073850000,30,34,93,157
9053860000,3369430000,446350000,72480000,2597860000,15539980000,35,32,92,159
404220000,6745160000,467690000,826040000,305800000,8748910000,34,24,79,137
3706210000,35170000,10450000,359020000,8556360000,12667210000,32,33,90,155
3068710000,5690320000,373350000,2006200000,293720000,11432300000,36,32,90,158
3983430000,1948990000,138380000,486040000,3444660000,10001500000,36,36,97,169
635840000,9909160000,2424270000,1318720000,3491070000,17779060000,31,30,93,154
1146180000,6985310000,69820000,1919990000,4654330000,14775630000,24,24,82,130
4315480000,6688140000,368070000,1024340000,320900000,12716930000,24,19,69,112
4991360000,3770770000,277830000,679430000,627480000,10346870000,30,30,92,152
1137390000,3877460000,128900000,827300000,13675770000,19646820000,30,28,78,136
533890000,8796020000,2663460000,4009220000,351130000,16353720000,33,36,100,169
8970250000,131110000,93300000,16360000,3466130000,12677150000,33,31,98,162
2438070000,5040450000,232070000,521250000,566630000,8798470000,42,33,102,177
3250160000,2162010000,1155340000,345790000,6382350000,13295650000,40,29,99,168
5001630000,2598390000,124460000,1352780000,1991660000,11068920000,28,22,65,115
7450830000,1466510000,109230000,0,2059100000,11085670000,26,25,63,114
403320000,295860000,110960000,3974710000,5436530000,10221380000,29,21,68,118
5088100000,193960000,55340000,0,8505210000,13842610000,42,32,93,167
1710470000,4393540000,747950000,1556450000,4828480000,13236890000,36,36,96,168
2477380000,2501310000,304280000,341670000,215260000,5839900000,24,18,61,103
2015180000,604830000,89200000,1980000,7172450000,9883640000,31,34,95,160
4131400000,5975800000,136660000,1531640000,2699630000,14475130000,31,25,82,138
2688810000,8235520000,688880000,607330000,657530000,12878070000,32,25,84,141
4015940000,4555850000,301290000,174680000,1028690000,10076450000,35,32,104,171
3232610000,4706980000,492940000,761590000,1136900000,10331020000,32,24,77,133
539380000,2595750000,258280000,584920000,996460000,4974790000,36,36,102,174
4260170000,5643530000,320830000,1825170000,988180000,13037880000,27,25,71,123
4311550000,2548410000,819780000,1787850000,1212610000,10680200000,30,31,95,156
2047470000,4058560000,829250000,83950000,5727050000,12746280000,37,33,88,158
3799530000,439280000,56260000,4180000,4015290000,8314540000,36,31,75,142
2730720000,1762500000,289130000,338670000,229660000,5350680000,29,27,85,141
2490130000,988280000,376610000,1168470000,1369360000,6392850000,31,26,87,144
3196240000,5234990000,552970000,128560000,432280000,9545040000,30,30,94,154
3699880000,3617080000,621490000,1150770000,1338080000,10427300000,29,31,96,156
508890000,3462510000,1359600000,1722780000,3843580000,10897360000,33,27,80,140
91580000,3377420000,415350000,192010000,2150920000,6227280000,35,33,97,165
1898600000,5369860000,674700000,840320000,297870000,9081350000,41,34,96,171
7288460000,132610000,27590000,0,2917790000,10366450000,33,34,80,147
4410330000,4271110000,537200000,797450000,330860000,10346950000,31,35,94,160
5189630000,2144530000,1223330000,5485340000,1074590000,15117420000,26,22,76,124
8196230000,4306490000,1049930000,5610000,8084240000,21642500000,29,28,74,131
3778870000,258650000,25340000,0,1503250000,5566110000,30,25,74,129
10983050000,41850000,40860000,5340000,5759570000,16830670000,33,27,91,151
4822940000,8584110000,675400000,1108480000,324050000,15514980000,34,36,103,173
2665180000,143650000,231990000,2650990000,4384330000,10076140000,43,31,98,172
2914580000,2826630000,269260000,4177860000,268840000,10457170000,29,32,95,156
7618120000,389680000,77350000,0,2803690000,10888840000,33,23,80,136
4.572e+09,5245050000,1416290000,2429100000,180080000,13842520000,38,26,84,148
3716260000,1039830000,100960000,1581990000,3130900000,9569940000,26,22,68,116
4247480000,3352460000,232500000,1160660000,1323030000,10316130000,30,28,76,134
2030260000,397280000,25570000,640000,7242720000,9696470000,31,19,70,120
2873830000,212070000,129180000,1374020000,581220000,5170320000,31,29,81,141
200280000,1608600000,177540000,1054860000,6255810000,9297090000,32,23,84,139
967980000,6122330000,473950000,708600000,429380000,8702240000,23,22,66,111
1731960000,5210930000,926750000,616470000,617930000,9104040000,32,26,88,146
756190000,211290000,56200000,1384950000,15534380000,17943010000,27,26,79,132
893170000,2294100000,236660000,2957530000,4308640000,10690100000,25,27,77,129
4825400000,4655680000,995980000,1010080000,4167310000,15654450000,36,31,86,153
1604610000,4320160000,307840000,2008880000,97100000,8338590000,29,25,77,131
1728970000,8098020000,249480000,261160000,439350000,10776980000,38,29,92,159
2281790000,378400000,13680000,7e+05,10118960000,12793530000,31,29,94,154
3280090000,1013820000,370740000,1863180000,2292830000,8820660000,33,32,91,156
1115960000,2551570000,162810000,453010000,6378480000,10661830000,25,19,61,105
4312730000,2468050000,730190000,1547120000,1273780000,10331870000,29,22,71,122
1314630000,4059130000,109550000,510540000,5058760000,11052610000,31,24,87,142
5442850000,7662820000,576380000,593130000,6239050000,20514230000,35,30,92,157
2624260000,7438490000,738150000,1085190000,1347820000,13233910000,27,22,67,116
628080000,4612820000,548580000,861800000,3799860000,10451140000,28,23,81,132
1268890000,5567550000,135860000,291280000,1827360000,9090940000,30,31,77,138
3183890000,3e+05,570000,157410000,7.334e+09,10676170000,32,30,91,153
8604040000,2655350000,329010000,884100000,3017630000,15490130000,39,37,104,180
702920000,2981270000,427550000,849460000,118010000,5079210000,34,26,96,156
708400000,3705600000,584980000,2103210000,477970000,7580160000,37,39,94,170
2365620000,6712960000,448850000,635290000,823170000,10985890000,42,34,97,173
4026320000,4101420000,298370000,1869040000,418080000,10713230000,33,27,77,137
241280000,597010000,534800000,5881970000,6582510000,13837570000,35,33,91,159
1781870000,537470000,143750000,1337900000,4345130000,8146120000,31,31,79,141
64250000,728160000,248750000,1891800000,6052170000,8985130000,38,41,98,177
7088090000,3232320000,517760000,4250000,5293940000,16136360000,28,23,76,127
5619360000,3445360000,787340000,886400000,1337510000,12075970000,33,34,94,161
2721490000,1598590000,457070000,1456010000,3852470000,10085630000,33,23,70,126
3893250000,5153340000,505980000,673410000,757750000,10983730000,30,32,87,149
2288670000,985160000,691130000,287760000,5893830000,10146550000,37,28,91,156
1911370000,2430710000,570260000,193800000,59150000,5165290000,33,30,85,148
5311660000,8159900000,152920000,2440370000,3005270000,19070120000,28,28,75,131
2658170000,6608480000,733300000,212440000,172880000,10385270000,35,25,86,146
4447570000,4480840000,413180000,751020000,244780000,10337390000,41,28,99,168
2907030000,5187690000,753710000,1169960000,62960000,10081350000,43,32,103,178
7374360000,1003430000,235390000,0,3360960000,11974140000,39,36,101,176
12491510000,2117770000,403220000,254870000,5535610000,20802980000,22,21,59,102
6393130000,69550000,18300000,4430000,3470030000,9955440000,29,26,78,133
3794800000,3299680000,1463020000,1308490000,486010000,1.0352e+10,36,38,86,160
6.89e+08,7122290000,2718400000,4164410000,168270000,14862370000,32,30,79,141
802730000,6433200000,651420000,5005890000,2332570000,15225810000,35,33,92,160
64700000,964260000,218880000,31470000,3355240000,4634550000,35,40,104,179
2415840000,106370000,73490000,22390000,2767640000,5385730000,35,27,90,152
1481860000,5605240000,2166960000,1326160000,579290000,11159510000,28,27,80,135
418810000,815960000,121990000,2357610000,1826670000,5541040000,40,34,103,177
6128430000,2997180000,227650000,1390590000,2020250000,12764100000,31,31,86,148
2127560000,5468990000,344280000,2379950000,141960000,10462740000,34,31,99,164
1515610000,5410930000,671340000,869130000,603470000,9070480000,32,25,74,131
582270000,9359110000,963960000,1419180000,6001710000,18326230000,29,25,72,126
2.722e+09,2148320000,479960000,104050000,3003510000,8457840000,33,31,93,157
1654230000,354360000,25810000,3330000,8049190000,10086920000,29,22,73,124
2481680000,7197160000,141320000,141700000,2613300000,12575160000,35,25,83,143
2284290000,6006210000,164840000,485500000,5718490000,14659330000,34,30,96,160
659880000,2881430000,576820000,3428860000,2534670000,10081660000,27,27,87,141
111520000,741380000,68270000,174010000,3829540000,4924720000,32,33,100,165
3071520000,4758310000,1691180000,741250000,440410000,10702670000,33,33,90,156
1722710000,1124320000,5.4e+07,294100000,2160540000,5355670000,33,30,94,157
2355570000,3460410000,430740000,471240000,3081740000,9799700000,35,32,92,159
789600000,4940500000,2770050000,1887810000,3499830000,13887790000,31,31,80,142
3282540000,4585750000,483050000,697770000,1282740000,10331850000,32,28,89,149
3661020000,3755190000,229200000,2683830000,128420000,10457660000,32,34,87,153
4117070000,3580950000,264050000,1783160000,12713160000,22458390000,30,27,72,129
8206600000,5723280000,1413850000,3080450000,438450000,18862630000,36,26,90,152
1823610000,1610570000,62360000,662980000,1361500000,5521020000,31,34,94,159
2075150000,6969480000,78660000,1022140000,897970000,11043400000,35,33,83,151
5058240000,389080000,53420000,0,3248700000,8749440000,33,28,71,132
2354240000,7806230000,646720000,3340650000,89720000,14237560000,35,34,103,172
2919990000,4310370000,175730000,635300000,874470000,8915860000,33,32,98,163
3609060000,2965610000,148820000,2986090000,733040000,10442620000,39,38,95,172
6493120000,239970000,24100000,6430000,2083290000,8846910000,35,36,95,166
1992020000,26800000,56600000,2033960000,11286680000,15396060000,32,32,90,154
2525080000,196030000,25760000,66730000,12584770000,15398370000,31,33,90,154
982220000,4507840000,462350000,1501170000,1661830000,9115410000,28,32,92,152
3834650000,4698430000,364520000,1075790000,374150000,10347540000,37,36,95,168
3118860000,2980520000,779190000,1830920000,1371530000,10081020000,30,23,87,140
8582800000,3990250000,4.32e+08,169200000,5760680000,18934930000,36,39,99,174
3807230000,4053980000,516010000,394380000,144370000,8915970000,36,33,89,158
7943010000,520840000,236660000,17370000,4146250000,12864130000,34,35,100,169
4172350000,3952080000,309170000,1811530000,206150000,10451280000,31,33,86,150
208980000,301740000,34870000,988470000,5979530000,7513590000,33,26,91,150
6970180000,10940000,11550000,195060000,16956820000,24144550000,32,28,80,140
4028620000,2077360000,342870000,18410000,6851400000,13318660000,29,20,73,122
3166610000,3125710000,220890000,1557610000,5374060000,13444880000,34,34,95,163
476600000,3493350000,682690000,2829200000,2631440000,10113280000,34,35,88,157
4535780000,4052710000,541280000,1068650000,139080000,10337500000,33,29,85,147
5115660000,6740030000,703430000,583010000,4215370000,17357500000,27,20,69,116
2568510000,2803210000,481150000,560010000,3333980000,9746860000,29,34,94,157
4865560000,319480000,102140000,16680000,5080760000,10384620000,29,27,69,125
489500000,2245360000,373990000,2756950000,3016710000,8882510000,32,36,89,157
2995730000,3192610000,873080000,45730000,3304200000,10411350000,40,42,104,186
4376210000,5246860000,836710000,9626900000,365050000,20451730000,37,39,103,179
4806430000,1471210000,139800000,3e+05,12396560000,18814300000,33,38,98,169
4349020000,1588810000,640400000,2961430000,687340000,1.0227e+10,32,29,85,146
4089310000,3610260000,713420000,1577750000,455690000,10446430000,29,24,74,127
12571050000,21230000,15070000,40000,9323720000,21931110000,34,27,84,145
1467250000,1631540000,203830000,371720000,2735050000,6409390000,31,25,81,137
5568080000,4819360000,1834090000,1422920000,188370000,13832820000,29,19,59,107
1274410000,8409860000,586070000,1619470000,917750000,12807560000,38,34,96,168
1316540000,159810000,22690000,460000,5984210000,7483710000,30,31,89,150
2984440000,1801920000,429070000,519140000,2714100000,8448670000,33,38,104,175
5770110000,11739080000,1597540000,954260000,395500000,20456490000,31,29,82,142
4752700000,278500000,307310000,2769020000,2218520000,10326050000,30,28,77,135
2390880000,9327800000,1580220000,2134710000,261780000,15695390000,31,32,83,146
1735570000,6499980000,1042110000,346300000,712220000,10336180000,33,26,83,142
58240000,2071090000,148560000,320000,3399340000,5677550000,32,33,73,138
944410000,4102730000,851500000,2785350000,294460000,8978450000,39,26,79,144
1121190000,4018150000,147220000,332580000,220820000,5839960000,32,27,92,151
1651960000,8863420000,1063940000,530830000,763170000,12873320000,31,31,93,155
4598040000,3129080000,397680000,1077800000,1575680000,10778280000,29,27,73,129
3456380000,1596230000,83100000,366810000,5358140000,10860660000,34,30,72,136
6061400000,15790000,1140000,0,3120260000,9198590000,35,27,78,140
4088990000,2236710000,251100000,3345550000,525200000,10447550000,40,39,101,180
1872730000,1011200000,309470000,7378750000,8430600000,19002750000,36,29,79,144
2631070000,7411960000,174620000,2094110000,7140840000,19452600000,33,34,87,154
104410000,625900000,737150000,1956250000,6238920000,9662630000,34,33,80,147
3181400000,5644740000,858660000,666150000,347120000,10698070000,31,26,84,141
7333210000,920200000,119360000,0,2731210000,11103980000,35,34,83,152
6117750000,14270000,16300000,23090000,4606810000,10778220000,37,36,103,176
1784320000,7751550000,453700000,217760000,250280000,10457610000,29,22,83,134
3468050000,7755050000,853700000,1663880000,148860000,13889540000,33,32,96,161
2097210000,3996680000,429860000,147280000,3548150000,10219180000,31,25,73,129
2138820000,1774930000,391510000,522920000,211640000,5039820000,36,39,104,179
2318060000,7629790000,206170000,2575910000,3804180000,16534110000,29,30,90,149
8217820000,643250000,201980000,0,2362270000,11425320000,31,35,97,163
3056400000,2781260000,244070000,483620000,3704530000,10269880000,33,32,81,146
3827250000,4893160000,393140000,253260000,2098790000,11465600000,44,41,106,191
11010390000,525170000,155970000,15060000,4056990000,15763580000,39,37,97,173
2592030000,4566930000,202860000,509500000,8074790000,15946110000,33,33,72,138
3887090000,1047100000,36810000,2170000,8432150000,13405320000,29,29,77,135
2838910000,3997210000,615990000,228810000,1229300000,8910220000,32,35,92,159
313040000,4814840000,434250000,848880000,3670530000,10081540000,33,34,91,158
964450000,6796710000,597220000,46980000,384840000,8790200000,26,18,62,106
2840310000,5395210000,353040000,1471870000,391710000,10452140000,27,22,72,121
7217160000,106900000,12460000,0,3787480000,1.1124e+10,32,30,88,150
856980000,373670000,43160000,105380000,193090000,1572280000,33,33,99,165
2707040000,1009870000,586170000,2808290000,2965040000,10076410000,42,28,100,170
3678780000,382310000,29260000,51680000,8420420000,12562450000,37,30,93,160
6503710000,188830000,65650000,2550000,4472400000,11233140000,35,29,97,161
4903270000,6443220000,521430000,198650000,12905020000,24971590000,37,34,89,160
5369890000,1189600000,1051060000,1107430000,3839410000,12557390000,30,29,85,144
937610000,1434490000,1328740000,2412710000,3202610000,9316160000,32,34,95,161
2900670000,3149750000,343300000,636090000,3128910000,10158720000,37,34,98,169
4169210000,1963110000,225650000,70060000,5572290000,12000320000,29,23,79,131
1234540000,7771100000,243160000,567940000,2e+08,10016740000,30,35,82,147
5064480000,3718570000,450240000,938690000,520660000,10692640000,17,14,44,75
656470000,1884680000,316990000,506110000,177250000,3541500000,33,37,100,170
1457750000,7499630000,464050000,438400000,817030000,10676860000,34,35,90,159
9059330000,24830000,12510000,0,5689670000,14786340000,35,29,86,150
582010000,1634180000,168050000,450080000,154040000,2988360000,34,35,91,160
4192020000,7012650000,1438560000,870530000,630180000,14143940000,35,27,86,148
2058590000,2472160000,113290000,153470000,4389020000,9186530000,32,34,83,149
574660000,58340000,19170000,105890000,87450000,845510000,31,35,102,168
1858890000,6906530000,833660000,842670000,270930000,10712680000,25,27,79,131
437980000,5963670000,149990000,1740400000,1209410000,9501450000,28,25,74,127
2712890000,5575520000,514560000,1647880000,261840000,10712690000,31,36,103,170
5242130000,4635180000,1468740000,3333630000,265400000,14945080000,37,39,108,184
2270320000,6162090000,776170000,918360000,325200000,10452140000,35,33,94,162
30540000,6100000,1820000,25150000,1192800000,1256410000,40,33,94,167
3839230000,4227590000,822450000,984830000,468230000,10342330000,31,26,80,137
4482330000,5154410000,849220000,1627590000,563050000,12676600000,27,20,66,113
8631010000,1232610000,313420000,1470000,3664420000,13842930000,34,37,92,163
9483460000,6850200000,501480000,2457210000,1354040000,20646390000,35,36,94,165
1661300000,8934870000,930060000,4393820000,187820000,16107870000,34,37,101,172
6291460000,1787420000,454030000,995110000,804290000,10332310000,22,13,52,87
1357470000,3493790000,797970000,177860000,3344780000,9171870000,34,30,90,154
170190000,918510000,512640000,2964660000,975060000,5541060000,42,32,91,165
5935720000,1576500000,191100000,1740000,5.378e+09,13083060000,31,35,91,157
2281850000,1865500000,160670000,47600000,4655740000,9011360000,35,35,90,160
7765820000,3284440000,241720000,2740930000,12038400000,26071310000,34,28,80,142
309160000,299640000,68150000,3964580000,944620000,5586150000,30,32,99,161
10374470000,258690000,26960000,44160000,4840640000,15544920000,31,26,78,135
1323450000,2620690000,170900000,789220000,271070000,5175330000,30,31,80,141
950520000,3067300000,31040000,505610000,856330000,5410800000,40,31,91,162
2323940000,4057870000,309640000,1648070000,430920000,8770440000,33,27,87,147
4681390000,2637760000,350450000,3416960000,6581590000,17668150000,37,39,103,179
600110000,1850980000,133220000,87030000,2716120000,5387460000,32,32,95,159
3609330000,4619660000,646470000,1055630000,150170000,10081260000,30,21,77,128
2537810000,901220000,154550000,446390000,88860000,4128830000,33,29,81,143
2748330000,5252200000,1282880000,974810000,455070000,10713290000,30,27,84,141
2199330000,880830000,155100000,849840000,4537320000,8622420000,28,27,68,123
1128850000,405640000,27930000,322760000,5250670000,7135850000,48,34,107,189
5011900000,5623770000,2031200000,2061860000,317720000,15046450000,33,24,84,141
3891370000,5300630000,252880000,738100000,4415150000,14598130000,37,35,94,166
3043390000,3702130000,449550000,1208830000,1948690000,10352590000,32,36,98,166
561830000,11159470000,1020970000,753940000,898550000,14394760000,32,32,89,153
2587850000,933870000,92010000,714380000,5697720000,10025830000,29,22,78,129
2087750000,6989100000,565140000,626420000,511140000,10779550000,30,23,81,134
2270210000,6367270000,395300000,1190940000,232610000,10456330000,33,36,100,169
1291440000,2826880000,560310000,298390000,63040000,5040060000,33,35,92,160
7214520000,507560000,77130000,0,3294650000,11093860000,33,35,93,161
9814520000,2405030000,161680000,2060000,4084490000,16467780000,36,35,96,167
3846370000,4973950000,291910000,576850000,650490000,10339570000,32,35,98,165
4370260000,758360000,121970000,5440000,4835690000,10091720000,32,29,84,145
2197260000,1070340000,236100000,2545030000,8536380000,14585110000,29,28,85,142
371950000,617700000,150150000,3551120000,1736550000,6427470000,32,24,95,151
1663580000,8398340000,1003740000,1598810000,5898230000,18562700000,33,32,84,149
1285110000,6831380000,565860000,1695430000,315330000,10693110000,31,28,90,149
2576150000,1158420000,1345830000,5701790000,8292250000,19074440000,36,29,87,152
3773870000,4189460000,509700000,243640000,7911010000,16627680000,30,31,90,151
5769810000,4959040000,180310000,129120000,3687060000,14725340000,30,33,85,148
2530380000,4060710000,303740000,1114230000,1475260000,9484320000,28,23,63,114
1325670000,3662830000,50690000,1385110000,2960400000,9384700000,32,33,98,163
1260040000,9437700000,755960000,226120000,6200400000,17880220000,30,32,92,154
2344570000,2873210000,467090000,498160000,4060360000,10243390000,34,27,88,149
1205810000,4472010000,355380000,1356830000,2743170000,10133200000,40,38,105,183
1427720000,4585100000,773220000,1861490000,2493330000,11140860000,35,24,83,142
879530000,6569590000,171820000,288260000,2418140000,10327340000,31,23,84,138
1831520000,1257240000,217560000,173250000,9206750000,12686320000,31,30,92,153
3551970000,10200540000,2294170000,292530000,1184480000,17523690000,26,25,77,128
2586200000,3295360000,386950000,590560000,193940000,7053010000,38,29,80,147
91610000,251980000,12280000,664650000,4565630000,5586150000,30,23,78,131
3556240000,3301540000,432210000,2629860000,323370000,10243220000,33,26,88,147
3937020000,396310000,273260000,2256240000,3551730000,10414560000,40,26,83,149
3828130000,2267620000,678660000,1793290000,233050000,8800750000,35,26,79,140
4437880000,2015070000,243320000,0,4061980000,10758250000,27,24,70,121
13061070000,46121580000,3879640000,4372980000,16075980000,83511250000,36,32,93,161
20313570000,42470000,81630000,107430000,20288510000,40833610000,33,34,103,170
8417270000,16386530000,1732690000,3212690000,907220000,30656400000,43,35,111,189
11629060000,2.5742e+10,2434970000,2352910000,19988530000,62147470000,35,42,115,192
13274570000,15807920000,1198750000,5846900000,8340750000,44468890000,50,35,114,199
6539040000,3487300000,649260000,2981910000,856800000,14514310000,49,41,114,204
26170150000,3334930000,467760000,17340000,25568790000,55558970000,33,36,103,172
16727300000,10973250000,1833520000,3332390000,15828270000,48694730000,31,31,91,153
24482900000,23636880000,4169460000,11288610000,1224720000,64802570000,47,40,110,197
2836310000,17490720000,2030370000,2483990000,20244970000,45086360000,34,38,98,170
8841330000,21983260000,781280000,1341750000,14443550000,47391170000,36,37,102,175
6745360000,22477080000,510590000,8792310000,11538260000,50063600000,39,37,95,171
1396070000,11395540000,4127070000,9706150000,11969380000,38594210000,39,40,108,187
46294250000,1985720000,507550000,109630000,22889750000,71786900000,40,41,102,183
12560780000,19505470000,1233770000,3349650000,3095570000,39745240000,40,38,108,186
6054950000,91290000,27950000,0,18960340000,25134530000,41,39,98,178
18624360000,29424070000,4970800000,7919790000,1269550000,62208570000,37,29,102,168
16309910000,16131510000,825710000,4386290000,8460470000,46113890000,43,42,111,196
19023780000,17615710000,3875710000,5165100000,18719290000,64399590000,46,34,104,184
15298840000,23060610000,1468740000,6411550000,27096650000,73336390000,38,31,105,174
16427670000,17573980000,1903780000,9598800000,4627430000,50131660000,38,40,95,173
2245810000,6206410000,551710000,749060000,8345430000,18098420000,34,33,100,167
11064310000,22606050000,2833020000,8230130000,12937840000,57671350000,42,39,108,189
3894220000,4624350000,1953520000,13563620000,18759210000,42794920000,37,28,91,156
23774450000,300930000,84580000,0,10564530000,34724490000,45,46,118,209
1114990000,15827630000,4244460000,7636700000,482860000,29306640000,40,35,111,186
15049440000,25404390000,1488950000,2081410000,3250170000,47274360000,49,35,112,196
5625320000,24201810000,2549380000,13784760000,8002230000,54163500000,35,36,85,156
16582710000,3059950000,242700000,217260000,38872760000,58975380000,37,42,108,187
5839730000,16060700000,1146470000,2608430000,16846250000,42501580000,36,29,96,161
9605670000,19799620000,794610000,4700790000,13845070000,48745760000,36,38,99,173
23237160000,4340310000,868480000,880000,13821140000,42267970000,37,32,92,161
3872970000,14892450000,393390000,1256340000,10301350000,30716500000,35,31,87,153
19118350000,32147410000,4568400000,5140490000,1787130000,62761780000,43,43,111,197
20039860000,24608350000,2271940000,5244930000,7018260000,59183340000,42,37,119,198
13224450000,20536110000,1671220000,16673750000,1074670000,53180200000,38,33,96,167
3712710000,16306170000,1901050000,3421940000,2036540000,27378410000,35,32,90,157
15100130000,29423970000,4616060000,2688900000,2251340000,54080400000,29,21,77,127
16078700000,27861560000,3170240000,8154800000,2162490000,57427790000,47,38,115,200
16895520000,26408220000,1975620000,1494950000,11533850000,58308160000,39,39,98,176
28395870000,10180550000,2113680000,355580000,19600090000,60645770000,42,40,104,186
23491300000,23174600000,5139290000,7855160000,2751440000,62411790000,39,38,98,175
16524900000,24305990000,1624130000,3504240000,13028550000,58987810000,32,39,107,178
10875660000,17041930000,1886820000,2668600000,9570230000,42043240000,39,39,104,182
11400570000,24377460000,1535780000,1275630000,29351020000,67940460000,39,34,94,167
9737120000,14040030000,897390000,2554950000,2.994e+09,30223490000,36,31,101,168
11647400000,21347540000,1580170000,3105810000,8377980000,46058900000,37,35,84,156
26903190000,758390000,320240000,132590000,17809270000,45923680000,41,37,110,188
5212090000,30427410000,3336850000,9393740000,5648740000,54018830000,42,32,109,183
25838630000,1033730000,108440000,870000,11120700000,38102370000,33,34,95,162
25414200000,62530000,40950000,20000,13686230000,39203930000,46,42,117,205
19346980000,10894110000,816070000,3138960000,27525710000,61721830000,38,32,108,178
1492990000,3125250000,821840000,14805950000,4625470000,24871500000,42,34,114,190
20533090000,38534680000,3010240000,5301070000,4224780000,71603860000,39,39,112,190
26267090000,16256680000,6993440000,11547090000,1387220000,62451520000,39,43,104,186
3002090000,26414640000,2513160000,2868960000,28730640000,63529490000,33,39,107,179
24494760000,4631130000,528740000,24990000,14774390000,44454010000,39,36,95,170
16018060000,30364740000,4.115e+09,1748430000,11142650000,63388880000,34,36,106,176
1423030000,1777900000,783460000,12511770000,20211110000,36707270000,30,36,101,167
21620700000,9865080000,3881630000,15344070000,14458010000,65169490000,37,37,105,179
16752400000,17061660000,1445110000,3994240000,9667850000,48921260000,32,36,101,169
22065060000,9508230000,1782990000,8960000,16457980000,49823220000,31,37,101,169
29306950000,11199490000,2197780000,1202610000,27592730000,71499560000,42,44,103,189
16632060000,30986930000,5458960000,5075720000,2396010000,60549680000,41,38,100,179
8096470000,804860000,104500000,255850000,32650510000,41912190000,44,42,111,197
19775380000,456470000,74260000,760070000,44085340000,65151520000,33,35,98,166
7024350000,12707990000,1346920000,1186520000,12733940000,34999720000,40,38,111,189
18246060000,8172140000,805510000,8180190000,21765510000,57169410000,31,34,102,167
2013320000,815290000,196760000,2433300000,20413800000,25872470000,48,47,119,214
1515310000,2226090000,366680000,12221540000,15171400000,31501020000,40,43,107,190
29614980000,6224390000,687480000,2060000,12649100000,49178010000,42,38,93,173
5641670000,25556720000,5210760000,15176520000,12738350000,64324020000,37,42,115,194
17718170000,10635040000,2819450000,4832170000,21052920000,57057750000,33,32,89,154
13011480000,28032520000,1789120000,6136400000,7517380000,56486900000,38,38,110,186
1818050000,9393780000,2044750000,9755870000,25791280000,48803730000,40,39,110,189
2581080000,15473230000,593140000,1614690000,10047350000,30309490000,38,44,108,190
6044160000,15528730000,591570000,4351570000,5919360000,32435390000,36,41,107,184
4996630000,25246650000,548030000,2896930000,8436930000,42125170000,48,44,117,209
28572340000,10621890000,1429850000,642550000,17461710000,58728340000,42,37,89,168
705900000,1383650000,103820000,4316730000,16674960000,23185060000,42,36,98,176
20571300000,18040870000,2541600000,5046780000,2160800000,48361350000,37,39,111,187
14343540000,20773380000,1560670000,2794740000,18681100000,58153430000,42,39,109,190
20968610000,21305380000,2188660000,3564550000,3905660000,51932860000,33,40,102,175
2214010000,17439270000,5402200000,6023830000,17234900000,48314210000,36,36,102,174
33914760000,3062470000,407410000,0,14745440000,52130080000,35,35,102,172
12918960000,10479600000,909500000,725770000,20381380000,45415210000,36,43,104,183
27440480000,10075490000,2227200000,6852150000,14291220000,60886540000,44,31,101,176
10876040000,11745060000,959420000,4848130000,10953080000,39381730000,40,44,117,201
2668930000,6441470000,2488250000,17220890000,18949110000,47768650000,41,35,92,168
7090510000,22427500000,11819390000,12432420000,11498480000,65268300000,36,38,96,170
16635520000,16450200000,2197560000,5007550000,3174020000,43464850000,41,40,108,189
21036440000,1154030000,70490000,353290000,42999250000,65613500000,44,38,111,193
23805940000,17605890000,4394810000,10492050000,4465660000,60764350000,37,38,95,170
8555310000,26271500000,3270280000,3975690000,3.967e+09,46039780000,34,36,98,168
10240390000,2201550000,274690000,29690000,43262980000,56009300000,38,34,103,175
11270860000,26741710000,2473710000,7338870000,1870740000,49695890000,40,40,108,188
8953780000,127700000,19980000,20000,26403390000,35504870000,36,30,96,162
4722910000,1550490000,514360000,6865400000,27162260000,40815420000,37,31,102,170
24007160000,12875950000,2198600000,9204130000,2774680000,51060520000,39,39,107,185
48236180000,1625690000,334980000,79560000,29853110000,80129520000,41,38,93,172
13989490000,15369730000,2138580000,2563890000,1043740000,35105430000,44,39,110,193
17256080000,31966150000,2953860000,8666300000,1084390000,61926780000,42,42,109,193
17879240000,12463090000,498120000,4815800000,8699800000,44356050000,39,37,103,179
32450410000,4056470000,558800000,53360000,10593760000,47712800000,37,38,101,176
20411230000,17137610000,3905500000,16479810000,3123780000,61057930000,30,28,78,136
11192140000,2306730000,504630000,199140000,35091360000,4.9294e+10,35,36,102,173
13724170000,32365230000,3036340000,4379500000,1911110000,55416350000,33,31,83,147
16238760000,2987210000,971750000,15590000,13580470000,33793780000,33,32,83,148
6761180000,14152280000,1082730000,2215920000,41177810000,65389920000,35,33,101,169
18070610000,13831440000,3342140000,11640940000,4689410000,51574540000,44,33,97,174
8949430000,37438800000,7452830000,6262250000,3850560000,63953870000,40,34,92,166
20503320000,20267390000,3548610000,10588950000,1283800000,56192070000,41,39,98,178
45714460000,76289160000,6027940000,10928450000,115461160000,254421170000,41,46,114,201
20963220000,75339010000,3230780000,11027100000,49035290000,159595400000,41,42,107,190
63226930000,74784290000,8708460000,11815240000,111618850000,270153770000,45,41,118,204
11548630000,11260390000,3768470000,29433820000,93865710000,149877020000,43,41,112,196
48629750000,62247360000,3735060000,12728800000,30643390000,157984360000,46,46,117,209
7.4267e+10,126047690000,15283130000,23604480000,15589530000,254791830000,44,42,114,200
80996090000,104718640000,15645890000,26729580000,8320420000,236410620000,47,43,108,198
33167360000,59938230000,3016420000,13316870000,28869730000,138308610000,53,45,121,219
65093450000,98657880000,21700240000,30880960000,7580780000,223913310000,43,46,133,222
147898230000,29829830000,4645160000,870300000,168897530000,352141050000,51,52,136,239
119792130000,1946130000,540110000,1455310000,168514940000,292248620000,52,45,131,228
5052230000,9438130000,2139920000,48345590000,52818450000,117794320000,54,50,144,248
40676670000,55688870000,4496950000,11739730000,40300090000,152902310000,36,46,127,209
83048540000,77097190000,16469520000,33543070000,45424160000,255582480000,44,42,106,192
72473480000,135000350000,1.1614e+10,19147350000,40866250000,279101430000,45,47,119,211
129486130000,14630430000,1942710000,72920000,73993670000,220125860000,47,45,120,212
8694450000,57112320000,16810830000,46239930000,67389130000,196246660000,46,45,115,206
38594310000,61964820000,5239220000,29903390000,16380560000,152082300000,40,43,116,199
24031010000,40313980000,2720600000,8852370000,78886460000,154804420000,46,42,119,207
58682080000,47158410000,10983620000,26690830000,45077600000,188592540000,44,46,107,197
71596690000,27969870000,4503710000,3624920000,97973310000,205668500000,44,41,104,189
125402570000,7069900000,1001200000,963270000,150326540000,284763480000,51,43,130,224
16843840000,74147710000,8492570000,23686330000,42485680000,165656130000,42,39,105,186
53917600000,90498980000,25109010000,42895360000,27269270000,239690220000,43,40,117,200
17145350000,55854630000,2649560000,10863940000,36752560000,123266040000,44,42,100,186
84774410000,101502190000,12170390000,33209360000,11410140000,243066490000,44,44,119,207
24711870000,37596890000,2539570000,7615640000,47603350000,120067320000,30,28,79,137
86295860000,113834040000,13030110000,17396520000,18100060000,248656590000,54,48,137,239
227911970000,331095270000,39841130000,68242870000,120013130000,787104370000,56,55,152,263
317238410000,343279530000,67734030000,146383790000,142945020000,1017580780000,52,54,143,249
161645790000,333903310000,20310020000,69248680000,235976790000,821084590000,57,53,134,244
227629860000,85623790000,12630700000,8029660000,316414860000,650328870000,53,50,131,234
269502940000,425503410000,38992740000,86981020000,316869850000,1137849960000,61,58,161,280
389106510000,41598560000,6286290000,4833950000,405909310000,847734620000,50,55,140,245
48276210000,187777140000,44461080000,160878720000,306051490000,747444640000,58,51,138,247
1596762660000,1695128470000,218143230000,526381830000,1963679440000,6000095630000,86,88,204,378
