"Forest","Agriculture","Urban","Grassland","Other","Area_Total","natural_sp","human_dominated_sp","Sp_Total"
147070000,292150000,454400000,20770000,1575750000,2490140000,26,85,111
172980000,395020000,49980000,810000,1579250000,2198040000,29,76,105
175890000,1257450000,148490000,14550000,903620000,2.5e+09,32,88,120
619460000,781250000,9630000,45460000,1044200000,2.5e+09,25,79,104
565210000,517030000,59010000,50480000,1308270000,2.5e+09,31,92,123
248050000,1979790000,12970000,16870000,242320000,2.5e+09,27,81,108
991010000,445190000,30880000,380000,1032540000,2.5e+09,31,80,111
597140000,1807380000,24770000,3650000,67060000,2.5e+09,29,88,117
469440000,1897980000,24410000,13200000,94970000,2.5e+09,29,86,115
597850000,1300620000,1.32e+08,30240000,439290000,2.5e+09,32,80,112
719640000,1444340000,76290000,30640000,229090000,2.5e+09,34,86,120
1221380000,659120000,39420000,4530000,575550000,2.5e+09,25,74,99
1340190000,1046150000,9510000,1620000,102530000,2.5e+09,32,86,118
922150000,855170000,126330000,48740000,547610000,2.5e+09,31,78,109
1456990000,358370000,18800000,12750000,653090000,2.5e+09,27,74,101
148730000,854620000,22350000,46710000,1427590000,2.5e+09,32,95,127
845680000,604670000,7430000,169460000,872760000,2.5e+09,30,93,123
414280000,744400000,53980000,48390000,1238950000,2.5e+09,36,92,128
439840000,1858190000,16840000,41220000,143910000,2.5e+09,30,83,113
466820000,1356390000,6910000,118840000,551040000,2.5e+09,33,95,128
380550000,2010980000,15190000,14730000,78550000,2.5e+09,28,81,109
122230000,1766120000,43360000,322040000,246250000,2.5e+09,36,104,140
786170000,983310000,22820000,35130000,672570000,2.5e+09,30,86,116
484080000,1091590000,3430000,187140000,733760000,2.5e+09,33,111,144
50250000,783370000,69970000,15240000,1581170000,2.5e+09,45,109,154
15130000,55280000,53640000,15490000,1599790000,1739330000,33,95,128
688730000,741300000,12970000,62060000,994940000,2.5e+09,32,98,130
505860000,1099070000,5040000,303590000,586440000,2.5e+09,20,62,82
283010000,1637100000,8120000,293570000,278200000,2.5e+09,30,84,114
64010000,904160000,21160000,1030490000,480180000,2.5e+09,35,99,134
133870000,1985160000,18900000,139840000,222230000,2.5e+09,33,102,135
96380000,1353660000,11820000,269900000,768240000,2.5e+09,34,103,137
219170000,163890000,4230000,75200000,1807420000,2269910000,17,52,69
462900000,289980000,242170000,16530000,1373140000,2384720000,27,63,90
594330000,1031150000,140410000,67260000,666850000,2.5e+09,20,63,83
1017820000,635340000,36020000,50430000,760390000,2.5e+09,26,66,92
748630000,529020000,125440000,161250000,935660000,2.5e+09,27,78,105
616790000,665380000,102820000,6.4e+07,1051010000,2.5e+09,33,75,108
602590000,694890000,23310000,546930000,632280000,2.5e+09,27,86,113
445530000,474580000,14300000,334390000,1231200000,2.5e+09,33,92,125
771040000,1126010000,17880000,78380000,506690000,2.5e+09,23,75,98
993420000,751790000,49430000,123650000,581710000,2.5e+09,27,76,103
632550000,1133560000,15680000,142520000,575690000,2.5e+09,25,63,88
481470000,784390000,32950000,146930000,1054260000,2.5e+09,26,77,103
5.1e+08,769190000,18960000,300740000,901110000,2.5e+09,35,107,142
367300000,1209360000,15220000,114990000,793130000,2.5e+09,27,71,98
401060000,9.86e+08,20730000,1.1e+08,982210000,2.5e+09,26,77,103
240340000,1373610000,10080000,193720000,682250000,2.5e+09,33,95,128
117380000,1164760000,8360000,219730000,989770000,2.5e+09,38,107,145
398500000,721480000,5170000,518640000,856210000,2.5e+09,29,93,122
363420000,1231180000,19020000,141690000,744690000,2.5e+09,32,99,131
286230000,1301070000,12350000,122270000,778080000,2.5e+09,33,97,130
443140000,1173540000,7760000,81640000,793920000,2.5e+09,25,78,103
932070000,543190000,27280000,174790000,822670000,2.5e+09,31,91,122
858840000,549600000,10720000,330700000,750140000,2.5e+09,23,65,88
606810000,682430000,2430000,213720000,994610000,2.5e+09,34,109,143
303540000,1296320000,4920000,258270000,636950000,2.5e+09,31,99,130
220280000,1427780000,5510000,536900000,309530000,2.5e+09,38,118,156
666910000,1084110000,1400000,84710000,662870000,2.5e+09,32,95,127
582370000,136120000,3930000,562130000,1215450000,2.5e+09,27,79,106
1120680000,441330000,16380000,241070000,680540000,2.5e+09,30,87,117
5310000,35110000,2610000,69960000,1727050000,1840040000,30,73,103
58030000,57560000,3030000,235730000,1982800000,2337150000,29,71,100
37110000,112050000,7280000,518800000,1824760000,2.5e+09,34,77,111
27670000,84540000,2040000,194440000,2191310000,2.5e+09,21,60,81
119890000,190870000,8900000,946780000,1233560000,2.5e+09,23,49,72
32620000,163980000,13840000,594360000,1695200000,2.5e+09,32,70,102
23120000,113910000,1970000,68970000,2285240000,2493210000,31,62,93
112360000,353130000,9530000,548640000,1476340000,2.5e+09,29,69,98
36010000,117270000,4400000,164190000,2113940000,2435810000,34,78,112
70190000,171530000,16580000,497740000,1743960000,2.5e+09,28,72,100
173250000,328050000,26870000,847960000,1123870000,2.5e+09,29,69,98
184890000,326790000,16720000,1151030000,820570000,2.5e+09,31,72,103
10730000,71200000,8280000,96140000,2151720000,2338070000,33,81,114
185500000,543890000,23630000,1571560000,175420000,2.5e+09,29,64,93
35240000,442590000,82760000,862160000,1077250000,2.5e+09,23,54,77
86140000,3.86e+08,17830000,713850000,1275780000,2479600000,30,61,91
39890000,143120000,70100000,1981400000,265490000,2.5e+09,28,58,86
134840000,317640000,20500000,1632530000,394490000,2.5e+09,26,56,82
121150000,308250000,18760000,1766180000,285660000,2.5e+09,28,58,86
28230000,101980000,30650000,1788660000,550480000,2.5e+09,27,69,96
106350000,117800000,21480000,2062810000,191560000,2.5e+09,25,59,84
33710000,159810000,90490000,2009740000,206250000,2.5e+09,28,72,100
41040000,161160000,59130000,453950000,1734450000,2449730000,31,77,108
64280000,106160000,24680000,628460000,1676420000,2.5e+09,33,73,106
365890000,1479860000,10260000,96060000,547930000,2.5e+09,37,101,138
239430000,421440000,58090000,957900000,823140000,2.5e+09,32,76,108
70130000,664930000,31140000,8.93e+08,840800000,2.5e+09,29,71,100
53260000,288930000,36700000,1678860000,442250000,2.5e+09,27,65,92
25630000,615480000,380160000,943780000,534950000,2.5e+09,31,74,105
131530000,2240000,540000,246510000,2119180000,2.5e+09,32,78,110
279420000,1510530000,24200000,316700000,369150000,2.5e+09,37,114,151
177720000,1765650000,6100000,275440000,275090000,2.5e+09,27,85,112
350550000,1022860000,5640000,4.81e+08,639950000,2.5e+09,31,101,132
48390000,1637350000,19100000,575030000,220130000,2.5e+09,35,106,141
314940000,1306160000,11060000,181790000,686050000,2.5e+09,34,115,149
305690000,1269610000,10680000,44370000,869650000,2.5e+09,27,98,125
104330000,64350000,75100000,6800000,1823710000,2074290000,23,73,96
114180000,1325100000,101850000,71710000,887160000,2.5e+09,31,106,137
20010000,2390150000,19860000,20380000,49600000,2.5e+09,31,90,121
98340000,1959360000,22360000,141770000,278170000,2.5e+09,31,100,131
484810000,1199410000,11930000,25590000,778260000,2.5e+09,29,72,101
461670000,762440000,2350000,248340000,1025200000,2.5e+09,30,90,120
316930000,922020000,6240000,479020000,775790000,2.5e+09,33,100,133
182410000,1916400000,42340000,82270000,276580000,2.5e+09,34,100,134
225940000,778480000,24650000,14640000,1456290000,2.5e+09,32,97,129
136790000,750710000,8090000,3450000,1600960000,2.5e+09,31,90,121
243730000,1931720000,24280000,32910000,267360000,2.5e+09,26,76,102
177050000,1994850000,80140000,31270000,216690000,2.5e+09,32,90,122
244300000,1492620000,6280000,13100000,743700000,2.5e+09,29,96,125
486270000,918480000,7740000,4290000,1083220000,2.5e+09,26,93,119
115310000,1762410000,11470000,75820000,534990000,2.5e+09,34,87,121
16930000,2052630000,34230000,17090000,379120000,2.5e+09,30,90,120
58830000,457090000,35410000,0,1948670000,2.5e+09,34,98,132
498960000,1372050000,6470000,3080000,619440000,2.5e+09,27,94,121
580420000,709350000,3910000,2640000,1203680000,2.5e+09,23,79,102
333500000,1458870000,3310000,12960000,691360000,2.5e+09,23,76,99
310490000,1387510000,5520000,119670000,676810000,2.5e+09,29,84,113
729220000,196780000,23150000,484020000,1066830000,2.5e+09,30,86,116
73210000,1241440000,98990000,3340000,1083020000,2.5e+09,30,98,128
307800000,1374150000,23120000,0,794930000,2.5e+09,25,77,102
135390000,1658220000,155370000,41480000,509540000,2.5e+09,39,108,147
527380000,1449160000,5210000,12700000,505550000,2.5e+09,28,81,109
538780000,1018480000,19950000,0,922790000,2.5e+09,29,86,115
465950000,762500000,8840000,6790000,1255920000,2.5e+09,28,80,108
772010000,471320000,2940000,98510000,1155220000,2.5e+09,30,76,106
739550000,581680000,1110000,30220000,1147440000,2.5e+09,32,93,125
209990000,901850000,115750000,33840000,1238570000,2.5e+09,28,88,116
56430000,987090000,240870000,7e+05,1214910000,2.5e+09,41,102,143
46080000,1244970000,83640000,1150000,1124160000,2.5e+09,37,96,133
457390000,956260000,64640000,650000,1021060000,2.5e+09,39,103,142
378300000,508300000,4670000,656220000,952510000,2.5e+09,32,114,146
201010000,1774140000,45880000,411030000,67940000,2.5e+09,37,118,155
626350000,1255410000,39620000,132860000,445760000,2.5e+09,37,108,145
363600000,386730000,2460000,536460000,1210750000,2.5e+09,35,110,145
568290000,406610000,42240000,5.64e+08,918860000,2.5e+09,36,110,146
143580000,2241420000,12120000,60380000,42500000,2.5e+09,37,96,133
147220000,1940430000,6010000,142490000,263850000,2.5e+09,34,103,137
770250000,1411350000,14550000,56760000,247090000,2.5e+09,36,87,123
383340000,1412210000,29560000,371230000,303660000,2.5e+09,37,106,143
46580000,2372500000,6310000,50410000,24200000,2.5e+09,29,90,119
103080000,2300680000,14140000,2.5e+07,57100000,2.5e+09,33,96,129
119490000,2226540000,18080000,18330000,117560000,2.5e+09,35,102,137
256750000,1871490000,59540000,50550000,261670000,2.5e+09,36,98,134
1131830000,125560000,1570000,223300000,1017740000,2.5e+09,32,93,125
849210000,1068750000,5420000,143310000,433310000,2.5e+09,36,105,141
982080000,73350000,3720000,323650000,1117200000,2.5e+09,32,99,131
585080000,1475130000,6070000,122600000,311120000,2.5e+09,36,109,145
294280000,141930000,7420000,222250000,1573920000,2239800000,27,73,100
55750000,47410000,5760000,91550000,1479660000,1680130000,30,81,111
206050000,970110000,535360000,382790000,405690000,2.5e+09,37,110,147
410630000,1336870000,4780000,244120000,503600000,2.5e+09,32,97,129
507360000,279410000,83600000,801490000,828140000,2.5e+09,36,114,150
572850000,865400000,5750000,214080000,841920000,2.5e+09,35,97,132
345510000,1177800000,29480000,110930000,836280000,2.5e+09,38,108,146
126200000,2127250000,29480000,10780000,206290000,2.5e+09,32,101,133
215360000,2062410000,9710000,28430000,184090000,2.5e+09,30,101,131
1226790000,681080000,7620000,129950000,454560000,2.5e+09,34,109,143
824830000,1161830000,1660000,1.01e+08,410680000,2.5e+09,32,113,145
713600000,232730000,25710000,510050000,1017910000,2.5e+09,32,96,128
484210000,1076310000,2770000,180650000,756060000,2.5e+09,37,101,138
925920000,477670000,19720000,432560000,644130000,2.5e+09,35,93,128
527230000,1293730000,3050000,28310000,647680000,2.5e+09,36,108,144
12350000,94040000,30170000,4490000,1856950000,1.998e+09,30,79,109
150350000,519740000,133190000,54420000,1637230000,2494930000,39,94,133
404410000,1610740000,12300000,34180000,438370000,2.5e+09,33,92,125
1179840000,563530000,540000,65900000,690190000,2.5e+09,33,93,126
405160000,1218250000,1940000,281740000,592910000,2.5e+09,30,90,120
690450000,1197540000,7400000,166730000,437880000,2.5e+09,32,94,126
1091690000,611850000,1460000,182660000,612340000,2.5e+09,29,80,109
1170060000,519070000,12370000,109750000,688750000,2.5e+09,34,112,146
1165950000,632560000,6740000,138080000,556670000,2.5e+09,34,106,140
383700000,1356340000,21380000,67730000,670850000,2.5e+09,41,121,162
373670000,1367310000,920000,106260000,651840000,2.5e+09,32,100,132
1174710000,66370000,88680000,489280000,680960000,2.5e+09,32,96,128
631160000,1491310000,44320000,20730000,312480000,2.5e+09,38,116,154
1275870000,27680000,61990000,577690000,556770000,2.5e+09,37,101,138
693310000,1299470000,16240000,135240000,355740000,2.5e+09,39,121,160
43680000,639190000,106510000,328830000,1381790000,2.5e+09,38,98,136
2.37e+08,1144870000,150290000,240240000,727600000,2.5e+09,42,104,146
4690000,88740000,40670000,12080000,1969870000,2116050000,33,85,118
263480000,1636930000,105190000,391910000,102490000,2.5e+09,40,97,137
40760000,926270000,195100000,536320000,801550000,2.5e+09,35,103,138
487610000,954170000,8890000,158290000,891040000,2.5e+09,26,79,105
179570000,1788640000,7480000,3270000,521040000,2.5e+09,31,96,127
131700000,1965880000,24820000,1710000,375890000,2.5e+09,41,112,153
196100000,1695170000,17150000,42350000,549230000,2.5e+09,36,105,141
499460000,1443880000,5860000,2480000,548320000,2.5e+09,35,111,146
1164500000,229800000,12190000,713960000,379550000,2.5e+09,41,110,151
625470000,1248390000,48850000,15770000,561520000,2.5e+09,38,118,156
1044700000,457090000,24360000,808400000,165450000,2.5e+09,38,104,142
1237830000,364860000,2440000,153880000,740990000,2.5e+09,34,105,139
650180000,53060000,37850000,650000,1449160000,2190900000,27,72,99
595070000,510110000,177160000,212230000,972170000,2466740000,37,90,127
1710380000,455660000,58930000,10740000,264290000,2.5e+09,28,71,99
595790000,1609260000,89470000,177260000,28220000,2.5e+09,33,91,124
268400000,2860000,36110000,850000,1436480000,1744700000,30,74,104
271530000,12310000,58320000,30000,1545270000,1887460000,32,70,102
711380000,499790000,355840000,136650000,796340000,2.5e+09,39,95,134
95670000,131240000,60190000,42800000,1845780000,2175680000,37,96,133
67030000,11850000,16070000,4190000,1488310000,1587450000,31,70,101
293760000,1712970000,99840000,290600000,102830000,2.5e+09,39,101,140
334950000,1135200000,45670000,245910000,738270000,2.5e+09,35,88,123
102240000,1881020000,110690000,393150000,12900000,2.5e+09,37,99,136
40580000,625090000,130990000,231520000,1471820000,2.5e+09,43,110,153
144570000,1729910000,79800000,536400000,9320000,2.5e+09,34,92,126
122150000,1965140000,124950000,272650000,15110000,2.5e+09,38,93,131
172030000,1724640000,70970000,508740000,23620000,2.5e+09,38,95,133
86690000,1586510000,283360000,478830000,64610000,2.5e+09,40,104,144
135830000,1352160000,155620000,816120000,40270000,2.5e+09,40,96,136
129650000,1703280000,103900000,547670000,15500000,2.5e+09,37,88,125
810760000,523760000,540000,174230000,990710000,2.5e+09,30,91,121
105690000,2070470000,12160000,0,311680000,2.5e+09,30,90,120
476550000,1254270000,7030000,31230000,730920000,2.5e+09,45,129,174
181910000,1949230000,6800000,4990000,357070000,2.5e+09,34,105,139
832090000,589140000,90280000,717830000,270660000,2.5e+09,38,105,143
873500000,159330000,8640000,486100000,972430000,2.5e+09,34,114,148
449870000,1535440000,152210000,245050000,117430000,2.5e+09,29,76,105
1371640000,761720000,42530000,113280000,210830000,2.5e+09,30,72,102
261140000,2068690000,107120000,50980000,12070000,2.5e+09,33,96,129
536380000,1595500000,32230000,108820000,227070000,2.5e+09,30,85,115
274950000,1777050000,99700000,330120000,18180000,2.5e+09,33,86,119
586180000,1239560000,84900000,565260000,24100000,2.5e+09,40,99,139
524930000,1607940000,118530000,193780000,54820000,2.5e+09,42,100,142
29850000,260420000,40150000,344060000,1825520000,2.5e+09,30,72,102
158680000,443870000,59330000,681430000,1156690000,2.5e+09,36,84,120
48050000,147670000,14610000,645280000,1384920000,2240530000,29,78,107
5370000,75550000,5560000,232230000,1466730000,1785440000,31,65,96
1890000,78430000,29480000,404970000,1829880000,2344650000,36,88,124
41330000,115520000,187470000,580300000,1575380000,2.5e+09,27,66,93
22110000,225070000,46300000,887620000,1318570000,2499670000,27,64,91
323120000,29270000,0,377660000,1769950000,2.5e+09,25,72,97
199420000,68520000,90520000,654370000,1487170000,2.5e+09,32,79,111
248470000,44640000,11300000,490690000,1704900000,2.5e+09,40,93,133
29600000,653710000,142240000,47080000,1627370000,2.5e+09,37,83,120
20640000,319350000,37250000,18520000,2101890000,2497650000,36,86,122
89290000,317310000,91340000,638070000,1362970000,2498980000,36,92,128
59970000,94990000,35130000,711920000,1597990000,2.5e+09,26,63,89
238490000,391710000,22600000,1741120000,106080000,2.5e+09,32,79,111
127850000,348440000,85320000,709940000,1228450000,2.5e+09,29,84,113
1.63e+08,622920000,141700000,1130780000,441600000,2.5e+09,31,89,120
234730000,43550000,5360000,1889090000,327270000,2.5e+09,35,91,126
98800000,148360000,175920000,1061110000,1015810000,2.5e+09,36,85,121
181070000,142980000,14040000,2002560000,159350000,2.5e+09,33,79,112
345770000,249810000,369530000,1276590000,258300000,2.5e+09,34,84,118
40370000,86040000,38270000,747160000,1588160000,2.5e+09,39,97,136
251040000,21230000,13290000,789110000,1424300000,2498970000,33,88,121
255310000,200550000,69410000,1646610000,328120000,2.5e+09,33,79,112
279510000,238040000,14620000,1819050000,148780000,2.5e+09,36,79,115
31280000,92960000,182330000,249020000,1701910000,2257500000,26,84,110
239010000,48330000,10530000,997360000,1204770000,2.5e+09,39,99,138
99170000,85770000,49970000,1322900000,942190000,2.5e+09,33,87,120
127920000,41760000,26050000,918360000,1385910000,2.5e+09,48,107,155
2.24e+08,185240000,471150000,1442480000,177130000,2.5e+09,30,74,104
575620000,31050000,16030000,1516030000,361270000,2.5e+09,29,66,95
250110000,354660000,192540000,1087490000,615200000,2.5e+09,38,93,131
572300000,84040000,22610000,1351050000,4.7e+08,2.5e+09,35,85,120
248590000,1450540000,120930000,151310000,528630000,2.5e+09,35,88,123
179460000,1777030000,144010000,198540000,200960000,2.5e+09,31,78,109
275310000,1923330000,76220000,135210000,89930000,2.5e+09,32,83,115
414640000,1735990000,63880000,207910000,77580000,2.5e+09,26,70,96
20580000,251810000,51520000,7e+06,1675380000,2006290000,30,73,103
50220000,886460000,80770000,850020000,632530000,2.5e+09,37,98,135
133680000,1431710000,119230000,806980000,8400000,2.5e+09,31,83,114
546400000,796600000,698260000,391320000,67420000,2.5e+09,32,77,109
274340000,803340000,203130000,335250000,883940000,2.5e+09,36,98,134
144350000,1518890000,59760000,767790000,9210000,2.5e+09,30,78,108
242580000,596450000,252420000,1107020000,301530000,2.5e+09,34,86,120
67990000,1693800000,210400000,524350000,3460000,2.5e+09,30,76,106
91710000,1563310000,202920000,622480000,19580000,2.5e+09,29,80,109
82590000,746650000,187680000,1471890000,11190000,2.5e+09,30,82,112
165690000,1306140000,140790000,849750000,37630000,2.5e+09,36,81,117
111030000,300620000,256620000,1769360000,62370000,2.5e+09,37,90,127
84830000,1081890000,890310000,395720000,47250000,2.5e+09,34,82,116
19100000,116490000,177280000,715670000,1471460000,2.5e+09,36,90,126
99950000,173440000,409350000,1480920000,336340000,2.5e+09,33,82,115
161150000,180450000,575370000,1156930000,426100000,2.5e+09,35,83,118
126330000,117510000,49240000,1838770000,368150000,2.5e+09,34,83,117
128390000,11990000,30470000,1932710000,396440000,2.5e+09,34,85,119
68440000,907180000,451600000,249620000,823160000,2.5e+09,37,89,126
70810000,1202010000,33710000,537480000,655990000,2.5e+09,33,91,124
617570000,208680000,9720000,1192510000,471520000,2.5e+09,33,84,117
32470000,520130000,88590000,220290000,1372390000,2233870000,39,91,130
152250000,1353300000,119530000,135550000,739370000,2.5e+09,37,88,125
220320000,1882950000,88920000,262570000,45240000,2.5e+09,29,73,102
137100000,1356850000,129310000,218790000,657950000,2.5e+09,38,93,131
300490000,1704090000,149940000,287820000,57660000,2.5e+09,29,79,108
18270000,218650000,42740000,222750000,1997590000,2.5e+09,39,99,138
211880000,560130000,315360000,297110000,1115520000,2.5e+09,37,97,134
100990000,445880000,181170000,209930000,1369160000,2307130000,30,81,111
41860000,1828100000,2.24e+08,395590000,10450000,2.5e+09,30,76,106
178840000,1710420000,207400000,378200000,25140000,2.5e+09,28,76,104
214450000,899940000,1087200000,252580000,45830000,2.5e+09,33,85,118
109590000,1481330000,446270000,414070000,48740000,2.5e+09,33,86,119
36860000,1559950000,361430000,514200000,27560000,2.5e+09,30,78,108
48890000,2257940000,114690000,63880000,14600000,2.5e+09,29,72,101
74690000,2035210000,214740000,123700000,51660000,2.5e+09,31,83,114
52700000,2089500000,177100000,145860000,34840000,2.5e+09,34,78,112
118870000,1742210000,431660000,114210000,93050000,2.5e+09,34,94,128
74940000,2000780000,173890000,157780000,92610000,2.5e+09,28,65,93
222060000,982270000,46070000,382550000,867050000,2.5e+09,35,90,125
104700000,1307400000,71110000,831160000,185630000,2.5e+09,43,104,147
160620000,1698020000,124810000,493570000,22980000,2.5e+09,34,91,125
158520000,968580000,53480000,1299720000,19700000,2.5e+09,38,86,124
137920000,1237830000,80800000,1032900000,10550000,2.5e+09,38,90,128
41770000,298870000,39660000,378870000,1708870000,2468040000,42,98,140
71800000,784060000,92630000,1330750000,220760000,2.5e+09,38,93,131
18020000,478440000,108590000,206610000,1469380000,2281040000,37,104,141
189150000,1187060000,120420000,985850000,17520000,2.5e+09,34,90,124
353710000,1031730000,59660000,1029490000,25410000,2.5e+09,39,89,128
334790000,1120310000,126690000,901050000,17160000,2.5e+09,32,89,121
284210000,15030000,2390000,421780000,1776590000,2.5e+09,32,81,113
317960000,16760000,1550000,430400000,1733330000,2.5e+09,36,86,122
243870000,5100000,3240000,635950000,1611840000,2.5e+09,34,81,115
92800000,1880000,2730000,188740000,2213850000,2.5e+09,26,66,92
121610000,10600000,340000,141400000,2226050000,2.5e+09,29,80,109
357390000,18840000,5320000,293290000,1825160000,2.5e+09,33,82,115
13100000,1550000,0,174490000,2266910000,2456050000,29,68,97
86400000,1910000,1010000,191280000,2219400000,2.5e+09,30,68,98
263370000,42880000,3870000,499720000,1690160000,2.5e+09,35,87,122
366320000,337580000,108740000,1000480000,686880000,2.5e+09,33,88,121
305960000,765190000,71380000,648770000,708700000,2.5e+09,35,84,119
493280000,381280000,49220000,381820000,1194400000,2.5e+09,38,99,137
163570000,14880000,3870000,167620000,2150060000,2.5e+09,37,91,128
557430000,297160000,41190000,470110000,1134110000,2.5e+09,34,88,122
209010000,49380000,8820000,510560000,1722230000,2.5e+09,29,81,110
156150000,1840000,330000,234440000,2107240000,2.5e+09,33,86,119
363840000,75840000,9470000,296960000,1753890000,2.5e+09,31,78,109
163200000,79670000,15090000,591120000,1650920000,2.5e+09,33,77,110
8440000,8e+06,1750000,27720000,2249530000,2295440000,28,77,105
0,3460000,3280000,280010000,2135870000,2422620000,29,73,102
498310000,1391960000,30540000,1e+06,578190000,2.5e+09,29,99,128
87260000,927460000,20910000,50000,1460580000,2496260000,36,101,137
432410000,1518100000,8800000,0,540690000,2.5e+09,35,103,138
721560000,1.181e+09,20360000,25080000,5.52e+08,2.5e+09,38,96,134
787760000,788790000,4960000,37320000,881170000,2.5e+09,31,112,143
119500000,2124240000,23200000,2600000,230460000,2.5e+09,39,110,149
857570000,825600000,87890000,534480000,194460000,2.5e+09,34,94,128
799770000,56840000,8350000,613370000,1021670000,2.5e+09,32,105,137
588660000,1743570000,24290000,81570000,61910000,2.5e+09,29,71,100
335090000,1866830000,30370000,251480000,16230000,2.5e+09,25,65,90
753320000,1445200000,66620000,200120000,34740000,2.5e+09,28,81,109
494210000,1771290000,58040000,124230000,52230000,2.5e+09,27,69,96
524660000,1577950000,138830000,2.36e+08,22560000,2.5e+09,38,98,136
789680000,1507410000,26190000,143850000,32870000,2.5e+09,32,78,110
571150000,1465850000,56320000,270000,406410000,2.5e+09,36,97,133
1230000,270240000,14070000,250000,1759410000,2045200000,42,113,155
377830000,1082940000,169820000,1420000,867990000,2.5e+09,28,91,119
851910000,435350000,3860000,174800000,1034080000,2.5e+09,37,111,148
192080000,1950050000,39550000,9e+05,317420000,2.5e+09,36,103,139
1308340000,266900000,6190000,219830000,698740000,2.5e+09,30,107,137
952400000,976260000,58500000,473770000,39070000,2.5e+09,35,101,136
827670000,38910000,6120000,791620000,835680000,2.5e+09,33,104,137
726960000,1221090000,44140000,440340000,67470000,2.5e+09,33,103,136
851500000,75740000,9110000,567710000,995940000,2.5e+09,34,97,131
154910000,2159130000,67520000,82230000,36210000,2.5e+09,31,84,115
166470000,2096320000,28060000,179410000,29740000,2.5e+09,28,73,101
422080000,1818480000,72220000,127540000,59680000,2.5e+09,34,94,128
156220000,1899420000,361990000,33680000,48690000,2.5e+09,29,83,112
1129760000,995940000,33960000,295910000,44430000,2.5e+09,31,84,115
478240000,1709850000,52730000,234030000,25150000,2.5e+09,26,74,100
1102720000,807920000,45860000,447400000,96100000,2.5e+09,38,91,129
1042150000,875510000,30360000,341770000,210210000,2.5e+09,30,85,115
697500000,834140000,53090000,869150000,46120000,2.5e+09,37,95,132
1129970000,1054290000,62590000,215240000,37910000,2.5e+09,30,79,109
769590000,624260000,124710000,913080000,68360000,2.5e+09,38,87,125
661150000,1034520000,67080000,716650000,20600000,2.5e+09,36,85,121
561200000,1688760000,75730000,140090000,34220000,2.5e+09,38,96,134
266730000,1233270000,32230000,931880000,35890000,2.5e+09,36,88,124
540120000,1150530000,43390000,657580000,108380000,2.5e+09,45,110,155
351710000,942120000,33960000,1144450000,27760000,2.5e+09,37,93,130
521550000,1484550000,128110000,330400000,35390000,2.5e+09,40,98,138
491790000,1602110000,137880000,218940000,49280000,2.5e+09,33,96,129
634110000,1666350000,106950000,45720000,46870000,2.5e+09,40,101,141
542570000,1675510000,46430000,216110000,19380000,2.5e+09,38,101,139
276920000,254530000,388250000,16300000,1536860000,2472860000,38,101,139
1251520000,417660000,20160000,307490000,503170000,2.5e+09,36,112,148
983580000,418360000,23910000,690520000,383630000,2.5e+09,39,114,153
1117860000,806570000,203730000,15730000,356110000,2.5e+09,30,99,129
1451260000,699010000,36030000,49150000,264550000,2.5e+09,38,115,153
1131530000,448860000,159160000,2860000,757590000,2.5e+09,32,104,136
685130000,1407390000,56800000,207620000,143060000,2.5e+09,32,99,131
1271600000,164910000,23110000,527460000,512920000,2.5e+09,33,104,137
499850000,1188240000,57170000,67540000,687200000,2.5e+09,37,110,147
675100000,949320000,119690000,102200000,653690000,2.5e+09,46,129,175
556010000,1516970000,67180000,314300000,45540000,2.5e+09,34,91,125
547050000,1647520000,67490000,216390000,21550000,2.5e+09,34,92,126
723070000,1268450000,18240000,410640000,79600000,2.5e+09,34,92,126
1471600000,361560000,13500000,420630000,232710000,2.5e+09,33,97,130
1011580000,532610000,33650000,866260000,55900000,2.5e+09,33,79,112
698740000,1029040000,40100000,641770000,90350000,2.5e+09,33,87,120
639620000,466590000,39420000,1269310000,85060000,2.5e+09,35,89,124
710520000,748850000,46150000,939470000,55010000,2.5e+09,34,87,121
1194440000,300530000,20890000,765100000,219040000,2.5e+09,38,92,130
1394060000,236240000,50750000,692640000,126310000,2.5e+09,36,86,122
7.91e+08,502050000,28340000,1106700000,71910000,2.5e+09,35,89,124
661960000,214510000,25610000,1515870000,82050000,2.5e+09,36,84,120
322190000,1320190000,65460000,752790000,39370000,2.5e+09,40,95,135
461530000,856040000,39070000,1131090000,12270000,2.5e+09,45,100,145
466830000,915310000,43370000,1039710000,34780000,2.5e+09,40,96,136
347390000,6.9e+08,76580000,1362340000,23690000,2.5e+09,43,100,143
1414640000,834220000,70200000,124300000,56640000,2.5e+09,44,105,149
750100000,1489740000,86050000,139320000,34790000,2.5e+09,37,93,130
704190000,1274380000,67600000,409770000,44060000,2.5e+09,42,104,146
427590000,1546770000,88970000,395500000,41170000,2.5e+09,36,90,126
24940000,420900000,42390000,420000,1873730000,2362380000,45,109,154
18690000,479480000,91860000,10330000,1621100000,2221460000,40,102,142
705660000,1168600000,89950000,104010000,431780000,2.5e+09,39,117,156
1151010000,648730000,86960000,126070000,487230000,2.5e+09,35,112,147
142980000,724790000,226220000,57250000,1348760000,2.5e+09,46,112,158
906950000,501840000,19270000,862020000,209920000,2.5e+09,38,97,135
930900000,436570000,19430000,791750000,321350000,2.5e+09,38,107,145
7.97e+08,494210000,42610000,963380000,202800000,2.5e+09,37,101,138
1428620000,185730000,13450000,252300000,619900000,2.5e+09,37,103,140
598640000,1093220000,206800000,541540000,59800000,2.5e+09,40,103,143
1031490000,608620000,45770000,693360000,120760000,2.5e+09,38,102,140
841730000,414350000,91730000,1042670000,109520000,2.5e+09,44,109,153
1.119e+09,573430000,73330000,654070000,80170000,2.5e+09,37,98,135
512750000,629370000,65840000,1227050000,64990000,2.5e+09,40,101,141
341160000,940950000,85600000,1095580000,36710000,2.5e+09,37,104,141
535040000,418570000,57720000,1451820000,36850000,2.5e+09,39,101,140
365680000,389820000,78580000,1639390000,26530000,2.5e+09,33,89,122
764770000,1371370000,64280000,283860000,15720000,2.5e+09,40,102,142
822590000,805210000,57290000,758130000,56780000,2.5e+09,39,97,136
827590000,1166230000,38200000,444020000,23960000,2.5e+09,36,89,125
1132470000,213300000,22680000,1094530000,37020000,2.5e+09,36,93,129
684060000,1234460000,224890000,39350000,317240000,2.5e+09,36,104,140
74070000,1017520000,72590000,190010000,1145810000,2.5e+09,44,119,163
813500000,1239960000,131860000,46740000,267940000,2.5e+09,41,119,160
348420000,731130000,346330000,211230000,862890000,2.5e+09,43,103,146
1204550000,559560000,85860000,469740000,180290000,2.5e+09,38,106,144
974390000,878890000,108340000,226540000,311840000,2.5e+09,37,108,145
1121080000,861760000,77140000,254680000,185340000,2.5e+09,44,113,157
1113230000,867100000,22650000,116190000,380830000,2.5e+09,38,106,144
412460000,900200000,431210000,704660000,51470000,2.5e+09,40,106,146
844380000,824040000,240660000,491950000,98970000,2.5e+09,36,95,131
625400000,1261060000,270940000,192320000,150280000,2.5e+09,44,124,168
696810000,1372750000,110310000,296770000,23360000,2.5e+09,41,101,142
581700000,719750000,161210000,968450000,68890000,2.5e+09,42,103,145
668570000,822040000,116470000,855240000,37680000,2.5e+09,38,94,132
581990000,1267850000,92980000,514750000,42430000,2.5e+09,46,105,151
691320000,1033130000,103740000,568340000,103470000,2.5e+09,44,110,154
1069140000,1030120000,30820000,347070000,22850000,2.5e+09,36,92,128
788910000,781320000,69120000,821720000,38930000,2.5e+09,33,99,132
873450000,1160330000,58080000,379330000,28810000,2.5e+09,39,91,130
725310000,1288770000,198330000,214270000,73320000,2.5e+09,41,94,135
105270000,54640000,137570000,1680000,1873080000,2172240000,27,93,120
1088700000,811490000,50270000,136440000,413100000,2.5e+09,41,121,162
1177680000,717870000,153940000,12560000,437950000,2.5e+09,39,111,150
1182650000,266250000,43410000,556560000,451130000,2.5e+09,37,112,149
1122500000,545770000,15500000,226720000,589510000,2.5e+09,39,110,149
1084700000,780220000,152280000,348840000,133960000,2.5e+09,47,110,157
1118820000,598190000,217280000,375980000,189730000,2.5e+09,43,110,153
1320280000,404490000,65970000,602720000,106540000,2.5e+09,46,105,151
1096980000,599850000,253960000,404620000,144590000,2.5e+09,45,103,148
982430000,918280000,73340000,488010000,37940000,2.5e+09,43,93,136
1078720000,745450000,140470000,482890000,52470000,2.5e+09,42,95,137
403720000,1217580000,45710000,809180000,23810000,2.5e+09,35,93,128
397580000,1367530000,57240000,666650000,1.1e+07,2.5e+09,37,90,127
345130000,1932740000,134290000,67820000,20020000,2.5e+09,36,90,126
254060000,2117850000,48020000,65890000,14180000,2.5e+09,32,89,121
357080000,1041620000,180830000,770260000,150210000,2.5e+09,42,113,155
412650000,969230000,58730000,1036340000,23050000,2.5e+09,34,86,120
581230000,1215880000,266780000,362990000,73120000,2.5e+09,36,97,133
5.27e+08,1657840000,192490000,95500000,27170000,2.5e+09,32,86,118
63380000,713050000,58810000,121900000,1341740000,2298880000,28,76,104
292750000,1121130000,109200000,487080000,489840000,2.5e+09,35,100,135
335080000,1196660000,319490000,569570000,79200000,2.5e+09,36,100,136
125620000,283230000,104940000,327220000,1399900000,2240910000,38,101,139
111680000,935580000,157570000,123290000,1171880000,2.5e+09,39,99,138
53760000,2148770000,167920000,117950000,11600000,2.5e+09,37,96,133
80530000,1478900000,527730000,189210000,223630000,2.5e+09,32,96,128
45670000,899370000,71360000,85850000,1360460000,2462710000,42,107,149
9450000,335180000,33490000,40550000,2041640000,2460310000,25,75,100
162070000,2035810000,114800000,119750000,67570000,2.5e+09,40,108,148
49310000,7.21e+08,33820000,14560000,1431070000,2249760000,39,99,138
112570000,2108030000,128760000,128070000,22570000,2.5e+09,43,108,151
588180000,1571210000,273850000,47590000,19170000,2.5e+09,31,92,123
436710000,1811520000,158480000,52280000,41010000,2.5e+09,35,96,131
798960000,1148650000,455160000,21150000,76080000,2.5e+09,35,101,136
430230000,1820940000,106660000,109270000,32900000,2.5e+09,36,98,134
351160000,1592880000,132310000,408620000,15030000,2.5e+09,30,88,118
638260000,1519500000,221770000,53720000,66750000,2.5e+09,39,99,138
141090000,828340000,104690000,227760000,1194210000,2496090000,46,119,165
298590000,1753850000,124660000,286330000,36570000,2.5e+09,37,98,135
107860000,1820420000,350300000,178710000,42710000,2.5e+09,35,88,123
145440000,2112010000,145130000,29840000,67580000,2.5e+09,35,93,128
55830000,802280000,101280000,116860000,1409700000,2485950000,40,109,149
63180000,2062850000,209250000,150180000,14540000,2.5e+09,38,96,134
19350000,414310000,58610000,129870000,1363660000,1985800000,30,89,119
402680000,1918660000,88820000,24470000,65370000,2.5e+09,35,93,128
636840000,1672470000,102500000,36150000,52040000,2.5e+09,43,105,148
232160000,2074300000,100880000,53060000,39600000,2.5e+09,36,95,131
785700000,1412910000,86920000,175160000,39310000,2.5e+09,36,95,131
738790000,1431280000,153690000,123340000,52900000,2.5e+09,46,100,146
547500000,1700210000,99310000,129980000,2.3e+07,2.5e+09,33,78,111
317550000,1916500000,120880000,98020000,47050000,2.5e+09,43,102,145
485860000,1806370000,95820000,42370000,69580000,2.5e+09,40,98,138
201650000,1555510000,417560000,241950000,83330000,2.5e+09,40,98,138
140740000,2025420000,161340000,153640000,18860000,2.5e+09,34,92,126
375320000,1069370000,424690000,559900000,70720000,2.5e+09,39,87,126
476980000,939490000,113610000,955750000,14170000,2.5e+09,41,93,134
59620000,1336750000,361070000,203650000,538910000,2.5e+09,42,103,145
51250000,1557310000,709380000,156870000,25190000,2.5e+09,32,88,120
94560000,1310090000,553570000,113800000,427980000,2.5e+09,45,104,149
23970000,124570000,282460000,167470000,1595780000,2194250000,38,103,141
34030000,1203980000,202410000,97420000,962160000,2.5e+09,41,109,150
695660000,1363730000,72070000,213820000,154720000,2.5e+09,43,102,145
1118260000,1170420000,45240000,139430000,26650000,2.5e+09,36,90,126
985120000,1030260000,44620000,326470000,113530000,2.5e+09,41,93,134
882350000,826260000,61660000,700850000,28880000,2.5e+09,33,80,113
510540000,1246370000,43180000,609140000,90770000,2.5e+09,45,105,150
445990000,1624530000,68660000,206280000,154540000,2.5e+09,45,101,146
733190000,1028530000,107290000,580600000,50390000,2.5e+09,48,98,146
827950000,1089990000,56170000,414370000,111520000,2.5e+09,45,101,146
624160000,1186240000,443880000,201800000,43920000,2.5e+09,33,81,114
1369850000,394060000,138860000,547560000,49670000,2.5e+09,43,100,143
1131040000,677740000,189520000,464910000,36790000,2.5e+09,39,81,120
1172050000,697070000,114240000,483560000,33080000,2.5e+09,40,89,129
3.59e+08,930410000,738630000,403740000,68220000,2.5e+09,41,91,132
491460000,1219960000,442530000,152090000,193960000,2.5e+09,44,106,150
237610000,1268880000,741420000,174470000,77620000,2.5e+09,43,100,143
37020000,398510000,545250000,1299040000,220180000,2.5e+09,42,109,151
209280000,1236130000,413440000,476700000,164450000,2.5e+09,45,113,158
699640000,533300000,332780000,707870000,226410000,2.5e+09,43,112,155
285040000,1334940000,396040000,403310000,80670000,2.5e+09,42,109,151
13320000,362980000,44950000,120440000,1958310000,2.5e+09,39,101,140
75610000,438160000,412780000,733360000,840090000,2.5e+09,41,110,151
35510000,126060000,120610000,1394570000,823250000,2.5e+09,39,107,146
245640000,908860000,148930000,318420000,878150000,2.5e+09,49,123,172
3500000,170320000,25610000,337790000,1961100000,2498320000,35,100,135
685710000,806860000,171950000,677830000,157650000,2.5e+09,41,98,139
967030000,633440000,67910000,797490000,34130000,2.5e+09,38,89,127
108460000,282770000,10450000,15240000,1965560000,2382480000,42,111,153
3.3e+07,130950000,42750000,28940000,2192310000,2427950000,43,109,152
0,15670000,0,0,1463900000,1479570000,23,72,95
765180000,261830000,7860000,37540000,1427590000,2.5e+09,39,109,148
349260000,597940000,117150000,96270000,1339380000,2.5e+09,45,125,170
661800000,139270000,100880000,2200000,1595850000,2.5e+09,38,96,134
518910000,214960000,28710000,8910000,1728510000,2.5e+09,39,104,143
609790000,86350000,940000,9690000,1793230000,2.5e+09,39,92,131
1154460000,431960000,182640000,507380000,223560000,2.5e+09,41,102,143
698210000,270610000,74460000,4410000,1452310000,2.5e+09,36,94,130
193330000,88850000,5260000,4240000,2208320000,2.5e+09,42,110,152
554400000,127030000,9260000,440000,1808870000,2.5e+09,35,103,138
640000,19720000,550000,2260000,1739640000,1762810000,43,110,153
428420000,252430000,130960000,4470000,1683720000,2.5e+09,35,86,121
985620000,500350000,27600000,241130000,745300000,2.5e+09,39,119,158
1297450000,574060000,97640000,99390000,431460000,2.5e+09,37,103,140
403780000,91210000,11430000,592050000,1401530000,2.5e+09,37,97,134
885740000,441360000,36110000,421220000,715570000,2.5e+09,38,103,141
975480000,236230000,72140000,645120000,571030000,2.5e+09,31,92,123
1228220000,71980000,4480000,535770000,659550000,2.5e+09,32,106,138
802800000,214440000,307660000,154190000,1020910000,2.5e+09,34,107,141
1150230000,123590000,39300000,482890000,703990000,2.5e+09,31,105,136
68270000,37900000,133720000,11850000,1648080000,1899820000,25,75,100
811470000,34750000,28190000,678790000,946800000,2.5e+09,35,99,134
607580000,63370000,16370000,688110000,1124570000,2.5e+09,35,96,131
674390000,1239160000,271710000,181430000,133310000,2.5e+09,38,115,153
924310000,1016870000,69120000,276760000,212940000,2.5e+09,33,97,130
658470000,68480000,70830000,638230000,1063990000,2.5e+09,37,100,137
547130000,51070000,37770000,769260000,1094770000,2.5e+09,31,92,123
566490000,110760000,35600000,495670000,1291480000,2.5e+09,32,98,130
658250000,307660000,58580000,581940000,893570000,2.5e+09,37,110,147
648910000,1282890000,191460000,148290000,228450000,2.5e+09,51,121,172
979300000,219240000,168680000,479930000,652850000,2.5e+09,46,119,165
702720000,729960000,167500000,725070000,174750000,2.5e+09,44,107,151
730830000,166630000,111220000,705470000,785850000,2.5e+09,40,115,155
1213880000,658020000,197610000,386700000,43790000,2.5e+09,46,105,151
974330000,654020000,91540000,679530000,100580000,2.5e+09,47,107,154
836480000,1177890000,321130000,99290000,65210000,2.5e+09,46,108,154
966290000,993740000,239050000,228240000,72680000,2.5e+09,48,108,156
945450000,242290000,53140000,159340000,1099780000,2.5e+09,32,97,129
540690000,1794640000,107610000,44170000,12890000,2.5e+09,32,84,116
1071490000,1169080000,58510000,112840000,88080000,2.5e+09,33,90,123
208420000,2096040000,109450000,8300000,77790000,2.5e+09,34,98,132
935500000,470460000,114120000,78790000,901130000,2.5e+09,28,86,114
1063900000,86870000,38180000,396340000,914710000,2.5e+09,34,99,133
397640000,1747120000,148820000,80390000,126030000,2.5e+09,41,113,154
1136500000,491590000,503140000,46020000,322750000,2.5e+09,38,105,143
194110000,1986570000,247820000,7430000,64070000,2.5e+09,33,90,123
787970000,60590000,46720000,850550000,754170000,2.5e+09,40,90,130
662560000,70860000,43990000,477650000,1244940000,2.5e+09,34,103,137
413860000,11880000,24180000,769640000,1280440000,2.5e+09,37,86,123
1290410000,59780000,69790000,389520000,690500000,2.5e+09,35,103,138
1322210000,644120000,218350000,278410000,36910000,2.5e+09,47,98,145
802090000,1107680000,286630000,226320000,77280000,2.5e+09,48,100,148
833730000,1194070000,301570000,115830000,54800000,2.5e+09,48,93,141
718900000,642860000,317270000,453870000,367100000,2.5e+09,52,113,165
633040000,239710000,134950000,10020000,1439280000,2.457e+09,29,79,108
616460000,1637090000,73670000,31130000,141650000,2.5e+09,37,106,143
1559230000,279470000,42980000,110600000,507720000,2.5e+09,29,93,122
285200000,1986480000,119940000,2800000,105580000,2.5e+09,27,87,114
1590510000,654800000,21390000,61820000,171480000,2.5e+09,28,85,113
1053170000,552140000,469520000,179350000,245820000,2.5e+09,41,117,158
52900000,1770730000,573630000,69870000,32870000,2.5e+09,29,91,120
1277210000,399820000,208430000,283270000,331270000,2.5e+09,37,111,148
49690000,2154720000,255460000,18360000,21770000,2.5e+09,33,91,124
759180000,39900000,42400000,941510000,717010000,2.5e+09,35,92,127
1053810000,92010000,54550000,453220000,846410000,2.5e+09,37,105,142
479580000,2e+06,23900000,729190000,1265330000,2.5e+09,29,85,114
789380000,105240000,30790000,455420000,1119170000,2.5e+09,32,92,124
485610000,1.082e+09,272580000,152800000,507010000,2.5e+09,47,103,150
909120000,226340000,167600000,946490000,250450000,2.5e+09,40,101,141
802060000,192800000,134710000,1283540000,86890000,2.5e+09,47,108,155
861340000,24890000,84550000,954720000,574500000,2.5e+09,38,92,130
494860000,538850000,40330000,37940000,1388020000,2.5e+09,27,79,106
1207500000,964320000,25190000,124280000,178710000,2.5e+09,25,75,100
394610000,1067080000,29860000,43750000,964700000,2.5e+09,32,83,115
1557750000,601810000,127200000,83360000,129880000,2.5e+09,35,93,128
569700000,1305830000,153040000,23180000,448250000,2.5e+09,29,88,117
1351520000,835750000,159920000,62960000,89850000,2.5e+09,31,85,116
886470000,1406740000,107920000,26070000,72800000,2.5e+09,30,79,109
114490000,2142240000,198840000,2340000,42090000,2.5e+09,32,93,125
803950000,1406940000,107440000,44660000,137010000,2.5e+09,26,93,119
35610000,2312270000,102360000,980000,48780000,2.5e+09,30,74,104
484980000,1650710000,202040000,44470000,117800000,2.5e+09,32,107,139
1449110000,232330000,62100000,261430000,495030000,2.5e+09,34,102,136
90820000,1850150000,246260000,67500000,245270000,2.5e+09,38,100,138
1405460000,492890000,132270000,310490000,158890000,2.5e+09,34,104,138
216260000,1934910000,253200000,31240000,64390000,2.5e+09,30,83,113
564340000,81130000,10870000,555430000,1288230000,2.5e+09,32,97,129
1084080000,204220000,41230000,538500000,631970000,2.5e+09,32,94,126
1522080000,409200000,102550000,162170000,3.04e+08,2.5e+09,36,95,131
935430000,158390000,75930000,983170000,347080000,2.5e+09,41,101,142
837530000,27260000,57730000,684210000,893270000,2.5e+09,28,73,101
1238390000,101830000,74880000,541750000,543150000,2.5e+09,42,106,148
852720000,69940000,103130000,584380000,889830000,2.5e+09,33,85,118
200090000,888320000,30830000,78760000,1217160000,2415160000,24,76,100
561490000,1606090000,47940000,114640000,169840000,2.5e+09,30,83,113
682090000,1413310000,20150000,160580000,223870000,2.5e+09,23,81,104
1472740000,819490000,29770000,41280000,136720000,2.5e+09,26,82,108
1292030000,918490000,68790000,61690000,1.59e+08,2.5e+09,30,85,115
11460000,2318450000,119960000,1040000,49090000,2.5e+09,21,65,86
72590000,2212650000,94010000,25100000,95650000,2.5e+09,37,100,137
807140000,1238870000,211170000,182540000,60280000,2.5e+09,38,109,147
104700000,2081430000,283030000,1330000,29510000,2.5e+09,25,66,91
1172300000,82050000,28490000,482010000,735150000,2.5e+09,32,99,131
1371270000,265140000,49900000,259120000,554570000,2.5e+09,38,107,145
1475620000,42920000,106270000,704790000,170400000,2.5e+09,37,89,126
703450000,14270000,30940000,806990000,944350000,2.5e+09,32,84,116
1035150000,343460000,83610000,963090000,74690000,2.5e+09,38,85,123
898490000,973760000,148960000,443640000,35150000,2.5e+09,38,87,125
1120720000,1023250000,163270000,148500000,44260000,2.5e+09,38,89,127
1169780000,838360000,95180000,337090000,59590000,2.5e+09,37,81,118
255060000,1471790000,557680000,126600000,88870000,2.5e+09,40,93,133
630120000,1133510000,315970000,283680000,136720000,2.5e+09,40,95,135
659260000,693590000,640300000,458560000,48290000,2.5e+09,37,78,115
768660000,735560000,525830000,418820000,51130000,2.5e+09,38,87,125
213850000,1154890000,180540000,920040000,30680000,2.5e+09,46,107,153
260290000,1301050000,318230000,516890000,103540000,2.5e+09,41,97,138
244690000,1860950000,222810000,157080000,14470000,2.5e+09,37,92,129
374290000,1137200000,779450000,151800000,57260000,2.5e+09,36,83,119
256100000,713140000,175430000,1231960000,123370000,2.5e+09,41,111,152
205380000,617290000,190180000,1379870000,107280000,2.5e+09,45,107,152
146680000,1822910000,176630000,297190000,56590000,2.5e+09,40,109,149
336700000,1754690000,130670000,161110000,116830000,2.5e+09,40,101,141
14340000,4.42e+08,56970000,567130000,1419560000,2.5e+09,38,102,140
21410000,684620000,134940000,698440000,960590000,2.5e+09,40,102,142
979240000,809170000,108230000,542800000,60560000,2.5e+09,44,100,144
1468660000,434310000,127410000,413410000,56210000,2.5e+09,39,94,133
1346700000,775110000,151160000,180140000,46890000,2.5e+09,45,102,147
1054230000,1030350000,193480000,156420000,65520000,2.5e+09,44,114,158
751020000,1047250000,245400000,379030000,77300000,2.5e+09,44,100,144
458810000,1247540000,176960000,554250000,62440000,2.5e+09,46,101,147
845030000,967420000,296750000,370950000,19850000,2.5e+09,36,88,124
975840000,835210000,166120000,492340000,30490000,2.5e+09,41,99,140
1105220000,909850000,177790000,273790000,33350000,2.5e+09,40,92,132
622670000,1521290000,228660000,60950000,66430000,2.5e+09,41,96,137
841310000,1085870000,365060000,192850000,14910000,2.5e+09,43,99,142
778450000,1093490000,417020000,148890000,62150000,2.5e+09,45,94,139
1432060000,515910000,226820000,295960000,29250000,2.5e+09,38,80,118
1233960000,308930000,255550000,670320000,31240000,2.5e+09,37,79,116
1270860000,760970000,97370000,340880000,29920000,2.5e+09,37,77,114
1109370000,798120000,191330000,384900000,16280000,2.5e+09,39,84,123
293310000,1884650000,246410000,63310000,12320000,2.5e+09,41,92,133
244440000,1.787e+09,278920000,164930000,24710000,2.5e+09,40,87,127
339810000,1667660000,401990000,70960000,19580000,2.5e+09,43,96,139
648670000,1368260000,197700000,244580000,40790000,2.5e+09,43,92,135
230750000,1513510000,175470000,475670000,104600000,2.5e+09,42,99,141
286230000,2028670000,77480000,86600000,21020000,2.5e+09,40,92,132
206640000,1233890000,321410000,696660000,41400000,2.5e+09,41,103,144
169820000,1838430000,78100000,252440000,161210000,2.5e+09,43,98,141
112550000,521400000,150580000,1358980000,356490000,2.5e+09,43,101,144
23150000,294870000,50330000,280890000,1850760000,2.5e+09,40,102,142
158280000,399440000,141050000,1400530000,400700000,2.5e+09,44,111,155
29990000,659080000,59810000,335470000,1415650000,2.5e+09,43,113,156
33090000,4960000,17870000,14990000,1436380000,1507290000,31,73,104
174560000,1808910000,82210000,53170000,381150000,2.5e+09,42,103,145
29450000,961180000,71190000,76520000,1361660000,2.5e+09,44,113,157
967660000,9.34e+08,283110000,163270000,151960000,2.5e+09,48,108,156
1346090000,539680000,141320000,457410000,15500000,2.5e+09,42,90,132
1169920000,912170000,173060000,174550000,70300000,2.5e+09,38,76,114
1057760000,815930000,192730000,417430000,16150000,2.5e+09,43,83,126
1275230000,919680000,190310000,103220000,11560000,2.5e+09,35,86,121
1094300000,976420000,222990000,118270000,88020000,2.5e+09,42,103,145
857340000,990300000,453830000,134840000,63690000,2.5e+09,46,102,148
904080000,1080010000,321500000,105660000,88750000,2.5e+09,42,84,126
1191280000,6.31e+08,115550000,525530000,36640000,2.5e+09,41,91,132
1378510000,766010000,180380000,125110000,49990000,2.5e+09,41,98,139
1063980000,992740000,86980000,3.39e+08,17300000,2.5e+09,40,89,129
541680000,1691070000,189640000,49710000,27900000,2.5e+09,45,101,146
947420000,1151850000,219070000,156020000,25640000,2.5e+09,36,80,116
1064460000,869980000,98980000,450570000,16010000,2.5e+09,35,72,107
9.66e+08,1278350000,102620000,142820000,10210000,2.5e+09,41,94,135
983990000,908950000,138780000,451630000,16650000,2.5e+09,43,97,140
746580000,1463550000,198490000,76520000,14860000,2.5e+09,39,88,127
977570000,1213720000,107670000,190170000,10870000,2.5e+09,40,89,129
520090000,1597020000,270080000,80890000,31920000,2.5e+09,47,103,150
887370000,1267930000,172500000,144540000,27660000,2.5e+09,41,98,139
413780000,1277330000,137630000,627200000,44060000,2.5e+09,44,96,140
479550000,1432540000,205680000,271080000,111150000,2.5e+09,47,104,151
1177440000,895180000,95970000,159780000,171630000,2.5e+09,41,98,139
835050000,1134070000,240130000,220880000,69870000,2.5e+09,46,100,146
142940000,942050000,128840000,1110380000,175790000,2.5e+09,44,108,152
219810000,1118490000,154810000,9.09e+08,97880000,2499990000,47,108,155
287800000,1417270000,169650000,549360000,75920000,2.5e+09,45,105,150
438130000,1034210000,652690000,291340000,83630000,2.5e+09,48,118,166
132260000,1432780000,115770000,573650000,245540000,2.5e+09,43,106,149
141430000,694400000,125500000,1402560000,136110000,2.5e+09,41,94,135
28540000,538160000,39030000,28480000,1865790000,2.5e+09,44,102,146
158360000,1146350000,152880000,269550000,772860000,2.5e+09,46,108,154
194500000,1885860000,154530000,29930000,235180000,2.5e+09,42,91,133
49460000,1721830000,113110000,19280000,596320000,2.5e+09,41,93,134
63860000,781160000,57560000,9940000,1587480000,2.5e+09,41,94,135
881520000,1019990000,324560000,257820000,16110000,2.5e+09,41,76,117
902030000,1108710000,112240000,335470000,41550000,2.5e+09,42,87,129
755640000,1285760000,226500000,183510000,48590000,2.5e+09,45,91,136
643510000,907530000,155250000,712980000,80730000,2.5e+09,43,87,130
919680000,1310580000,122630000,112570000,34540000,2.5e+09,38,73,111
752510000,1198790000,373760000,144540000,30400000,2.5e+09,37,75,112
513570000,1784010000,56640000,132310000,13470000,2.5e+09,41,84,125
851290000,995160000,151350000,462670000,39530000,2.5e+09,41,81,122
950030000,1235890000,93980000,207560000,12540000,2.5e+09,43,96,139
980960000,1258630000,122380000,115200000,22830000,2.5e+09,45,102,147
1076710000,1035460000,99890000,263030000,24910000,2.5e+09,43,90,133
1016560000,1022850000,80010000,327180000,53400000,2.5e+09,41,100,141
389080000,1868290000,159290000,57550000,25790000,2.5e+09,44,93,137
1171940000,879710000,223490000,213780000,11080000,2.5e+09,43,100,143
309900000,1938340000,161700000,40920000,49140000,2.5e+09,40,97,137
1046930000,1165400000,140740000,120400000,26530000,2.5e+09,42,93,135
372180000,1780540000,211270000,98400000,37610000,2.5e+09,47,101,148
1331540000,883590000,1.35e+08,103150000,46720000,2.5e+09,44,101,145
234180000,1852650000,253970000,106370000,52830000,2.5e+09,49,100,149
232550000,1994020000,205530000,30450000,37450000,2.5e+09,49,112,161
752360000,1461770000,73080000,199370000,13420000,2.5e+09,47,104,151
646420000,1391810000,134230000,303840000,23700000,2.5e+09,53,110,163
663810000,1255600000,72370000,4.65e+08,43220000,2.5e+09,49,110,159
676350000,1258740000,96880000,381320000,86710000,2.5e+09,49,109,158
191790000,1416260000,165320000,156030000,570600000,2.5e+09,46,105,151
619570000,1375910000,83660000,368550000,52310000,2.5e+09,51,113,164
309510000,1456060000,96980000,203410000,434040000,2.5e+09,51,118,169
665640000,1283240000,118220000,367340000,65560000,2.5e+09,44,86,130
85290000,764910000,45340000,74160000,1530300000,2.5e+09,44,106,150
12250000,80870000,9900000,18110000,2378870000,2.5e+09,38,79,117
644390000,1376570000,220280000,195930000,62830000,2.5e+09,46,96,142
621630000,779030000,147700000,908380000,43260000,2.5e+09,44,90,134
507150000,1691080000,127640000,160600000,13530000,2.5e+09,41,90,131
733990000,739820000,454120000,378650000,193420000,2.5e+09,47,99,146
696440000,1340210000,218520000,217570000,27260000,2.5e+09,39,93,132
708500000,1321960000,94620000,327100000,47820000,2.5e+09,46,103,149
1076330000,1006730000,129630000,270680000,16630000,2.5e+09,40,97,137
860230000,1379490000,128600000,109150000,22530000,2.5e+09,49,104,153
413070000,1822890000,141130000,112730000,10180000,2.5e+09,46,91,137
722130000,831580000,147670000,697450000,101170000,2.5e+09,46,92,138
1268330000,118920000,9750000,210000,1102790000,2.5e+09,37,107,144
313450000,63830000,13440000,0,1723880000,2114600000,42,114,156
211710000,25770000,5800000,590000,2256130000,2.5e+09,31,85,116
265740000,30500000,4160000,3e+05,2199300000,2.5e+09,31,84,115
385040000,1.9e+07,4910000,0,2091050000,2.5e+09,28,86,114
607490000,70410000,6e+06,0,1816100000,2.5e+09,32,86,118
672600000,110440000,11810000,970000,1704180000,2.5e+09,34,88,122
720630000,129260000,7550000,0,1642560000,2.5e+09,30,89,119
43040000,85050000,2410000,0,2175410000,2305910000,36,85,121
655260000,146810000,46560000,1530000,1649840000,2.5e+09,38,104,142
9210000,68240000,22080000,18980000,1394190000,1512700000,29,73,102
111180000,1462330000,76420000,22190000,827880000,2.5e+09,41,97,138
241270000,1854450000,89760000,2660000,311860000,2.5e+09,40,92,132
2011630000,135500000,19430000,0,333440000,2.5e+09,37,100,137
575250000,52410000,54360000,0,1582760000,2264780000,43,103,146
1438550000,116900000,50070000,0,894480000,2.5e+09,42,102,144
38960000,5160000,840000,0,1053990000,1098950000,28,68,96
1149330000,35780000,3400000,0,1311490000,2.5e+09,34,97,131
1088300000,23810000,3500000,0,1384390000,2.5e+09,33,92,125
1731270000,57200000,3050000,0,708480000,2.5e+09,34,88,122
2032020000,28910000,3470000,0,435600000,2.5e+09,34,88,122
572300000,21830000,8830000,0,1897040000,2.5e+09,33,95,128
1169340000,51710000,12210000,0,1266740000,2.5e+09,34,99,133
585020000,46890000,6020000,270000,1861800000,2.5e+09,29,80,109
412060000,82080000,12420000,0,1993440000,2.5e+09,33,103,136
1110360000,127600000,28770000,3900000,1229370000,2.5e+09,33,103,136
433660000,98060000,2370000,1810000,1964100000,2.5e+09,40,101,141
690410000,271270000,26320000,0,1.512e+09,2.5e+09,38,108,146
619180000,99070000,7800000,450000,1773500000,2.5e+09,37,92,129
810170000,146080000,5240000,3e+05,1538210000,2.5e+09,39,104,143
273170000,50900000,6070000,0,2169860000,2.5e+09,34,96,130
549150000,95740000,1130000,0,1853980000,2.5e+09,38,97,135
159940000,1805690000,94460000,125260000,314650000,2.5e+09,36,88,124
449800000,1680670000,113390000,19710000,236430000,2.5e+09,37,85,122
218090000,1363860000,92120000,21600000,804330000,2.5e+09,39,89,128
184510000,1380580000,196490000,27300000,711120000,2.5e+09,41,92,133
110990000,1194890000,69360000,53160000,1071600000,2.5e+09,40,100,140
102910000,1316530000,139140000,31920000,909500000,2.5e+09,38,92,130
24990000,910000,220000,0,1034170000,1060290000,18,42,60
1855630000,221910000,65200000,2170000,355090000,2.5e+09,41,113,154
1176130000,61870000,35920000,0,1213890000,2487810000,39,108,147
785700000,554830000,140310000,0,1019160000,2.5e+09,47,120,167
82740000,71320000,33180000,0,1674400000,1861640000,37,85,122
1706260000,95650000,12690000,440000,684960000,2.5e+09,37,94,131
1877630000,176150000,36970000,0,409250000,2.5e+09,43,107,150
1578250000,329080000,35390000,0,557280000,2.5e+09,41,103,144
1312090000,385010000,269280000,420000,533200000,2.5e+09,43,104,147
1053120000,138540000,15890000,0,1292450000,2.5e+09,36,101,137
1535340000,94140000,10520000,0,8.6e+08,2.5e+09,33,98,131
1293550000,361330000,4.9e+07,2870000,793250000,2.5e+09,39,110,149
1399750000,360550000,28650000,960000,710090000,2.5e+09,41,109,150
566170000,115730000,7470000,1e+06,1809630000,2.5e+09,41,104,145
1141650000,137060000,10710000,1750000,1208830000,2.5e+09,38,114,152
1085970000,116910000,17770000,870000,1278480000,2.5e+09,40,114,154
650890000,153010000,4490000,0,1691610000,2.5e+09,37,100,137
372150000,86710000,6440000,610000,2034090000,2.5e+09,28,92,120
755270000,150440000,3710000,0,1590580000,2.5e+09,29,87,116
716500000,99690000,2980000,0,1680830000,2.5e+09,32,92,124
168180000,182210000,8520000,0,2141090000,2.5e+09,32,81,113
881070000,236120000,10590000,0,1372220000,2.5e+09,37,104,141
784490000,196080000,3140000,0,1516290000,2.5e+09,34,95,129
731730000,375600000,90160000,0,1302510000,2.5e+09,38,101,139
47840000,221750000,17720000,5790000,1931130000,2224230000,35,81,116
55250000,212250000,26660000,6760000,2162790000,2463710000,37,90,127
1129600000,408510000,70330000,23050000,868510000,2.5e+09,46,116,162
496090000,269210000,92330000,42220000,1586980000,2486830000,45,111,156
1362860000,600150000,125060000,0,411930000,2.5e+09,45,118,163
911910000,197120000,21940000,13230000,1355800000,2.5e+09,43,98,141
1881600000,148060000,8850000,2e+06,459490000,2.5e+09,35,93,128
1774540000,329790000,18640000,3890000,373140000,2.5e+09,35,92,127
1380440000,704200000,75060000,1020000,339280000,2.5e+09,39,100,139
1553380000,572680000,57420000,0,316520000,2.5e+09,43,110,153
1489450000,115140000,20680000,1350000,873380000,2.5e+09,36,106,142
1362850000,404240000,31260000,0,701650000,2.5e+09,43,111,154
985140000,39260000,1030000,0,1474570000,2.5e+09,33,93,126
1493380000,29810000,7670000,0,969140000,2.5e+09,30,95,125
547770000,93740000,1070000,0,1857420000,2.5e+09,30,93,123
956190000,115510000,7310000,0,1420990000,2.5e+09,33,88,121
579040000,488130000,19080000,0,1413750000,2.5e+09,39,110,149
587990000,146840000,5650000,420000,1759100000,2.5e+09,34,95,129
53310000,14980000,0,0,2377420000,2445710000,20,52,72
443900000,49290000,0,0,2006810000,2.5e+09,30,82,112
722750000,184070000,10140000,0,1583040000,2.5e+09,35,96,131
1052420000,233750000,10680000,0,1203150000,2.5e+09,31,90,121
242230000,53230000,0,0,2204540000,2.5e+09,31,82,113
338740000,430840000,34990000,114850000,1579310000,2498730000,24,63,87
558710000,338280000,25200000,53330000,1358280000,2333800000,19,54,73
264100000,252860000,12800000,32800000,1673200000,2235760000,25,78,103
1064400000,429150000,26720000,2.25e+08,754730000,2.5e+09,23,78,101
794990000,809590000,42540000,17510000,835370000,2.5e+09,23,67,90
833900000,1211450000,55220000,50870000,348560000,2.5e+09,29,82,111
1350550000,836960000,78890000,65400000,168200000,2.5e+09,27,84,111
191690000,1072380000,43070000,25520000,1167340000,2.5e+09,25,70,95
451330000,1775850000,99800000,33700000,139320000,2.5e+09,30,82,112
68380000,733310000,371070000,9480000,1276850000,2459090000,29,78,107
666930000,1424240000,115030000,15230000,278570000,2.5e+09,29,77,106
704870000,1613740000,49900000,20830000,110660000,2.5e+09,30,84,114
480060000,1582430000,111700000,35010000,290800000,2.5e+09,30,84,114
1221240000,879470000,34400000,152900000,211990000,2.5e+09,27,79,106
18720000,346510000,20830000,0,1914720000,2300780000,33,87,120
36890000,1217400000,81260000,0,1164450000,2.5e+09,39,90,129
344090000,1809060000,256460000,36310000,54080000,2.5e+09,42,113,155
6e+06,1147850000,222120000,1460000,1122570000,2.5e+09,30,74,104
73940000,767340000,74190000,1.5e+07,1484120000,2414590000,27,74,101
326580000,748190000,48010000,34060000,1343160000,2.5e+09,20,74,94
1122880000,994850000,54180000,104060000,224030000,2.5e+09,32,101,133
573730000,1505110000,183460000,60440000,177260000,2.5e+09,31,91,122
613740000,699040000,55610000,704440000,427170000,2.5e+09,29,91,120
990120000,980020000,78320000,214130000,237410000,2.5e+09,31,102,133
899910000,1175470000,63950000,206890000,153780000,2.5e+09,24,88,112
1185460000,792410000,51420000,264270000,206440000,2.5e+09,32,98,130
318660000,1831790000,75440000,99460000,174650000,2.5e+09,23,82,105
1126370000,693520000,35980000,366780000,277350000,2.5e+09,29,95,124
45470000,733090000,98310000,1970000,1402900000,2281740000,25,73,98
642320000,1508500000,62780000,90040000,196360000,2.5e+09,29,95,124
32410000,2080950000,226990000,9940000,149710000,2.5e+09,41,96,137
269080000,1.125e+09,177500000,10530000,917890000,2.5e+09,43,116,159
163320000,294860000,35750000,5160000,1665400000,2164490000,29,89,118
1384340000,61130000,39740000,554310000,460480000,2.5e+09,29,80,109
1326560000,528250000,71180000,171290000,402720000,2.5e+09,36,99,135
1556350000,133570000,64460000,464090000,281530000,2.5e+09,33,88,121
1320670000,561140000,111630000,116050000,390510000,2.5e+09,34,105,139
1435280000,27850000,93900000,589640000,353330000,2.5e+09,38,93,131
790910000,18640000,37520000,893980000,758950000,2.5e+09,33,87,120
1440540000,15140000,97950000,460920000,485450000,2.5e+09,40,92,132
1029010000,7900000,59820000,765940000,637330000,2.5e+09,30,72,102
47090000,221370000,30710000,11240000,1863440000,2173850000,16,57,73
742610000,1296450000,75640000,141040000,244260000,2.5e+09,31,89,120
782390000,1180500000,275950000,61430000,199730000,2.5e+09,27,79,106
475190000,1434510000,78970000,168860000,342470000,2.5e+09,34,106,140
1189600000,525870000,20720000,407400000,356410000,2.5e+09,36,106,142
52710000,720500000,36260000,9830000,1464020000,2283320000,22,70,92
444480000,1770640000,24130000,56590000,204160000,2.5e+09,26,82,108
11790000,182630000,23750000,0,1332290000,1550460000,16,52,68
57420000,899590000,79170000,0,1271210000,2307390000,24,79,103
388400000,131720000,28800000,177790000,1773290000,2.5e+09,30,91,121
1580920000,483830000,75710000,171240000,188300000,2.5e+09,37,118,155
1369790000,540300000,41880000,162420000,385610000,2.5e+09,40,107,147
1647020000,496550000,61560000,236040000,58830000,2.5e+09,49,116,165
1817530000,71630000,75580000,96460000,438800000,2.5e+09,38,106,144
1484560000,336610000,141510000,351700000,185620000,2.5e+09,37,100,137
1661640000,321400000,37740000,138140000,341080000,2.5e+09,40,100,140
1396820000,644850000,81860000,314180000,62290000,2.5e+09,39,98,137
1599750000,477510000,92590000,169770000,160380000,2.5e+09,34,104,138
1467270000,20930000,48490000,300890000,662420000,2.5e+09,35,91,126
1342730000,58450000,26240000,729260000,343320000,2.5e+09,31,80,111
1828320000,6700000,34730000,296690000,333560000,2.5e+09,35,88,123
1582320000,216890000,66410000,472980000,161400000,2.5e+09,34,86,120
961620000,1077960000,43970000,201220000,215230000,2.5e+09,31,95,126
1135760000,877040000,33800000,208700000,244700000,2.5e+09,31,90,121
224830000,2106940000,41260000,65640000,61330000,2.5e+09,24,75,99
782150000,1364950000,37470000,165450000,149980000,2.5e+09,33,94,127
7720000,2010190000,44560000,36580000,400950000,2.5e+09,22,63,85
403880000,1936990000,33300000,64970000,60860000,2.5e+09,30,80,110
51410000,1741410000,27170000,86980000,593030000,2.5e+09,31,88,119
426820000,582430000,29660000,226070000,1235020000,2.5e+09,38,105,143
1.21e+08,458690000,122790000,198440000,1599080000,2.5e+09,30,88,118
4.33e+08,551640000,24110000,670300000,820950000,2.5e+09,27,91,118
1663290000,2.83e+08,10420000,224710000,318580000,2.5e+09,32,73,105
1378660000,910360000,39410000,110220000,61350000,2.5e+09,37,92,129
1462770000,623880000,38960000,109190000,265200000,2.5e+09,44,89,133
715600000,1149360000,266300000,201790000,166950000,2.5e+09,44,97,141
1019260000,949540000,19470000,190080000,321650000,2.5e+09,28,78,106
1384560000,661670000,109170000,279190000,65410000,2.5e+09,41,90,131
1260210000,908490000,71560000,239940000,19800000,2.5e+09,39,97,136
795630000,1507300000,103860000,69560000,23650000,2.5e+09,46,102,148
835040000,1272270000,58080000,192930000,141680000,2.5e+09,51,106,157
1906750000,42220000,59600000,232370000,259060000,2.5e+09,36,88,124
1500950000,373980000,226090000,380630000,18350000,2.5e+09,37,84,121
1529900000,520150000,132710000,244960000,72280000,2.5e+09,36,86,122
997770000,1292530000,135020000,69100000,5580000,2.5e+09,44,95,139
386210000,1733650000,25860000,50320000,303960000,2.5e+09,28,72,100
67380000,810720000,84170000,40150000,1482220000,2484640000,23,65,88
152490000,1969450000,50330000,298280000,29450000,2.5e+09,25,56,81
189410000,1900740000,83310000,35920000,290620000,2.5e+09,22,48,70
445680000,289630000,25740000,57320000,1681630000,2.5e+09,22,64,86
634780000,448820000,80410000,289910000,1046080000,2.5e+09,29,89,118
1079590000,1087590000,24120000,202500000,106200000,2.5e+09,35,70,105
1629980000,328970000,6990000,425790000,108270000,2.5e+09,22,58,80
893110000,1476290000,36760000,31870000,61970000,2.5e+09,40,85,125
691840000,1386110000,58820000,120880000,242350000,2.5e+09,34,77,111
7.98e+08,1039400000,71680000,211720000,379200000,2.5e+09,40,88,128
891540000,1242970000,60520000,149730000,155240000,2.5e+09,46,102,148
1152230000,919150000,41310000,161100000,226210000,2.5e+09,47,89,136
1026270000,1097670000,107340000,177010000,91710000,2.5e+09,44,96,140
641340000,1366070000,118780000,174700000,199110000,2.5e+09,42,82,124
620770000,1009200000,125320000,323200000,421510000,2.5e+09,46,105,151
889520000,1256440000,76780000,114580000,162680000,2.5e+09,38,93,131
630480000,1345450000,145090000,131410000,247570000,2.5e+09,54,109,163
735330000,1485160000,130030000,96380000,53100000,2.5e+09,38,87,125
307740000,1714920000,162720000,197450000,117170000,2.5e+09,42,86,128
639070000,1398610000,116460000,224670000,121190000,2.5e+09,36,78,114
560870000,1416850000,206130000,164120000,152030000,2.5e+09,49,106,155
327360000,600320000,40070000,150720000,1381530000,2.5e+09,28,91,119
955290000,320260000,29090000,328540000,866820000,2.5e+09,24,91,115
805290000,1455850000,1.7e+07,159570000,62290000,2.5e+09,35,74,109
1476570000,564260000,19710000,344800000,94660000,2.5e+09,26,59,85
668050000,1506210000,43210000,124720000,157810000,2.5e+09,36,79,115
1101400000,1090920000,53960000,70790000,182930000,2.5e+09,43,87,130
429420000,1624920000,107260000,68770000,269630000,2.5e+09,41,97,138
770370000,1301200000,146210000,152170000,130050000,2.5e+09,40,89,129
400910000,1755300000,161380000,76410000,1.06e+08,2.5e+09,50,102,152
740630000,962160000,150550000,328210000,318450000,2.5e+09,46,102,148
287830000,4.51e+08,75510000,166490000,1519170000,2.5e+09,46,104,150
238330000,1041340000,67400000,245960000,906970000,2.5e+09,51,117,168
78040000,1141280000,241150000,68090000,971440000,2.5e+09,41,108,149
2500000,347710000,41620000,15630000,1695820000,2103280000,38,101,139
462810000,1839250000,67200000,118740000,1.2e+07,2.5e+09,40,88,128
630830000,1011090000,116300000,602030000,139750000,2.5e+09,47,95,142
551650000,1623700000,99990000,184220000,40440000,2.5e+09,42,94,136
802430000,709150000,128100000,792530000,67790000,2.5e+09,41,91,132
1096310000,1015470000,71040000,281310000,35870000,2.5e+09,48,108,156
647160000,1515040000,107890000,198530000,31380000,2.5e+09,43,106,149
820950000,1173220000,73590000,409300000,22940000,2.5e+09,50,112,162
1529540000,216080000,62570000,582770000,109040000,2.5e+09,48,108,156
1233960000,607760000,147350000,3.62e+08,148930000,2.5e+09,48,104,152
1105570000,870890000,82920000,3.83e+08,57620000,2.5e+09,50,106,156
684710000,972890000,94040000,397410000,350950000,2.5e+09,47,110,157
917230000,1281200000,125200000,139850000,36520000,2.5e+09,47,109,156
421060000,1669120000,305900000,71110000,32810000,2.5e+09,45,97,142
270660000,1960760000,1.67e+08,46030000,55550000,2.5e+09,44,95,139
685850000,1216160000,240860000,222830000,134300000,2.5e+09,43,95,138
1048590000,1083770000,104110000,203830000,59700000,2.5e+09,48,96,144
960260000,1035590000,138960000,247520000,117670000,2.5e+09,47,95,142
798090000,1330970000,106470000,206390000,58080000,2.5e+09,43,94,137
1135490000,833530000,86490000,323580000,120910000,2.5e+09,48,104,152
577550000,802270000,762100000,233010000,125070000,2.5e+09,47,109,156
367360000,1532350000,133540000,405570000,61180000,2.5e+09,45,102,147
623710000,1281760000,68480000,245190000,280860000,2.5e+09,48,112,160
323810000,1627330000,97510000,395660000,55690000,2.5e+09,45,109,154
780930000,1225410000,84770000,242330000,166560000,2.5e+09,46,100,146
89860000,122690000,21440000,52460000,2022750000,2309200000,44,101,145
424040000,838960000,46470000,105050000,1085480000,2.5e+09,46,115,161
17340000,402440000,26730000,23590000,1371580000,1841680000,37,88,125
984990000,847490000,103080000,496460000,67980000,2.5e+09,40,83,123
579430000,1431470000,226210000,229990000,32900000,2.5e+09,47,87,134
1233250000,908710000,61390000,282450000,14200000,2.5e+09,42,92,134
877040000,1055840000,138470000,387220000,41430000,2.5e+09,43,90,133
748530000,1358980000,82550000,232340000,77600000,2.5e+09,48,111,159
1159600000,675490000,39410000,492360000,133140000,2.5e+09,52,118,170
721890000,1501070000,90720000,159340000,26980000,2.5e+09,45,111,156
952120000,1071670000,121300000,226230000,128680000,2.5e+09,54,125,179
401740000,1808710000,177170000,39070000,73310000,2.5e+09,47,107,154
1131070000,1028600000,151340000,138510000,50480000,2.5e+09,45,103,148
514880000,1659470000,232530000,33570000,59550000,2.5e+09,46,101,147
686550000,1364310000,326320000,80950000,41870000,2.5e+09,47,105,152
759730000,1253020000,300100000,98150000,8.9e+07,2.5e+09,48,102,150
975520000,826410000,202890000,337310000,157870000,2.5e+09,46,110,156
713860000,1272320000,151230000,142520000,220070000,2.5e+09,49,111,160
1044210000,792180000,168560000,392920000,102130000,2.5e+09,45,110,155
1245900000,768780000,136400000,228350000,120570000,2.5e+09,49,106,155
844830000,1011590000,166410000,201210000,275960000,2.5e+09,45,95,140
1417930000,728060000,101230000,144870000,107910000,2.5e+09,45,99,144
1166060000,742350000,156950000,177700000,256940000,2.5e+09,46,107,153
954360000,1083980000,102410000,236810000,122440000,2.5e+09,49,111,160
902660000,1085680000,349530000,102040000,60090000,2.5e+09,48,105,153
707290000,1409890000,57360000,236190000,89270000,2.5e+09,51,120,171
771820000,1320860000,70490000,299910000,36920000,2.5e+09,51,121,172
396810000,798920000,77110000,389590000,837570000,2.5e+09,44,104,148
470720000,1504650000,78370000,380160000,66100000,2.5e+09,50,111,161
481450000,414930000,32600000,237280000,1333740000,2.5e+09,52,122,174
940360000,802930000,146790000,382650000,227270000,2.5e+09,52,121,173
26910000,48260000,18610000,24240000,1262500000,1380520000,40,95,135
303340000,547180000,50950000,113160000,1273390000,2288020000,48,111,159
1175990000,1144690000,74990000,86610000,17720000,2.5e+09,44,93,137
1219550000,875910000,96130000,287930000,20480000,2.5e+09,43,89,132
508650000,1785710000,173250000,1190000,31200000,2.5e+09,44,89,133
1347340000,594400000,331510000,212150000,14600000,2.5e+09,44,94,138
744350000,1508520000,91670000,137380000,18080000,2.5e+09,44,101,145
846560000,1434700000,77620000,106950000,34170000,2.5e+09,46,111,157
778450000,1453120000,102580000,134790000,31060000,2.5e+09,45,97,142
645430000,1686730000,114130000,9540000,44170000,2.5e+09,45,109,154
552820000,1673560000,141960000,108290000,23370000,2.5e+09,49,108,157
625080000,1659810000,133670000,42290000,39150000,2.5e+09,48,111,159
736290000,1346200000,185260000,191540000,40710000,2.5e+09,51,118,169
649810000,1464810000,164710000,174420000,46250000,2.5e+09,48,113,161
1085010000,1115300000,100370000,96660000,102660000,2.5e+09,46,102,148
905390000,842290000,144710000,305430000,302180000,2.5e+09,46,110,156
606260000,1598190000,137560000,111190000,46800000,2.5e+09,48,108,156
913200000,1129700000,135220000,252830000,69050000,2.5e+09,44,111,155
1393090000,820680000,70240000,1.51e+08,64990000,2.5e+09,48,100,148
1151740000,1010470000,94580000,156370000,86840000,2.5e+09,45,106,151
902510000,1176980000,63640000,286660000,70210000,2.5e+09,46,113,159
846610000,1254360000,93120000,197530000,108380000,2.5e+09,49,110,159
945420000,1242350000,34090000,212300000,65840000,2.5e+09,46,114,160
1232260000,850810000,61900000,287940000,67090000,2.5e+09,47,109,156
1491740000,638410000,22700000,217200000,129950000,2.5e+09,49,113,162
1191390000,1104440000,27410000,108040000,68720000,2.5e+09,48,107,155
748540000,1274120000,31660000,340170000,105510000,2.5e+09,43,100,143
711220000,1414790000,42450000,247920000,83620000,2.5e+09,47,110,157
1061200000,1163840000,39700000,204630000,30630000,2.5e+09,42,96,138
1221180000,927480000,38390000,131140000,181810000,2.5e+09,44,99,143
1036530000,1126700000,53910000,199650000,83210000,2.5e+09,47,106,153
447120000,467760000,16540000,166480000,1317640000,2415540000,43,111,154
1116890000,1135980000,38400000,139480000,69250000,2.5e+09,42,106,148
440050000,1820730000,173930000,34710000,30580000,2.5e+09,44,100,144
358990000,1586850000,331690000,37540000,184930000,2.5e+09,53,108,161
920690000,1328590000,140460000,30530000,79730000,2.5e+09,54,118,172
282480000,1784560000,263270000,22740000,146950000,2.5e+09,52,115,167
1047340000,1145170000,186330000,47660000,73500000,2.5e+09,42,103,145
335840000,1891350000,195580000,12320000,64910000,2.5e+09,55,121,176
604300000,1546570000,240410000,50210000,58510000,2.5e+09,49,117,166
788690000,1370670000,172920000,139530000,28190000,2.5e+09,51,123,174
987820000,1037720000,69920000,273120000,131420000,2.5e+09,47,105,152
901640000,1197400000,152310000,202350000,46300000,2.5e+09,46,106,152
609910000,1508790000,147880000,155090000,78330000,2.5e+09,47,107,154
835290000,974730000,108030000,465660000,116290000,2.5e+09,49,121,170
489270000,1579190000,261770000,124760000,45010000,2.5e+09,48,112,160
397580000,1915600000,130830000,32810000,23180000,2.5e+09,41,96,137
736620000,1396260000,116710000,218110000,32300000,2.5e+09,47,113,160
671700000,1501820000,130550000,127640000,68290000,2.5e+09,47,110,157
473430000,1678280000,92880000,216220000,39190000,2.5e+09,48,121,169
559710000,1607430000,99510000,191900000,41450000,2.5e+09,47,111,158
434450000,1771360000,88620000,189430000,16140000,2.5e+09,48,112,160
722570000,1387060000,112720000,212880000,64770000,2.5e+09,50,113,163
810550000,1250830000,57430000,344070000,37120000,2.5e+09,45,116,161
684970000,1426680000,222430000,112440000,53480000,2.5e+09,47,107,154
498470000,1552870000,84390000,294530000,69740000,2.5e+09,47,106,153
431960000,1870130000,65420000,65920000,66570000,2.5e+09,44,95,139
1347760000,891710000,25850000,128340000,106340000,2.5e+09,42,99,141
1121690000,1088930000,31740000,153050000,104590000,2.5e+09,45,105,150
1473270000,712420000,26630000,169500000,118180000,2.5e+09,47,110,157
653100000,1627380000,37190000,117800000,64530000,2.5e+09,47,114,161
506120000,1707090000,223070000,10360000,53360000,2.5e+09,42,101,143
63070000,2200120000,189240000,7330000,40240000,2.5e+09,44,100,144
155710000,508210000,168170000,9380000,1647820000,2489290000,41,89,130
939720000,672550000,99320000,48650000,739760000,2.5e+09,43,110,153
810540000,1058520000,145860000,75850000,409230000,2.5e+09,46,113,159
789060000,240560000,202430000,28040000,1239910000,2.5e+09,45,107,152
69880000,224830000,33070000,26410000,1839350000,2193540000,42,110,152
1942520000,275580000,64950000,16790000,200160000,2.5e+09,42,97,139
1903880000,394760000,28920000,9930000,162510000,2.5e+09,41,101,142
525120000,1269920000,40100000,12750000,652110000,2.5e+09,42,104,146
1669220000,560640000,57080000,29200000,183860000,2.5e+09,40,98,138
1654110000,323370000,25640000,7820000,489060000,2.5e+09,41,94,135
578970000,216530000,13930000,1840000,1688730000,2.5e+09,39,94,133
2048220000,7.4e+07,9040000,0,368740000,2.5e+09,33,88,121
1823980000,201250000,24110000,2680000,447980000,2.5e+09,39,92,131
1599500000,12450000,14240000,540000,873270000,2.5e+09,33,91,124
1756030000,20230000,3480000,0,720260000,2.5e+09,33,88,121
1157870000,15480000,8540000,690000,1317420000,2.5e+09,38,108,146
613260000,10970000,1320000,21070000,1853380000,2.5e+09,30,91,121
827840000,7620000,7530000,4.2e+07,1615010000,2.5e+09,34,94,128
1936070000,233170000,33420000,20260000,277080000,2.5e+09,43,100,143
1563460000,598690000,89480000,114040000,134330000,2.5e+09,46,111,157
1815990000,232420000,19710000,24460000,407420000,2.5e+09,43,100,143
1233130000,380890000,76150000,67360000,742470000,2.5e+09,47,122,169
1974630000,209110000,49120000,10010000,257130000,2.5e+09,42,100,142
1711250000,241290000,45710000,16190000,485560000,2.5e+09,42,106,148
1812470000,355850000,46920000,35120000,249640000,2.5e+09,39,93,132
1848180000,238120000,52010000,16110000,345580000,2.5e+09,41,98,139
1062240000,1111890000,61110000,90380000,174380000,2.5e+09,42,107,149
1498710000,653540000,49130000,62020000,236600000,2.5e+09,39,99,138
703010000,518140000,38440000,19620000,1220790000,2.5e+09,41,111,152
1258270000,365710000,52250000,41750000,782020000,2.5e+09,40,94,134
673120000,290640000,75710000,6500000,1454030000,2.5e+09,42,99,141
425450000,230580000,18300000,3280000,1822390000,2.5e+09,39,99,138
1670410000,317630000,5.8e+07,8460000,445500000,2.5e+09,42,100,142
1515300000,280200000,22380000,8170000,673950000,2.5e+09,41,103,144
1836590000,60790000,13880000,8e+05,587940000,2.5e+09,32,90,122
1791100000,192840000,17110000,5510000,493440000,2.5e+09,39,93,132
1839410000,13260000,8020000,990000,638320000,2.5e+09,33,91,124
1799030000,39780000,27310000,1810000,632070000,2.5e+09,32,92,124
1658500000,32800000,20240000,3590000,784870000,2.5e+09,33,91,124
1402390000,33120000,16210000,2880000,1045400000,2.5e+09,33,89,122
1691520000,64370000,40490000,8330000,695290000,2.5e+09,34,106,140
1197130000,4840000,4270000,1170000,1292590000,2.5e+09,32,91,123
1390800000,1700000,3790000,310000,1103400000,2.5e+09,32,88,120
1466380000,23720000,8960000,1930000,999010000,2.5e+09,34,89,123
1511140000,650000,8e+05,0,987410000,2.5e+09,33,87,120
1051080000,2090000,810000,30940000,1415080000,2.5e+09,33,93,126
1480860000,10690000,8570000,2550000,997330000,2.5e+09,34,94,128
1464460000,161120000,7300000,740000,866380000,2.5e+09,34,96,130
1414800000,22910000,7300000,2360000,1052630000,2.5e+09,32,89,121
1510190000,57460000,11360000,10200000,910790000,2.5e+09,37,99,136
2087810000,139460000,24110000,12460000,236160000,2.5e+09,43,97,140
738990000,174080000,44400000,31980000,1510480000,2499930000,43,119,162
183480000,396900000,50310000,154120000,1713760000,2498570000,45,125,170
1904130000,262440000,37400000,23180000,272850000,2.5e+09,39,92,131
2094550000,105140000,18030000,17500000,264780000,2.5e+09,41,95,136
1813840000,180980000,24500000,17260000,463420000,2.5e+09,44,110,154
1504440000,194180000,36490000,12580000,752310000,2.5e+09,43,111,154
1000500000,1078880000,98400000,53320000,268900000,2.5e+09,40,104,144
1764510000,207740000,15870000,41250000,470630000,2.5e+09,37,96,133
908960000,479080000,14930000,21290000,1075740000,2.5e+09,45,114,159
999790000,890860000,84020000,18720000,506610000,2.5e+09,41,107,148
1785880000,340310000,33770000,2.3e+07,317040000,2.5e+09,41,96,137
1134820000,761400000,80570000,21760000,501450000,2.5e+09,41,98,139
1514610000,493190000,42670000,18560000,430970000,2.5e+09,41,98,139
1720050000,198690000,53390000,2100000,525770000,2.5e+09,37,101,138
1759840000,207740000,23290000,2930000,506200000,2.5e+09,39,100,139
1627540000,422160000,33940000,8890000,407470000,2.5e+09,39,100,139
1301830000,733580000,99120000,17820000,347650000,2.5e+09,42,109,151
1795700000,43210000,9600000,4910000,646580000,2.5e+09,33,97,130
1820550000,155420000,20260000,1940000,501830000,2.5e+09,34,102,136
1865070000,154500000,39700000,4770000,435960000,2.5e+09,36,93,129
1772620000,36530000,5590000,590000,684670000,2.5e+09,33,100,133
1788690000,37080000,8740000,1100000,664390000,2.5e+09,38,104,142
1621970000,95290000,17230000,3110000,762400000,2.5e+09,37,101,138
1803090000,212870000,25530000,2180000,456330000,2.5e+09,40,101,141
1704720000,25060000,4350000,820000,765050000,2.5e+09,33,90,123
1533930000,31010000,5860000,1950000,927250000,2.5e+09,34,96,130
1655810000,51550000,6530000,3710000,782400000,2.5e+09,33,94,127
1736580000,83900000,8900000,1010000,669610000,2.5e+09,34,95,129
1353770000,39850000,7120000,16670000,1082590000,2.5e+09,33,91,124
1566190000,45420000,3050000,4470000,880870000,2.5e+09,33,93,126
1597610000,36130000,5400000,4370000,856490000,2.5e+09,34,97,131
1621320000,64840000,3590000,3140000,807110000,2.5e+09,36,99,135
104540000,80390000,4660000,32040000,2263010000,2484640000,39,110,149
1171320000,510830000,48690000,24260000,744900000,2.5e+09,41,98,139
1138680000,583190000,55730000,14060000,708340000,2.5e+09,45,107,152
932960000,314560000,611670000,21830000,618980000,2.5e+09,42,109,151
364040000,114280000,21400000,6990000,1922770000,2429480000,43,108,151
1466160000,537450000,25780000,16300000,454310000,2.5e+09,42,108,150
967870000,1086690000,99250000,44110000,302080000,2.5e+09,41,105,146
452690000,14490000,32120000,1340000,1727720000,2228360000,40,112,152
1150010000,104200000,73650000,12720000,1159420000,2.5e+09,43,118,161
845850000,89510000,10660000,320000,1553660000,2.5e+09,38,105,143
473020000,43130000,22320000,5840000,1916220000,2460530000,40,106,146
1739860000,94600000,30620000,1200000,633720000,2.5e+09,38,103,141
1234750000,180650000,87910000,5580000,991110000,2.5e+09,45,121,166
1524840000,18740000,1870000,3510000,951040000,2.5e+09,33,98,131
1784670000,105810000,14900000,2450000,592170000,2.5e+09,34,98,132
773040000,105850000,2520000,0,1618590000,2.5e+09,27,76,103
769470000,80910000,1140000,0,1648480000,2.5e+09,30,85,115
315160000,120480000,6860000,0,2057500000,2.5e+09,30,77,107
648070000,70510000,1280000,0,1780140000,2.5e+09,28,74,102
171640000,112140000,6450000,640000,2209130000,2.5e+09,30,81,111
764820000,22700000,1470000,2900000,1708110000,2.5e+09,31,86,117
511310000,13540000,310000,6240000,1968600000,2.5e+09,32,87,119
1052880000,5260000,1600000,58930000,1381330000,2.5e+09,29,90,119
1220820000,4500000,50000,6120000,1268510000,2.5e+09,32,92,124
787050000,31470000,890000,0,1680590000,2.5e+09,24,56,80
821970000,21260000,1410000,26450000,1628910000,2.5e+09,25,81,106
499160000,6270000,1340000,59200000,1934030000,2.5e+09,26,87,113
317080000,46520000,0,0,2136400000,2.5e+09,25,75,100
784940000,143330000,11880000,0,1559850000,2.5e+09,35,96,131
643610000,29570000,16630000,0,1810190000,2.5e+09,39,103,142
171270000,32040000,1850000,0,2116380000,2321540000,29,86,115
268340000,56470000,20420000,460000,2154310000,2.5e+09,32,87,119
562980000,54830000,1990000,0,1880200000,2.5e+09,29,83,112
1356410000,8100000,560000,6750000,1128180000,2.5e+09,33,96,129
1413540000,30410000,1390000,8340000,1046320000,2.5e+09,32,87,119
1274440000,23140000,4200000,9340000,1188880000,2.5e+09,32,97,129
1429480000,24440000,3730000,7080000,1035270000,2.5e+09,33,98,131
1258690000,3950000,4610000,23600000,1209150000,2.5e+09,32,96,128
1426130000,3350000,2470000,20980000,1047070000,2.5e+09,32,95,127
1690200000,6840000,910000,1130000,800920000,2.5e+09,33,98,131
1399610000,4280000,2340000,0,1093770000,2.5e+09,34,96,130
148460000,1660000,0,44620000,2305260000,2.5e+09,25,77,102
354140000,470000,0,148960000,1996430000,2.5e+09,29,84,113
1105960000,0,0,18660000,1375380000,2.5e+09,31,90,121
611390000,28410000,4800000,18480000,1836920000,2.5e+09,33,96,129
483610000,30130000,2650000,0,1983610000,2.5e+09,25,64,89
675420000,60090000,960000,0,1763530000,2.5e+09,28,78,106
622240000,48290000,13810000,5820000,1809840000,2.5e+09,28,79,107
453710000,37060000,1620000,0,2007610000,2.5e+09,26,78,104
762160000,127330000,15400000,0,1595110000,2.5e+09,28,80,108
1234010000,16100000,0,1490000,1248400000,2.5e+09,32,94,126
1414330000,19920000,4290000,850000,1060610000,2.5e+09,34,97,131
1359360000,1.9e+07,8330000,2390000,1110920000,2.5e+09,32,94,126
259890000,0,620000,67930000,2171560000,2.5e+09,25,76,101
982890000,3e+05,0,25850000,1490960000,2.5e+09,32,90,122
795250000,71440000,7240000,27060000,1599010000,2.5e+09,21,59,80
34950000,283470000,6790000,68270000,2106520000,2.5e+09,15,59,74
100620000,493410000,30310000,196300000,1679360000,2.5e+09,31,96,127
422240000,724990000,45620000,340550000,966600000,2.5e+09,34,104,138
39840000,691870000,37510000,141610000,1589170000,2.5e+09,39,107,146
1196180000,286930000,9530000,250500000,756860000,2.5e+09,36,103,139
56600000,570090000,6030000,14170000,1853110000,2.5e+09,20,63,83
11900000,922240000,27500000,0,1538360000,2.5e+09,12,54,66
377580000,1116990000,7580000,152720000,845130000,2.5e+09,24,73,97
298880000,1203720000,23020000,170350000,804030000,2.5e+09,22,60,82
181920000,937670000,38540000,162050000,1179820000,2.5e+09,32,97,129
30660000,595930000,12060000,25380000,1835970000,2.5e+09,28,78,106
883700000,359880000,8690000,44290000,1203440000,2.5e+09,26,90,116
229470000,769150000,41080000,83630000,1376670000,2.5e+09,27,78,105
376250000,558220000,8230000,137390000,1419910000,2.5e+09,35,96,131
149010000,1422780000,85480000,429570000,413160000,2.5e+09,34,97,131
408950000,905840000,11550000,389900000,783760000,2.5e+09,32,89,121
163610000,616830000,8930000,197970000,1512660000,2.5e+09,27,83,110
0,51800000,260000,72420000,1932240000,2056720000,12,41,53
44010000,457430000,6030000,87560000,1904970000,2.5e+09,16,60,76
366990000,732820000,14510000,210270000,1175410000,2.5e+09,27,82,109
561910000,683870000,1.2e+07,380290000,861930000,2.5e+09,25,81,106
138940000,812830000,39490000,79800000,1428940000,2.5e+09,20,58,78
77020000,250160000,7440000,175020000,1990360000,2.5e+09,16,63,79
558970000,564710000,18100000,238410000,1119810000,2.5e+09,33,104,137
289440000,408200000,10710000,96660000,1694990000,2.5e+09,25,67,92
107520000,1027640000,27280000,38710000,1298850000,2.5e+09,27,80,107
279290000,538380000,24020000,118540000,1539770000,2.5e+09,18,59,77
6150000,1977790000,74390000,181170000,260500000,2.5e+09,19,77,96
141420000,1224570000,41220000,90040000,1002750000,2.5e+09,34,93,127
366770000,464700000,47970000,54550000,1516770000,2450760000,29,74,103
327970000,513490000,32300000,53930000,1572310000,2.5e+09,20,62,82
672140000,353890000,7650000,381610000,1084710000,2.5e+09,21,67,88
268580000,284550000,30910000,70400000,1845560000,2.5e+09,29,100,129
700540000,1495230000,70870000,173370000,59990000,2.5e+09,38,81,119
447160000,1736750000,78950000,91040000,146100000,2.5e+09,47,106,153
673110000,1516710000,78630000,80100000,151450000,2.5e+09,35,82,117
1198400000,502580000,5360000,303310000,490350000,2.5e+09,30,94,124
333800000,1914430000,143990000,5630000,102150000,2.5e+09,41,83,124
363420000,1666190000,85760000,78440000,306190000,2.5e+09,46,96,142
340460000,1805110000,132360000,20290000,201780000,2.5e+09,31,67,98
7500000,2273400000,122380000,54990000,41730000,2.5e+09,39,90,129
260860000,1939780000,114450000,49450000,135460000,2.5e+09,42,90,132
286440000,1823370000,119760000,154230000,116200000,2.5e+09,40,97,137
501870000,1672630000,105610000,79940000,139950000,2.5e+09,41,91,132
284460000,1311750000,79640000,523380000,300770000,2.5e+09,40,97,137
492600000,1521050000,90440000,216410000,179500000,2.5e+09,40,90,130
813450000,1112470000,278410000,138860000,156810000,2.5e+09,49,107,156
169420000,1769570000,243920000,155940000,161150000,2.5e+09,43,108,151
498510000,1229280000,547100000,101390000,123720000,2.5e+09,40,90,130
455620000,1344500000,157140000,389210000,153530000,2.5e+09,41,92,133
779960000,1555340000,62220000,70050000,32430000,2.5e+09,28,79,107
1214020000,772020000,33290000,81840000,398830000,2.5e+09,28,80,108
245090000,1919640000,180780000,25670000,128820000,2.5e+09,46,93,139
111300000,1878300000,277910000,57340000,175150000,2.5e+09,43,94,137
18280000,2031620000,108850000,232870000,108380000,2.5e+09,46,104,150
118610000,1845840000,169330000,154310000,211910000,2.5e+09,51,116,167
4420000,2205220000,132610000,103310000,54440000,2.5e+09,37,86,123
13350000,1943900000,122860000,276610000,143280000,2.5e+09,50,114,164
206050000,1753170000,98370000,327570000,114840000,2.5e+09,42,101,143
217600000,1715230000,167490000,268470000,131210000,2.5e+09,47,105,152
30660000,2200640000,93030000,151910000,23760000,2.5e+09,32,88,120
33740000,2123600000,117100000,176800000,48760000,2.5e+09,36,88,124
183020000,1898240000,139590000,194140000,85010000,2.5e+09,38,90,128
98670000,1627860000,120700000,449690000,203080000,2.5e+09,45,111,156
557150000,1067240000,24750000,285390000,565470000,2.5e+09,41,120,161
771510000,897340000,25910000,228640000,576600000,2.5e+09,48,132,180
904590000,523770000,12560000,455610000,603470000,2.5e+09,34,90,124
803310000,798660000,30820000,350200000,517010000,2.5e+09,44,129,173
680050000,1547450000,108170000,32820000,131510000,2.5e+09,30,71,101
448790000,1535330000,77590000,163800000,274490000,2.5e+09,48,111,159
1698430000,360480000,31410000,297380000,112300000,2.5e+09,35,79,114
1689470000,414450000,13860000,148940000,233280000,2.5e+09,30,79,109
222730000,1718550000,173830000,334670000,50220000,2.5e+09,34,81,115
146580000,1935010000,109370000,272330000,36710000,2.5e+09,27,74,101
871980000,979670000,148540000,400110000,99700000,2.5e+09,27,81,108
1213840000,703960000,89010000,381630000,111560000,2.5e+09,33,74,107
134290000,1664970000,152550000,443510000,104680000,2.5e+09,39,97,136
89840000,1905540000,181350000,225660000,97610000,2.5e+09,31,83,114
707150000,1166510000,139150000,413840000,73350000,2.5e+09,38,89,127
1181020000,802580000,119240000,284800000,112360000,2.5e+09,33,77,110
97510000,1451940000,126650000,661980000,161920000,2.5e+09,41,102,143
53070000,1811230000,87500000,490190000,58010000,2.5e+09,35,93,128
705900000,1323250000,141450000,186790000,142610000,2.5e+09,40,85,125
262660000,1634620000,197590000,319190000,85940000,2.5e+09,32,88,120
440070000,1335980000,62010000,13490000,648450000,2.5e+09,45,128,173
98020000,926560000,95720000,37040000,1342660000,2.5e+09,33,94,127
840710000,767920000,33030000,202540000,655800000,2.5e+09,37,106,143
355020000,1830740000,65060000,96410000,152770000,2.5e+09,34,99,133
902830000,980490000,54200000,179670000,382810000,2.5e+09,50,130,180
298380000,1402340000,93280000,227660000,478340000,2.5e+09,35,102,137
1185440000,596370000,29760000,388850000,299580000,2.5e+09,30,98,128
893120000,799700000,73730000,349780000,383670000,2.5e+09,47,123,170
1224340000,527870000,30670000,318370000,398750000,2.5e+09,42,130,172
996820000,577090000,71830000,369760000,484500000,2.5e+09,39,114,153
453890000,1171720000,3.37e+08,254160000,283230000,2.5e+09,42,126,168
177350000,1800300000,166670000,108490000,247190000,2.5e+09,32,92,124
1351580000,471380000,57360000,450260000,169420000,2.5e+09,27,68,95
438380000,1612300000,148640000,217320000,83360000,2.5e+09,19,70,89
1531850000,247660000,33270000,428180000,259040000,2.5e+09,23,70,93
1468860000,429790000,65630000,440010000,95710000,2.5e+09,30,81,111
1593940000,428560000,133460000,294700000,49340000,2.5e+09,24,66,90
1263160000,337930000,58920000,735020000,104970000,2.5e+09,30,79,109
229170000,1684820000,190430000,342230000,53350000,2.5e+09,34,78,112
865330000,657180000,31350000,280100000,666040000,2.5e+09,37,103,140
372390000,1343980000,47250000,26530000,709850000,2.5e+09,37,103,140
1589580000,433600000,35130000,149640000,292050000,2.5e+09,35,114,149
906210000,864230000,97940000,275430000,356190000,2.5e+09,43,105,148
1190460000,721460000,100570000,160550000,326960000,2.5e+09,36,107,143
248420000,1703620000,141780000,172980000,233200000,2.5e+09,36,83,119
369140000,1312980000,150390000,554660000,112830000,2.5e+09,41,99,140
1185710000,386310000,98400000,610300000,219280000,2.5e+09,35,88,123
702430000,1202440000,307140000,101990000,1.86e+08,2.5e+09,45,106,151
370240000,1466240000,401880000,124290000,137350000,2.5e+09,49,122,171
853930000,747360000,528480000,179110000,191120000,2.5e+09,50,113,163
746410000,1282040000,237930000,122650000,110970000,2.5e+09,52,119,171
533790000,1665820000,97980000,187600000,14810000,2.5e+09,46,104,150
1231500000,919040000,84050000,185940000,79470000,2.5e+09,47,107,154
688300000,1245920000,107600000,328250000,129930000,2.5e+09,48,105,153
791850000,1187790000,186260000,272130000,61970000,2.5e+09,44,112,156
516050000,1473500000,84120000,339380000,86950000,2.5e+09,46,106,152
425550000,1691230000,111720000,198790000,72710000,2.5e+09,46,114,160
226490000,1916270000,67760000,272090000,17390000,2.5e+09,46,115,161
521870000,1476130000,286660000,181340000,3.4e+07,2.5e+09,44,114,158
700690000,1409180000,128640000,149140000,112350000,2.5e+09,43,105,148
232120000,1996750000,36050000,86670000,148410000,2.5e+09,45,105,150
558640000,1757300000,28650000,90700000,64710000,2.5e+09,47,110,157
553380000,1685170000,53370000,89800000,118280000,2.5e+09,48,117,165
1045030000,1216210000,41320000,140570000,56870000,2.5e+09,49,106,155
779930000,1469030000,39990000,124560000,86490000,2.5e+09,46,109,155
350640000,1861170000,62120000,145250000,80820000,2.5e+09,49,106,155
440010000,1833380000,40810000,111370000,74430000,2.5e+09,48,112,160
425100000,358770000,69310000,91800000,1526350000,2471330000,46,111,157
727670000,1243680000,190190000,77160000,261300000,2.5e+09,47,107,154
74770000,918940000,5e+07,42780000,1413510000,2.5e+09,54,117,171
1319450000,802100000,119220000,147970000,111260000,2.5e+09,39,87,126
487390000,1808690000,129270000,26660000,47990000,2.5e+09,57,112,169
1226820000,765830000,83570000,286010000,137770000,2.5e+09,44,108,152
904780000,1228320000,110810000,189280000,66810000,2.5e+09,51,107,158
1530960000,568530000,133040000,184620000,82850000,2.5e+09,46,114,160
911100000,1104210000,123870000,272890000,87930000,2.5e+09,48,112,160
1414160000,705360000,128030000,168350000,84100000,2.5e+09,48,117,165
1289370000,557880000,84510000,363160000,205080000,2.5e+09,38,102,140
1594340000,338710000,88640000,303440000,174870000,2.5e+09,46,117,163
375680000,1910940000,110290000,93300000,9790000,2.5e+09,47,105,152
630020000,1528510000,200950000,104210000,36310000,2.5e+09,40,108,148
199950000,1818670000,114630000,322860000,43890000,2.5e+09,47,112,159
710840000,1517690000,107360000,103740000,60370000,2.5e+09,45,109,154
816940000,1231790000,97250000,273980000,80040000,2.5e+09,44,108,152
843080000,1196760000,66740000,336640000,56780000,2.5e+09,46,108,154
1079600000,955180000,96800000,225920000,142500000,2.5e+09,47,111,158
737710000,1296230000,150040000,262220000,53800000,2.5e+09,50,114,164
315240000,1850460000,97940000,207150000,29210000,2.5e+09,46,109,155
633180000,1549430000,155920000,125110000,36360000,2.5e+09,47,112,159
536630000,1415140000,335270000,157130000,55830000,2.5e+09,44,109,153
506880000,1707440000,65910000,188480000,31290000,2.5e+09,47,111,158
605200000,1359610000,29340000,464190000,41660000,2.5e+09,41,105,146
382180000,1891170000,49980000,103010000,73660000,2.5e+09,48,114,162
456110000,1679560000,42380000,293100000,28850000,2.5e+09,38,100,138
471290000,1679530000,81720000,216260000,51200000,2.5e+09,48,112,160
730090000,1506290000,33650000,91340000,138630000,2.5e+09,47,106,153
639830000,1566610000,33980000,170660000,88920000,2.5e+09,44,105,149
703650000,1507490000,65060000,125700000,98100000,2.5e+09,47,119,166
1267440000,825580000,29450000,240720000,136810000,2.5e+09,48,112,160
0,0,0,0,2.24e+08,2.24e+08,48,117,165
443040000,913790000,17370000,58360000,521890000,1954450000,51,107,158
313450000,922230000,13860000,63050000,16480000,1329070000,50,115,165
11570000,0,960000,0,918770000,931300000,35,84,119
1252450000,950200000,72480000,158390000,66480000,2.5e+09,46,117,163
1319740000,671990000,125990000,263140000,119140000,2.5e+09,45,96,141
1207450000,788870000,80990000,278450000,144240000,2.5e+09,48,115,163
867190000,1146370000,190890000,189490000,106060000,2.5e+09,42,90,132
1042100000,680430000,86880000,501490000,189100000,2.5e+09,38,98,136
1425360000,379670000,68830000,301080000,325060000,2.5e+09,37,98,135
1247410000,860550000,100290000,212090000,79660000,2.5e+09,46,111,157
1238780000,726180000,94270000,209290000,231480000,2.5e+09,47,104,151
631150000,1540310000,110260000,146840000,71440000,2.5e+09,47,109,156
565450000,1733140000,113310000,78250000,9850000,2.5e+09,44,104,148
626140000,1484930000,153980000,164990000,69960000,2.5e+09,47,109,156
520050000,1713140000,103360000,119650000,43800000,2.5e+09,48,108,156
407870000,1836090000,97490000,108470000,50080000,2.5e+09,46,118,164
851470000,1307490000,102100000,153930000,85010000,2.5e+09,53,120,173
703670000,1165590000,346650000,232470000,51620000,2.5e+09,47,113,160
791880000,1294010000,92950000,230410000,90750000,2.5e+09,48,115,163
534300000,1453720000,74230000,411360000,26390000,2.5e+09,46,107,153
537160000,1517830000,81140000,298130000,65740000,2.5e+09,46,115,161
787990000,1105310000,39990000,526770000,39940000,2.5e+09,46,110,156
771560000,1262770000,82640000,314150000,68880000,2.5e+09,48,114,162
547710000,1476760000,49080000,409840000,16610000,2.5e+09,49,118,167
682270000,1400500000,62580000,320510000,34140000,2.5e+09,47,113,160
614390000,1426460000,37320000,138460000,283370000,2.5e+09,52,116,168
1216060000,542850000,12540000,643870000,84680000,2.5e+09,49,107,156
701200000,1344380000,30670000,165700000,258050000,2.5e+09,50,109,159
683420000,1254510000,31690000,486370000,44010000,2.5e+09,55,122,177
181460000,776390000,9690000,60470000,51300000,1079310000,46,109,155
26920000,43920000,10400000,17460000,7190000,105890000,41,98,139
364990000,689060000,9330000,58550000,22590000,1144520000,48,116,164
630340000,1255350000,120390000,86220000,407700000,2.5e+09,50,115,165
258570000,618690000,32800000,251610000,619660000,1781330000,52,131,183
761730000,1367100000,48710000,216720000,105740000,2.5e+09,52,117,169
723580000,1255760000,80340000,241790000,179630000,2481100000,46,108,154
896910000,1208050000,166250000,143900000,84890000,2.5e+09,48,105,153
216220000,1720120000,119810000,327560000,116290000,2.5e+09,48,110,158
193820000,1496450000,148090000,193970000,72480000,2104810000,53,115,168
367770000,1644500000,189330000,206800000,91570000,2499970000,38,98,136
1396830000,761790000,65150000,231110000,45120000,2.5e+09,39,91,130
1165500000,1019750000,145480000,79050000,90220000,2.5e+09,36,102,138
1349150000,798470000,74250000,235940000,42190000,2.5e+09,48,104,152
1320380000,828760000,119490000,96300000,135070000,2.5e+09,50,116,166
1017300000,1100390000,79930000,260840000,41540000,2.5e+09,45,112,157
523830000,1312600000,120600000,162970000,38980000,2158980000,48,119,167
554770000,789550000,38520000,132970000,30410000,1546220000,58,122,180
7250000,4110000,0,2430000,380000,14170000,59,127,186
352880000,1773600000,143780000,194490000,35250000,2.5e+09,49,107,156
764110000,1484130000,59640000,162570000,29550000,2.5e+09,48,110,158
455320000,1193170000,62680000,282080000,79630000,2072880000,57,125,182
325550000,1.801e+09,95370000,260810000,17270000,2.5e+09,54,123,177
579880000,1418530000,71410000,400380000,17250000,2487450000,47,112,159
584770000,1332140000,64130000,467280000,51680000,2.5e+09,54,123,177
289950000,480990000,24790000,202740000,28050000,1026520000,48,114,162
540160000,550720000,25640000,212820000,41110000,1370450000,58,130,188
556110000,1350240000,97840000,430050000,65760000,2.5e+09,51,115,166
694730000,1365530000,38870000,378420000,22450000,2.5e+09,47,109,156
1149760000,677360000,19600000,419950000,54230000,2320900000,56,128,184
576420000,360070000,30450000,153930000,31800000,1152670000,52,124,176
863220000,1285910000,31660000,196480000,122730000,2.5e+09,49,118,167
636770000,9.84e+08,19830000,565240000,294160000,2.5e+09,54,126,180
1105530000,461150000,22980000,146180000,119110000,1854950000,54,117,171
528550000,833620000,20110000,209730000,20390000,1612400000,48,113,161
267160000,1590780000,77110000,103700000,86370000,2125120000,48,115,163
3.77e+08,1742990000,30030000,156110000,84140000,2390270000,51,114,165
823010000,1197500000,179190000,102510000,197790000,2.5e+09,48,105,153
402090000,1487300000,71530000,299510000,239570000,2.5e+09,54,121,175
658920000,1334750000,57790000,210640000,237900000,2.5e+09,48,105,153
522450000,1683660000,80940000,71690000,141260000,2.5e+09,40,93,133
560200000,1667950000,75220000,88980000,107650000,2.5e+09,38,91,129
0,5e+05,0,3850000,0,4350000,43,100,143
123790000,1063210000,87020000,293130000,57740000,1624890000,46,102,148
451600000,445180000,70410000,195560000,78690000,1241440000,44,97,141
897980000,194850000,9830000,165400000,30300000,1298360000,45,111,156
670040000,45610000,5490000,94180000,19690000,835010000,38,91,129
354330000,186320000,63040000,147730000,115550000,866970000,42,96,138
437920000,47670000,92570000,1270000,1920570000,2.5e+09,42,106,148
926780000,224530000,27080000,11790000,1309820000,2.5e+09,44,113,157
1311300000,452610000,48100000,23010000,664980000,2.5e+09,45,115,160
1739890000,26770000,2480000,970000,729890000,2.5e+09,34,97,131
1825860000,163810000,14710000,1390000,494230000,2.5e+09,38,119,157
568640000,37780000,9e+06,660000,1669240000,2285320000,38,111,149
1080220000,109480000,58400000,9420000,1242480000,2.5e+09,41,122,163
915250000,864830000,41990000,330060000,347870000,2.5e+09,48,113,161
773870000,1170880000,56180000,188210000,310860000,2.5e+09,51,125,176
1018930000,941400000,26190000,207320000,306160000,2.5e+09,45,108,153
698640000,1452900000,81290000,150620000,116550000,2.5e+09,47,118,165
712720000,276250000,6520000,232010000,1272500000,2.5e+09,44,101,145
1210520000,570140000,23280000,291550000,404510000,2.5e+09,46,103,149
151450000,44100000,2370000,19410000,2282670000,2.5e+09,38,91,129
861590000,399700000,87270000,0,1151440000,2.5e+09,47,127,174
932950000,306700000,76790000,0,1183560000,2.5e+09,45,124,169
877230000,4.02e+08,29890000,0,1190880000,2.5e+09,42,126,168
1240590000,771980000,81430000,520000,405480000,2.5e+09,42,119,161
1201990000,929880000,169900000,450000,197780000,2.5e+09,43,120,163
1156850000,150090000,17740000,0,1175320000,2.5e+09,50,135,185
662130000,209640000,93100000,360000,1534770000,2.5e+09,49,136,185
1618670000,419010000,20670000,0,441650000,2.5e+09,38,106,144
1793820000,394780000,29720000,0,281680000,2.5e+09,43,117,160
1055200000,389270000,73120000,290000,982120000,2.5e+09,47,133,180
1.303e+09,430390000,45320000,0,721290000,2.5e+09,47,129,176
1098850000,921600000,87180000,0,392370000,2.5e+09,40,107,147
1378610000,628570000,37390000,0,455430000,2.5e+09,37,105,142
482740000,70110000,31790000,0,1915360000,2.5e+09,44,118,162
337280000,127190000,44590000,0,1858540000,2367600000,43,121,164
1109290000,524120000,34200000,0,832390000,2.5e+09,42,115,157
798020000,1180520000,20280000,263750000,237430000,2.5e+09,43,96,139
710690000,1350150000,88270000,160110000,190780000,2.5e+09,44,104,148
685300000,1.468e+09,35400000,120570000,190730000,2.5e+09,43,107,150
815680000,702340000,23440000,292120000,666420000,2.5e+09,49,121,170
394090000,141770000,149280000,129820000,1647350000,2462310000,48,121,169
401230000,245840000,7410000,118770000,1667080000,2440330000,42,123,165
645290000,311460000,7e+06,79320000,1456930000,2.5e+09,50,131,181
31250000,44950000,6150000,10790000,2133380000,2226520000,41,104,145
62400000,10730000,350000,7270000,2070850000,2151600000,37,99,136
346870000,214930000,13740000,60710000,1863750000,2.5e+09,44,132,176
770270000,320260000,46170000,70820000,1292480000,2.5e+09,44,119,163
1066260000,700450000,16610000,159740000,556940000,2.5e+09,47,129,176
1455440000,590310000,79190000,0,375060000,2.5e+09,45,128,173
281930000,21660000,11910000,0,1916920000,2232420000,48,120,168
1347750000,892990000,39440000,0,219820000,2.5e+09,41,118,159
1149560000,1.107e+09,55410000,670000,187360000,2.5e+09,39,115,154
1777700000,190710000,15660000,0,515930000,2.5e+09,40,108,148
1219970000,502050000,184340000,0,593640000,2.5e+09,42,116,158
1482580000,500900000,38310000,0,478210000,2.5e+09,38,115,153
1550290000,387440000,21560000,0,540710000,2.5e+09,38,109,147
1176720000,396110000,63010000,0,864160000,2.5e+09,43,122,165
1445240000,426180000,28130000,0,600450000,2.5e+09,37,117,154
1445040000,18280000,11480000,2140000,1023060000,2.5e+09,33,98,131
1572100000,18570000,1290000,840000,907200000,2.5e+09,34,95,129
1071120000,7470000,1090000,730000,1419590000,2.5e+09,32,92,124
794880000,0,0,2110000,1703010000,2.5e+09,26,92,118
1210260000,148130000,8670000,0,1132940000,2.5e+09,34,87,121
404730000,14670000,720000,6050000,2073830000,2.5e+09,26,71,97
352140000,21930000,1240000,19330000,2105360000,2.5e+09,25,83,108
148620000,0,0,33960000,2317420000,2.5e+09,20,65,85
480260000,63220000,22590000,250000,1933680000,2.5e+09,29,80,109
127350000,13430000,810000,0,2358410000,2.5e+09,21,54,75
387090000,65370000,5540000,0,2.042e+09,2.5e+09,26,65,91
1688360000,10750000,3260000,1060000,796570000,2.5e+09,34,100,134
1842980000,49960000,5e+06,320000,601740000,2.5e+09,34,96,130
1861100000,195150000,30650000,3170000,409930000,2.5e+09,36,103,139
1905540000,155550000,5380000,1060000,432470000,2.5e+09,35,111,146
1415610000,6080000,8510000,6810000,1062990000,2.5e+09,32,94,126
1587840000,19350000,4450000,12450000,875910000,2.5e+09,32,99,131
1802860000,30120000,5950000,3110000,657960000,2.5e+09,33,98,131
1477590000,470000,1310000,1370000,1019260000,2.5e+09,31,90,121
1614960000,5420000,4670000,2850000,872100000,2.5e+09,31,93,124
1708680000,0,780000,2030000,788510000,2.5e+09,28,91,119
1675810000,1720000,11320000,260000,810890000,2.5e+09,31,93,124
743770000,0,2800000,5330000,1748100000,2.5e+09,28,93,121
1273920000,490000,3060000,5610000,1216920000,2.5e+09,27,84,111
1298070000,820000,1670000,2640000,1196800000,2.5e+09,27,87,114
229370000,0,0,8550000,2262080000,2.5e+09,24,84,108
836070000,7250000,1830000,0,1654850000,2.5e+09,20,70,90
881040000,1990000,530000,0,1616440000,2.5e+09,20,76,96
459920000,1930000,0,0,2038150000,2.5e+09,11,54,65
504560000,53940000,21940000,4e+05,1690670000,2271510000,32,107,139
469480000,56170000,2030000,320000,1566900000,2094900000,35,107,142
472770000,22720000,37930000,4720000,1961860000,2.5e+09,37,110,147
1521060000,59400000,11870000,18190000,889480000,2.5e+09,35,109,144
1389370000,2600000,3100000,6640000,1098290000,2.5e+09,28,86,114
1205530000,7930000,5580000,4500000,1276460000,2.5e+09,29,87,116
1292880000,3840000,4020000,0,1199260000,2.5e+09,32,94,126
1560310000,1650000,7880000,2960000,927200000,2.5e+09,33,90,123
451070000,0,0,0,2048930000,2.5e+09,22,74,96
428230000,137730000,25120000,450000,1711550000,2303080000,42,121,163
1486880000,60800000,16250000,19720000,916350000,2.5e+09,33,108,141
1704540000,17770000,7720000,770000,769200000,2.5e+09,33,98,131
1620160000,16400000,7570000,12550000,843320000,2.5e+09,33,105,138
1302620000,369700000,27710000,250550000,549420000,2.5e+09,35,113,148
173300000,586690000,40290000,74650000,1625070000,2.5e+09,44,126,170
1838600000,279560000,22480000,134160000,225200000,2.5e+09,36,94,130
816020000,1147490000,85980000,231840000,218670000,2.5e+09,30,82,112
1398640000,534560000,53270000,259550000,253980000,2.5e+09,38,101,139
904750000,753770000,103800000,578500000,159180000,2.5e+09,32,87,119
1294550000,432290000,33740000,109680000,629740000,2.5e+09,37,111,148
92390000,680760000,23850000,31410000,1570570000,2398980000,54,135,189
901460000,794650000,37080000,111380000,655430000,2.5e+09,38,105,143
179210000,691900000,26080000,49030000,1532330000,2478550000,45,111,156
1627990000,385290000,41840000,130420000,314460000,2.5e+09,41,114,155
688090000,1071880000,81700000,334990000,323340000,2.5e+09,45,112,157
1146430000,726910000,87480000,262160000,277020000,2.5e+09,44,126,170
1424630000,637570000,121240000,136710000,179850000,2.5e+09,41,114,155
1486310000,391980000,102490000,377750000,141470000,2.5e+09,26,84,110
625370000,1203680000,183630000,380970000,106350000,2.5e+09,44,106,150
1318660000,389220000,81970000,478110000,232040000,2.5e+09,38,103,141
848700000,659260000,87100000,652550000,252390000,2.5e+09,39,103,142
1452630000,248700000,52580000,487290000,198160000,2439360000,25,75,100
1551030000,360400000,75240000,273510000,145620000,2405800000,21,61,82
1547850000,176790000,43880000,434800000,296680000,2.5e+09,25,74,99
992550000,865870000,22070000,112610000,506900000,2.5e+09,37,104,141
452590000,1034510000,40210000,128260000,844430000,2.5e+09,57,137,194
109370000,1983990000,68130000,158290000,180220000,2.5e+09,23,64,87
549160000,1283590000,62560000,253620000,351070000,2.5e+09,43,110,153
357650000,1614160000,92220000,277500000,158470000,2.5e+09,35,94,129
136380000,1770960000,69470000,2.67e+08,256190000,2.5e+09,30,81,111
941140000,1086940000,128510000,148240000,195170000,2.5e+09,29,87,116
1109650000,867060000,101770000,181250000,240270000,2.5e+09,40,119,159
861150000,1239830000,149210000,109350000,140460000,2.5e+09,42,106,148
662030000,1410800000,103990000,233240000,89940000,2.5e+09,41,108,149
252310000,1857400000,178730000,93100000,118460000,2.5e+09,36,103,139
442020000,1610620000,136220000,162610000,148530000,2.5e+09,52,129,181
326310000,1800820000,138770000,102100000,1.32e+08,2.5e+09,42,107,149
495840000,1683850000,165450000,78630000,76230000,2.5e+09,35,92,127
257760000,1714880000,398670000,44660000,84030000,2.5e+09,29,80,109
1029210000,811120000,140570000,361540000,157560000,2.5e+09,33,93,126
1495470000,378030000,143610000,315770000,167120000,2.5e+09,22,65,87
1824340000,193370000,79770000,306670000,95850000,2.5e+09,37,91,128
1501700000,106340000,1.05e+08,475650000,311310000,2.5e+09,25,70,95
1648410000,144360000,139160000,352180000,215890000,2.5e+09,31,83,114
499260000,1337270000,306650000,297220000,59600000,2.5e+09,30,72,102
1244010000,885690000,51230000,126310000,192760000,2.5e+09,51,130,181
652560000,133510000,18730000,22720000,1454880000,2282400000,47,115,162
745220000,1329390000,139230000,169910000,116250000,2.5e+09,46,111,157
460940000,1427260000,123020000,225130000,263650000,2.5e+09,59,141,200
459580000,658700000,119360000,43400000,1218960000,2.5e+09,56,128,184
296340000,221410000,29840000,33210000,1669820000,2250620000,46,110,156
425240000,1674620000,153810000,62430000,183900000,2.5e+09,45,119,164
400140000,1825160000,148050000,82820000,43830000,2.5e+09,36,94,130
195180000,1970670000,166060000,55740000,112350000,2.5e+09,35,90,125
39400000,2220120000,109510000,54300000,76670000,2.5e+09,22,75,97
158840000,1516760000,102670000,106860000,52720000,1937850000,46,115,161
581050000,1354180000,247970000,263520000,53280000,2.5e+09,25,67,92
356240000,1277510000,179490000,236680000,55140000,2105060000,29,80,109
121290000,939920000,101300000,275640000,78880000,1517030000,47,106,153
438050000,1212180000,246390000,437710000,128080000,2462410000,35,90,125
174900000,312850000,80010000,91780000,37780000,697320000,44,102,146
16180000,1028410000,65530000,85190000,1293560000,2488870000,44,108,152
557580000,1380180000,104310000,214750000,243180000,2.5e+09,48,109,157
58340000,256920000,26560000,63970000,2094210000,2.5e+09,44,102,146
213990000,443770000,60010000,32150000,179240000,929160000,38,110,148
123200000,358420000,22840000,69940000,997790000,1572190000,40,105,145
673530000,1314770000,125920000,115380000,270400000,2.5e+09,50,119,169
1087940000,1054540000,59840000,120170000,177510000,2.5e+09,48,108,156
758540000,1246680000,186560000,136490000,171730000,2.5e+09,47,104,151
1.055e+09,789250000,33880000,244990000,162330000,2285450000,49,112,161
717220000,1501540000,80500000,114210000,86530000,2.5e+09,40,96,136
725520000,1416470000,76780000,130720000,150510000,2.5e+09,45,102,147
712850000,1379040000,60610000,189510000,157990000,2.5e+09,48,108,156
535150000,1619680000,59900000,168430000,116840000,2.5e+09,48,106,154
333650000,1730000,580000,87800000,25580000,449340000,34,82,116
241540000,51400000,19140000,11640000,23880000,347600000,36,85,121
15380000,56840000,2310000,7730000,10090000,92350000,49,111,160
856320000,142160000,7190000,86170000,167890000,1259730000,47,108,155
757790000,383810000,32760000,93180000,121500000,1389040000,47,107,154
764330000,1324650000,4e+07,178110000,192910000,2.5e+09,49,105,154
1103070000,898010000,56620000,156040000,286260000,2.5e+09,47,115,162
712690000,629960000,60330000,256730000,281550000,1941260000,50,113,163
298810000,750940000,23200000,140860000,130210000,1344020000,46,113,159
129310000,1410370000,240050000,283770000,59950000,2123450000,44,99,143
237850000,252880000,8110000,118970000,47840000,665650000,45,119,164
8240000,234820000,26920000,46190000,50390000,366560000,43,98,141
1027660000,1044470000,23290000,232200000,172380000,2.5e+09,38,95,133
347090000,1985300000,74750000,44600000,48260000,2.5e+09,37,90,127
1281240000,562180000,24560000,316420000,315600000,2.5e+09,41,105,146
783190000,1351240000,39500000,211300000,114770000,2.5e+09,42,102,144
856970000,378610000,231610000,105050000,927760000,2.5e+09,46,115,161
1148750000,910700000,9840000,81650000,349060000,2.5e+09,39,109,148
1276280000,752890000,19720000,162430000,288680000,2.5e+09,43,108,151
1148940000,488510000,34900000,76510000,751140000,2.5e+09,46,131,177
1285070000,683820000,12430000,94960000,423720000,2.5e+09,47,127,174
881010000,772600000,175450000,177610000,493330000,2.5e+09,49,129,178
1284470000,737040000,28280000,88060000,362150000,2.5e+09,42,103,145
862330000,380120000,447060000,720000,809770000,2.5e+09,49,130,179
1442140000,518640000,73800000,380000,465040000,2.5e+09,44,123,167
1392240000,734210000,113790000,0,259760000,2.5e+09,42,119,161
1696610000,184080000,28850000,0,590460000,2.5e+09,38,109,147
1510720000,354850000,31030000,0,603400000,2.5e+09,40,116,156
1738620000,185200000,10160000,0,566020000,2.5e+09,38,111,149
1887840000,75710000,13860000,0,522590000,2.5e+09,38,101,139
1220560000,391930000,24060000,0,863450000,2.5e+09,37,104,141
1307470000,160250000,8330000,0,1023950000,2.5e+09,41,112,153
1101970000,551820000,27710000,491820000,326680000,2.5e+09,44,109,153
743930000,694280000,9110000,524980000,527700000,2.5e+09,48,130,178
1301540000,732100000,20830000,211730000,233800000,2.5e+09,39,109,148
1224370000,471020000,5840000,492530000,306240000,2.5e+09,39,98,137
1.338e+09,585670000,6900000,316720000,252710000,2.5e+09,42,111,153
1262780000,677800000,13510000,335700000,210210000,2.5e+09,41,111,152
1045510000,780710000,32010000,169460000,472310000,2.5e+09,41,119,160
1234080000,801680000,29240000,169040000,265960000,2.5e+09,41,110,151
923520000,923330000,57790000,243350000,352010000,2.5e+09,46,128,174
1081290000,988200000,30830000,273300000,126380000,2.5e+09,39,109,148
1228460000,617130000,27950000,145210000,481250000,2.5e+09,45,128,173
1136080000,840820000,43640000,198410000,281050000,2.5e+09,38,109,147
1075970000,732780000,43900000,238620000,408730000,2.5e+09,42,118,160
1327570000,734910000,35700000,146920000,254900000,2.5e+09,43,116,159
539490000,206220000,66590000,370000,1651120000,2463790000,46,121,167
197560000,33470000,5390000,13500000,1889350000,2139270000,38,117,155
142360000,11770000,10120000,0,2004790000,2169040000,38,103,141
1297090000,468500000,130740000,0,603670000,2.5e+09,49,125,174
1191370000,936650000,63510000,350000,308120000,2.5e+09,39,116,155
1590870000,267620000,55350000,0,586160000,2.5e+09,40,118,158
1322520000,754690000,101180000,0,321610000,2.5e+09,45,126,171
1576860000,201930000,50180000,0,671030000,2.5e+09,40,115,155
1371420000,212050000,14600000,350000,901580000,2.5e+09,38,107,145
1740410000,108970000,10840000,0,639780000,2.5e+09,36,111,147
1733680000,113320000,12730000,0,640270000,2.5e+09,38,103,141
1619700000,130280000,14150000,0,735870000,2.5e+09,44,107,151
1658220000,246080000,107690000,0,488010000,2.5e+09,40,114,154
1431050000,175460000,4690000,0,888800000,2.5e+09,41,114,155
1607960000,177360000,12250000,0,702430000,2.5e+09,44,113,157
1711090000,388920000,15190000,0,384800000,2.5e+09,36,106,142
1657020000,151880000,7360000,0,683740000,2.5e+09,39,107,146
1660200000,308140000,12560000,290000,518810000,2.5e+09,36,103,139
1716990000,192850000,5590000,0,584570000,2.5e+09,36,106,142
587730000,923280000,24320000,735380000,229290000,2.5e+09,35,101,136
777370000,858180000,12770000,457840000,389450000,2495610000,37,92,129
309090000,231600000,3300000,246390000,99680000,890060000,46,116,162
884480000,473540000,11370000,126600000,172360000,1668350000,43,105,148
921130000,749460000,10800000,352540000,293450000,2327380000,39,96,135
391580000,235150000,7120000,48850000,829540000,1512240000,39,111,150
842610000,648590000,33710000,159880000,278920000,1963710000,39,121,160
996940000,325600000,54430000,60870000,1062160000,2.5e+09,41,116,157
329720000,88440000,7370000,1.7e+07,1163380000,1605910000,37,112,149
1776350000,242370000,13230000,0,468050000,2.5e+09,38,110,148
1545230000,343950000,58650000,0,541800000,2489630000,48,130,178
998370000,313750000,103790000,0,821770000,2237680000,39,128,167
1709700000,189550000,12610000,0,588140000,2.5e+09,39,108,147
1740790000,128680000,36340000,0,594190000,2.5e+09,37,104,141
1430800000,153280000,12950000,0,902970000,2.5e+09,41,108,149
1655820000,60730000,3960000,0,779490000,2.5e+09,36,108,144
1362480000,227770000,64720000,0,845030000,2.5e+09,41,102,143
1734550000,141320000,44860000,0,579270000,2.5e+09,40,107,147
1566770000,201400000,11600000,0,720230000,2.5e+09,36,103,139
1668410000,62180000,13500000,0,755910000,2.5e+09,39,107,146
1505070000,208780000,5950000,0,780200000,2.5e+09,35,103,138
1483760000,423910000,26870000,0,565460000,2.5e+09,41,120,161
1713150000,91820000,2250000,0,692780000,2.5e+09,35,96,131
1692440000,130040000,8700000,0,668820000,2.5e+09,38,102,140
1383760000,134870000,22180000,0,959190000,2.5e+09,40,109,149
1098490000,190390000,14950000,0,446860000,1750690000,45,118,163
1541840000,210400000,39600000,5e+05,707660000,2.5e+09,40,112,152
1189920000,280870000,46700000,0,982510000,2.5e+09,41,119,160
1693160000,47980000,0,0,757790000,2498930000,37,98,135
1195550000,130370000,13320000,0,1160760000,2.5e+09,41,104,145
775500000,128310000,36080000,2860000,1547730000,2490480000,48,137,185
1473230000,434850000,45330000,0,546590000,2.5e+09,37,109,146
183140000,16460000,42200000,2050000,2237770000,2481620000,41,115,156
1436320000,33410000,2430000,70000,1027770000,2.5e+09,31,104,135
1376110000,220690000,56470000,12470000,834260000,2.5e+09,37,111,148
1126990000,582530000,36880000,16880000,736720000,2.5e+09,45,132,177
1638420000,296290000,12810000,0,552480000,2.5e+09,37,113,150
1274320000,138170000,10010000,0,1077500000,2.5e+09,38,111,149
1489340000,144800000,5360000,0,860500000,2.5e+09,38,112,150
1009210000,67430000,8270000,0,1415090000,2.5e+09,38,120,158
850680000,131650000,148250000,3390000,1366030000,2.5e+09,46,128,174
1084960000,40710000,360000,0,1373970000,2.5e+09,35,106,141
1260970000,51560000,2640000,330000,1184500000,2.5e+09,37,104,141
1435510000,22500000,45810000,0,996180000,2.5e+09,35,105,140
1159940000,68740000,3250000,0,1268070000,2.5e+09,30,102,132
1593830000,20790000,2450000,0,882930000,2.5e+09,32,99,131
1174910000,32720000,3600000,0,1288770000,2.5e+09,33,102,135
1640050000,9450000,3240000,410000,846850000,2.5e+09,29,83,112
1704580000,15280000,790000,0,779350000,2.5e+09,31,92,123
1428450000,26820000,9690000,0,1035040000,2.5e+09,33,93,126
1382660000,6310000,0,0,1111030000,2.5e+09,31,90,121
1495670000,620000,4e+05,0,1003310000,2.5e+09,27,76,103
1498570000,12200000,9990000,0,979240000,2.5e+09,32,89,121
1616300000,0,0,0,883700000,2.5e+09,30,85,115
1297770000,1630000,0,0,1200600000,2.5e+09,32,93,125
1677400000,620000,0,0,821980000,2.5e+09,15,56,71
1355580000,0,0,0,1144420000,2.5e+09,25,84,109
1040960000,0,0,0,1459040000,2.5e+09,28,90,118
1728410000,0,1180000,0,770410000,2.5e+09,34,94,128
418550000,13010000,4280000,0,2064160000,2.5e+09,29,90,119
1123080000,2340000,0,0,1374580000,2.5e+09,22,73,95
202080000,0,0,0,2297920000,2.5e+09,21,63,84
587200000,4880000,0,560000,1907360000,2.5e+09,29,93,122
1170000,0,6e+05,0,2498230000,2.5e+09,21,69,90
181240000,8300000,1120000,0,2309340000,2.5e+09,22,68,90
1457070000,30660000,3860000,0,1008410000,2.5e+09,34,98,132
1539020000,30700000,8670000,0,921610000,2.5e+09,32,98,130
1536780000,89970000,11900000,0,861350000,2.5e+09,35,103,138
1501250000,31940000,350000,0,966460000,2.5e+09,34,104,138
1159560000,21050000,0,0,1319390000,2.5e+09,35,111,146
1255110000,24910000,5420000,0,1214560000,2.5e+09,30,96,126
1547830000,21600000,13840000,0,916730000,2.5e+09,32,95,127
1323090000,18790000,2050000,0,1156070000,2.5e+09,32,102,134
1371980000,27100000,390000,970000,1099470000,2499910000,29,90,119
1523230000,7620000,440000,350000,968360000,2.5e+09,31,91,122
1656440000,20660000,8480000,670000,813750000,2.5e+09,33,94,127
1689360000,5310000,1980000,0,803350000,2.5e+09,31,88,119
1737250000,0,2430000,0,760320000,2.5e+09,32,93,125
1118800000,650000,0,0,1380550000,2.5e+09,31,94,125
1619580000,0,0,0,875170000,2494750000,27,82,109
1114860000,0,0,0,1385140000,2.5e+09,30,94,124
1578720000,4920000,10610000,0,905750000,2.5e+09,35,106,141
802650000,33190000,2360000,0,1661800000,2.5e+09,26,80,106
332060000,0,0,0,2167940000,2.5e+09,26,86,112
410600000,22560000,5050000,0,2061790000,2.5e+09,22,76,98
991020000,3080000,1160000,0,1504740000,2.5e+09,28,88,116
304480000,18440000,0,0,2177080000,2.5e+09,20,61,81
86550000,7430000,2100000,0,2403920000,2.5e+09,21,64,85
1205580000,2.2e+07,0,0,1081960000,2309540000,31,96,127
1455100000,34380000,6960000,0,997770000,2494210000,35,97,132
1224550000,11730000,280000,0,680500000,1917060000,33,106,139
9.72e+08,8860000,370000,0,681020000,1662250000,31,89,120
1344420000,57820000,15380000,0,753710000,2171330000,44,112,156
602290000,1632990000,170660000,79060000,1.5e+07,2.5e+09,44,104,148
1672600000,44160000,9410000,0,773830000,2.5e+09,40,110,150
1772720000,99950000,9130000,0,523570000,2405370000,41,109,150
1363470000,29410000,11240000,0,649150000,2053270000,40,106,146
6740000,685940000,76440000,77960000,1497460000,2344540000,40,105,145
748810000,487220000,36420000,347590000,879960000,2.5e+09,39,112,151
0,6450000,280000,0,2238680000,2245410000,13,59,72
6517560000,994180000,366890000,860000,2206990000,10086480000,49,125,174
4354510000,3740800000,450890000,2526420000,258370000,11330990000,52,115,167
6261170000,221550000,36390000,1190000,6968870000,13489170000,40,118,158
3050180000,5486170000,318520000,694580000,1178750000,10728200000,55,133,188
328860000,3068040000,1513910000,2124400000,3106770000,10141980000,48,125,173
797690000,443810000,365320000,8765500000,7868270000,18240590000,49,113,162
3472830000,4997220000,170060000,1400600000,411890000,10452600000,41,109,150
1.952e+09,5457230000,410130000,2.554e+09,89270000,10462630000,44,105,149
4280790000,6413800000,96650000,1404380000,3966200000,16161820000,41,128,169
6778920000,1214830000,237260000,350000,2857500000,11088860000,49,130,179
459370000,3773140000,212280000,89870000,3542790000,8077450000,46,114,160
4518040000,7352270000,437830000,1098420000,516050000,13922610000,35,93,128
995880000,683060000,39040000,486980000,3065520000,5270480000,30,107,137
430570000,451670000,227190000,4890890000,6844990000,12845310000,41,100,141
3488590000,4346670000,22190000,461360000,2444440000,10763250000,37,107,144
634780000,448820000,80410000,289910000,1046080000,2.5e+09,29,89,118
3211560000,5830630000,438860000,871060000,361210000,10713320000,54,124,178
3255150000,2507200000,311090000,4025330000,353980000,10452750000,44,113,157
4152010000,176010000,66760000,0,2956150000,7350930000,47,112,159
4700910000,9581170000,80220000,1652790000,4707780000,20722870000,42,127,169
1484590000,9090070000,749260000,2375560000,719780000,14419260000,58,130,188
2902670000,7936540000,1451440000,1218240000,1.006e+09,14514890000,55,125,180
3203480000,2327800000,134520000,542510000,4748780000,10957090000,60,159,219
178680000,695290000,45660000,1348850000,6914980000,9183460000,34,79,113
1336590000,8484370000,111450000,201110000,643460000,10776980000,40,111,151
3300820000,3771620000,104090000,1185390000,576150000,8938070000,59,134,193
4657460000,6007120000,317900000,380780000,2131570000,13494830000,42,108,150
146470000,315400000,29680000,993030000,6029010000,7513590000,34,84,118
790280000,2982410000,598910000,6825690000,7098540000,18295830000,42,108,150
3453790000,3344560000,181180000,762740000,934040000,8676310000,55,136,191
1377750000,5926400000,935660000,474690000,81300000,8795800000,46,104,150
8288660000,739260000,82460000,13550000,2125510000,11249440000,42,102,144
1563220000,3737810000,221330000,494170000,3079980000,9096510000,33,103,136
332750000,1870460000,478080000,3100140000,2807120000,8588550000,35,90,125
3124450000,7337910000,69410000,70920000,440710000,11043400000,38,107,145
3516320000,4966210000,276490000,516730000,765680000,10041430000,40,111,151
6137880000,569620000,75850000,0,2423490000,9206840000,45,121,166
2760090000,73240000,15660000,0,1579260000,4428250000,44,116,160
3319070000,3679350000,693860000,1803100000,584910000,10080290000,52,126,178
7219370000,414060000,59990000,7030000,2661950000,10362400000,41,114,155
7314810000,4166150000,661120000,1603590000,342860000,14088530000,51,127,178
5017800000,6994010000,944240000,3762240000,819550000,17537840000,48,124,172
1960460000,4528120000,235800000,664390000,3674580000,11063350000,37,109,146
3388660000,4.834e+09,882020000,1143990000,719810000,10968480000,50,114,164
14499510000,5143010000,1345470000,4669600000,1990520000,27648110000,47,126,173
4039490000,3727700000,544250000,1618180000,516810000,10446430000,48,128,176
5051210000,7423480000,281210000,530020000,7702080000,2.0988e+10,45,112,157
3951070000,5833580000,685430000,854130000,2847350000,14171560000,56,148,204
5254480000,810290000,36220000,0,3110760000,9211750000,41,123,164
1461700000,449660000,11660000,0,9856530000,11779550000,41,111,152
866490000,1435150000,309020000,73660000,2122530000,4806850000,28,84,112
2976510000,173520000,22660000,0,1996780000,5169470000,43,110,153
2277600000,6591580000,247520000,4837320000,243470000,14197490000,51,118,169
3119680000,3126950000,448820000,1001470000,2745590000,10442510000,54,149,203
3623480000,8918080000,140560000,936560000,6812120000,20430800000,43,124,167
1227920000,5306830000,502890000,85810000,6113440000,13236890000,46,123,169
1365260000,5385950000,413860000,1315600000,5081680000,13562350000,53,127,180
5769370000,7172480000,1159840000,1267810000,666020000,16035520000,53,132,185
4782830000,2089750000,125490000,1853500000,3717690000,12569260000,49,135,184
12461970000,2145540000,347710000,431480000,10393680000,25780380000,49,134,183
1909790000,2712890000,188370000,396330000,103180000,5310560000,50,112,162
525920000,4497540000,482880000,439810000,7619690000,13565840000,46,109,155
2036210000,247980000,14470000,96930000,6449620000,8845210000,38,110,148
3009970000,5235010000,851820000,833650000,411900000,10342350000,50,118,168
1141340000,5165710000,1056790000,6295570000,875140000,14534550000,40,96,136
6497830000,31460000,5710000,560000,10905580000,17441140000,33,99,132
794130000,2.16e+08,33710000,1768120000,15131050000,17943010000,43,105,148
671890000,5077900000,310220000,51460000,3003940000,9115410000,43,121,164
469370000,3315650000,17440000,208730000,1399610000,5410800000,34,90,124
552070000,2773800000,479710000,3728500000,2547570000,10081650000,51,128,179
280060000,708300000,41400000,284940000,1668550000,2983250000,57,138,195
1767440000,7658310000,37390000,362300000,961600000,10787040000,41,127,168
4995850000,6040340000,284820000,2443410000,14607340000,28371760000,56,148,204
2522950000,6981450000,469210000,1447890000,1009910000,12431410000,53,130,183
4343910000,234800000,319080000,2710030000,2615230000,10223050000,46,117,163
1323300000,8388790000,657060000,412760000,2069530000,12851440000,57,139,196
6696380000,3553270000,216620000,862600000,4196260000,15525130000,50,141,191
1.281e+09,3354690000,88600000,278610000,3472320000,8475220000,35,96,131
3764190000,852040000,34840000,44560000,8822390000,13518020000,43,122,165
5571280000,2438520000,772320000,1130000,5461190000,14244440000,54,141,195
2041340000,7173460000,498200000,978930000,178810000,10870740000,45,109,154
2534620000,4046410000,80780000,731090000,3659680000,11052580000,37,119,156
520390000,8320090000,510750000,984300000,347530000,10683060000,49,110,159
2854820000,6242820000,668650000,438810000,132360000,10337460000,53,120,173
847870000,10739800000,269710000,346930000,2218740000,14423050000,42,119,161
4111370000,2463260000,272890000,1735760000,337690000,8920970000,55,121,176
6887650000,2620750000,171530000,1138900000,2047850000,12866680000,46,138,184
6200350000,21130000,9880000,190130000,6275630000,12697120000,40,108,148
2696980000,435890000,20970000,957180000,5383520000,9494540000,42,117,159
2920520000,110550000,15310000,0,1988460000,5034840000,36,105,141
2127300000,1477950000,106650000,813640000,4156290000,8681830000,34,119,153
2503250000,85690000,1.3e+07,590000,6197970000,8800500000,39,104,143
2829290000,19750000,3520000,121730000,11560550000,14534840000,35,102,137
4125600000,2271290000,1662870000,1851380000,164480000,10075620000,41,92,133
67200000,564740000,78610000,658820000,3991950000,5361320000,44,110,154
4203670000,1163670000,775810000,1381650000,2557010000,10081810000,42,125,167
372970000,5666350000,313100000,322880000,2183050000,8858350000,46,114,160
3474210000,4814340000,365270000,1217480000,480740000,10352040000,51,119,170
1104630000,9014830000,665230000,3543950000,194260000,14522900000,45,112,157
3695900000,5299260000,654650000,1538920000,2643230000,13831960000,48,136,184
2563240000,231170000,256140000,3005210000,2740140000,8795900000,39,105,144
2573920000,3155850000,311830000,464630000,3240630000,9746860000,53,129,182
4.449e+09,3819780000,652820000,190750000,3106740000,12219090000,43,115,158
2107490000,2759480000,92410000,574650000,1790590000,7324620000,28,74,102
3492510000,4588560000,141560000,2183210000,312310000,10718150000,57,130,187
3330350000,6454480000,137300000,144540000,4592660000,14659330000,37,110,147
4256350000,5494680000,352800000,328070000,2287490000,12719390000,36,106,142
3372490000,245070000,91440000,0,3435780000,7144780000,46,115,161
297580000,998650000,127850000,6145780000,1677090000,9246950000,28,79,107
2957600000,568760000,390730000,2348430000,3814680000,10080200000,48,135,183
8547480000,95050000,31330000,19710000,6073660000,14767230000,36,105,141
4284630000,800950000,208660000,20500000,11642450000,16957190000,45,116,161
3362480000,2325580000,933730000,338180000,6335680000,13295650000,52,132,184
652990000,2057270000,247150000,8347660000,4077490000,15382560000,32,76,108
4620410000,2825450000,275630000,600230000,6994480000,15316200000,55,148,203
374880000,10709610000,1673970000,1730420000,197240000,14686120000,36,95,131
3886730000,115150000,18820000,0,18992130000,23012830000,37,105,142
3182650000,402160000,14910000,2900000,9253820000,12856440000,40,117,157
1997550000,5857160000,175180000,28010000,6006390000,14064290000,53,140,193
1253640000,72120000,17900000,3e+05,7451450000,8795410000,37,110,147
6523030000,417460000,88810000,13080000,5469520000,12511900000,45,130,175
821610000,5981520000,587730000,1141830000,263150000,8795840000,46,108,154
2846980000,2442510000,132120000,399250000,2898410000,8719270000,30,94,124
2795130000,7190840000,361440000,586040000,608090000,11541540000,49,113,162
537400000,6853730000,111530000,18740000,1574020000,9095420000,40,115,155
994640000,5904390000,574700000,606570000,621940000,8702240000,41,102,143
678770000,4334840000,2611980000,6273940000,655580000,14555110000,41,99,140
1438100000,6497600000,269600000,637950000,237830000,9081080000,50,124,174
3941560000,4285860000,817400000,878240000,158270000,10081330000,43,106,149
6953790000,294750000,29230000,0,3650880000,10928650000,41,108,149
4041020000,5249800000,158040000,560600000,330110000,10339570000,51,126,177
8108510000,1982680000,246400000,22420000,3069750000,13429760000,50,126,176
4726530000,1720000,19380000,2570000,2664600000,7414800000,31,95,126
1253250000,1349310000,58590000,243780000,1958760000,4863690000,32,100,132
6876060000,192240000,25640000,7960000,3265550000,10367450000,37,104,141
1731940000,7710140000,650970000,262940000,106170000,10462160000,43,101,144
6323950000,9522330000,1125240000,2945900000,733690000,20651110000,53,136,189
900160000,5775550000,529460000,88150000,2788140000,10081460000,45,105,150
2772930000,339530000,37090000,0,1689030000,4838580000,45,120,165
3681240000,203920000,45520000,4400000,1295330000,5230410000,39,105,144
3254830000,60560000,16110000,970000,2213510000,5545980000,32,100,132
387030000,1892470000,793240000,2683060000,4830880000,10586680000,51,129,180
624170000,2941220000,1068410000,318490000,82140000,5034430000,41,92,133
1569110000,4628490000,3191480000,2153320000,3508060000,15050460000,44,111,155
5431740000,5110810000,855230000,755480000,331470000,12484730000,56,142,198
4225080000,7086050000,610500000,1104890000,1054910000,14081430000,54,115,169
2984340000,5023350000,696700000,1176370000,200610000,10081370000,49,110,159
1596990000,2839550000,162200000,138500000,372910000,5110150000,37,104,141
2618080000,614280000,144390000,705120000,948050000,5029920000,37,100,137
2039110000,6313730000,29520000,36640000,4444840000,12863840000,33,105,138
2505460000,6725780000,680370000,207150000,266510000,10385270000,57,127,184
6406140000,8470000,10020000,2650000,7997580000,14424860000,34,102,136
4185340000,9639810000,486120000,1012890000,5452080000,20776240000,57,156,213
1407120000,108940000,69080000,1.252e+09,2197520000,5034660000,34,100,134
1704700000,2511800000,314020000,5517590000,2653260000,12701370000,45,108,153
2118450000,826650000,126950000,0,5247790000,8319840000,50,131,181
1253320000,8385360000,1377170000,2886740000,2333550000,16236140000,43,107,150
711010000,11014850000,1058330000,3252010000,4499120000,20535320000,52,126,178
6944850000,1.952e+09,261630000,128060000,4860510000,14147050000,47,125,172
5521130000,1148530000,154370000,631970000,2876550000,10332550000,50,133,183
2156560000,272150000,98570000,5900000,2697240000,5230420000,47,122,169
1343400000,3950790000,21980000,1173160000,2882410000,9371740000,39,123,162
6364200000,195020000,19780000,29510000,3758930000,10367440000,37,104,141
3135130000,3e+05,620000,159290000,7380830000,10676170000,33,94,127
4672350000,2655270000,469480000,2121880000,172770000,10091750000,49,111,160
842230000,6575230000,257340000,432100000,2192810000,10299710000,33,84,117
2597280000,789520000,766010000,6434330000,7919870000,18507010000,43,107,150
6439520000,90520000,9470000,6820000,3668480000,10214810000,34,103,137
2935290000,57310000,12550000,0,2.12e+09,5125150000,33,102,135
490700000,11215320000,738090000,1449660000,521190000,14414960000,52,120,172
2454020000,7040990000,682670000,544490000,180650000,10902820000,51,124,175
5602280000,6029790000,1083230000,812120000,555550000,14082970000,59,132,191
2885240000,5918860000,365140000,913650000,264050000,10346940000,52,125,177
2330900000,5007220000,850650000,1336960000,318330000,9844060000,52,107,159
2967700000,6310840000,3.12e+08,591850000,274770000,10457160000,45,108,153
5308640000,3408830000,439360000,651290000,534380000,10342500000,52,122,174
10144990000,1756970000,268040000,35660000,3339630000,15545290000,44,118,162
526340000,3868410000,1742250000,755910000,1068020000,7960930000,48,114,162
1007390000,62800000,55300000,7670000,3703940000,4837100000,42,112,154
1261180000,5869650000,1158290000,1974710000,198730000,10462560000,48,109,157
5188040000,39610000,7830000,179420000,7267630000,12682530000,33,97,130
2274520000,6787350000,517570000,894370000,234410000,10708220000,51,124,175
1933470000,9134710000,1281060000,492370000,446180000,13287790000,51,122,173
2044790000,396510000,25500000,640000,7229030000,9696470000,40,104,144
1889740000,541290000,65540000,450000,2459600000,4956620000,44,125,169
5540960000,4133610000,207530000,3126100000,2686080000,15694280000,39,124,163
1624100000,5052250000,44900000,1392560000,3056660000,11170470000,38,126,164
3348580000,31220000,16760000,670000,2148830000,5546060000,33,99,132
5997710000,1241640000,81500000,0,2053790000,9374640000,39,122,161
1097900000,859460000,401380000,6707870000,6857170000,15923780000,42,111,153
3269250000,448860000,486820000,1192070000,4083690000,9480690000,38,128,166
1801200000,8263780000,356310000,1131370000,1310310000,12862970000,48,121,169
7331750000,5663750000,1521170000,2239800000,1058050000,17814520000,48,115,163
5673070000,1001940000,210250000,1578620000,2351890000,10815770000,39,117,156
1946230000,6025960000,129600000,1505890000,16258730000,25866410000,36,109,145
1886260000,6203470000,316010000,702740000,8989940000,18098420000,49,140,189
1268890000,3217300000,467600000,317260000,79610000,5350660000,48,119,167
1667270000,353380000,22350000,3330000,8040590000,10086920000,44,118,162
5485530000,1034350000,45330000,290000,2007430000,8572930000,39,116,155
3082470000,60970000,3080000,0,2429610000,5576130000,35,109,144
5427190000,4665310000,240140000,4749870000,607760000,15690270000,42,112,154
4685340000,3005800000,474780000,505500000,4481470000,13152890000,45,103,148
5770920000,2117320000,361460000,1533640000,914280000,10697620000,48,124,172
6556590000,51490000,22850000,410000,4502650000,11133990000,37,102,139
3756380000,205930000,30330000,6950000,1180700000,5180290000,35,105,140
3142910000,4763270000,147110000,606550000,431470000,9091310000,51,118,169
2642910000,3732970000,137190000,451160000,3977060000,10941290000,62,144,206
7499390000,94550000,11800000,66380000,6447670000,14119790000,38,113,151
1567280000,2912340000,67350000,282470000,310750000,5140190000,34,99,133
431020000,929100000,463610000,9392740000,7285870000,18502340000,36,88,124
3301820000,5224100000,1632410000,590610000,722400000,11471340000,56,130,186
9887510000,7.777e+09,936960000,2760900000,3477030000,24839400000,55,154,209
2293150000,8.095e+09,1068710000,420380000,788620000,12665860000,57,130,187
773660000,4749320000,668040000,1344560000,6462280000,13997860000,47,117,164
2105820000,3951650000,436170000,504350000,3586940000,10584930000,66,159,225
4552660000,4621630000,602990000,860520000,80340000,10718140000,46,106,152
1406570000,1317690000,444940000,1100710000,759760000,5029670000,49,121,170
566230000,1954650000,78430000,106670000,2674780000,5380760000,59,132,191
7419500000,528430000,70680000,10780000,5686860000,13716250000,41,121,162
1162630000,6996560000,1013200000,216330000,2308550000,11697270000,53,136,189
4747020000,6504020000,202250000,2282660000,4348110000,18084060000,57,151,208
2929880000,4779360000,686890000,1287530000,397860000,10081520000,49,117,166
2477920000,2089080000,80560000,337380000,190330000,5175270000,48,110,158
3162700000,3978840000,201090000,1455060000,181900000,8979590000,58,136,194
434830000,2664650000,75050000,262740000,1707880000,5145150000,41,111,152
557180000,1045090000,153110000,915790000,2504130000,5175300000,35,111,146
292530000,4367350000,74040000,540910000,576850000,5851680000,38,111,149
3713810000,3606580000,1128940000,1094430000,537820000,10081580000,53,120,173
2033500000,7355820000,339830000,625140000,425260000,10779550000,51,117,168
5148120000,2460100000,266030000,290000,2883730000,10758270000,50,142,192
2864020000,3979790000,411030000,271140000,6681240000,14207220000,58,151,209
3746420000,2147960000,347110000,17430000,7059740000,13318660000,51,143,194
114510000,1525730000,541380000,559420000,2.409e+09,5150040000,43,102,145
3155230000,297260000,51930000,67150000,16476150000,20047720000,48,123,171
7231120000,724550000,33160000,0,3115150000,11103980000,47,121,168
4294420000,1954680000,190940000,68560000,5491720000,12000320000,45,118,163
4356590000,1776190000,392250000,1734890000,696570000,8956490000,50,109,159
1797620000,3878120000,645590000,784180000,6670150000,13775660000,43,112,155
5717140000,63230000,29890000,8200000,4554020000,10372480000,37,104,141
6121470000,4180280000,281870000,1189120000,1.04e+09,12812740000,52,130,182
7669540000,124110000,26960000,32190000,4118140000,11970940000,36,112,148
5177180000,4569220000,443160000,1449920000,194610000,11834090000,51,113,164
1759810000,3301360000,281830000,4941490000,168200000,10452690000,44,115,159
406040000,6831720000,1225060000,758560000,3849780000,13071160000,45,109,154
4016070000,3976820000,520890000,1936930000,294680000,10745390000,52,122,174
4025460000,1106890000,118200000,0,8582010000,13832560000,43,123,166
3456650000,5944780000,340660000,546410000,168630000,10457130000,45,110,155
4338400000,4728150000,345260000,726550000,199140000,10337500000,57,132,189
2176240000,7182390000,493820000,404130000,211090000,10467670000,47,110,157
2124480000,11055510000,1063460000,2445810000,4072390000,20761650000,46,135,181
4257910000,3359930000,74440000,893060000,340130000,8925470000,41,95,136
2199330000,260470000,50190000,4170000,6281770000,8795930000,37,117,154
4318740000,7675890000,1037480000,652230000,158260000,13842600000,49,120,169
3542140000,1124460000,139690000,21760000,5533860000,10361910000,43,108,151
4342160000,3433950000,445490000,1773220000,86760000,10081580000,46,99,145
2171880000,7744870000,1846600000,178530000,599900000,12541780000,45,130,175
2677060000,11858400000,1230930000,2161840000,2382250000,20310480000,52,123,175
4007950000,4038410000,177510000,858990000,836950000,9919810000,57,127,184
2732870000,5770250000,773940000,567120000,502720000,10346900000,49,114,163
1703230000,466300000,34320000,15450000,5332320000,7551620000,48,129,177
3559950000,1796510000,67230000,307440000,5129530000,10860660000,53,145,198
1856430000,2059900000,125030000,1119600000,59390000,5220350000,42,91,133
3198490000,5211480000,618190000,875230000,444020000,10347410000,55,129,184
2015840000,6933240000,399200000,1149850000,209510000,10707640000,57,135,192
5546170000,13010000,15780000,23850000,5179410000,10778220000,29,92,121
2381950000,35910000,7490000,0,1957370000,4382720000,32,99,131
4436080000,2979120000,306580000,937350000,3732370000,12391500000,38,119,157
2982560000,4687250000,241930000,1254500000,552530000,9718770000,48,107,155
1862580000,5708030000,2306140000,935920000,549010000,11361680000,50,116,166
5055570000,5960880000,217440000,1490610000,1181010000,13905510000,48,126,174
5867480000,3838380000,67750000,2105510000,1647440000,13526560000,51,137,188
1305250000,4158600000,149800000,51380000,7193180000,12858210000,41,114,155
2196180000,2358570000,357990000,179200000,3401570000,8493510000,33,93,126
2014570000,7378290000,696330000,60140000,187480000,10336810000,55,128,183
1084150000,9610020000,915580000,391080000,806660000,12807490000,55,123,178
3855900000,1849130000,215220000,520000,3170830000,9091600000,48,137,185
6630120000,21120000,2420000,350000,4466910000,11120920000,33,105,138
1508340000,5929960000,142430000,394070000,257540000,8232340000,52,117,169
1801690000,5924260000,974010000,1502470000,418870000,10621300000,51,114,165
1857660000,3510700000,319030000,337520000,62180000,6087090000,50,110,160
1561160000,12132710000,832980000,874840000,4557970000,19959660000,59,146,205
6077680000,2880860000,267200000,781490000,325250000,10332480000,54,135,189
1268710000,9007090000,58630000,1814050000,3056460000,15204940000,37,110,147
2963100000,765400000,94730000,11450000,12374730000,16209410000,47,129,176
1198400000,502580000,5360000,303310000,490350000,2.5e+09,30,94,124
1226200000,5043750000,59680000,1915370000,2745840000,10990840000,39,133,172
5424200000,3.165e+09,70760000,1088850000,1324530000,11073340000,47,124,171
1896670000,11724470000,591440000,786140000,257550000,15256270000,39,103,142
3196150000,2112060000,95950000,1503880000,3474350000,10382390000,40,123,163
3065440000,4466070000,62550000,1485330000,3838250000,12917640000,33,106,139
3393650000,3720830000,240780000,1535610000,1420930000,10311800000,38,114,152
4594950000,6527540000,525430000,1032400000,1392670000,14072990000,56,122,178
1530870000,458080000,64950000,1654540000,14120130000,17828570000,43,110,153
540800000,7381880000,619160000,2811790000,7461050000,18814680000,50,129,179
2534080000,5320570000,4.36e+08,1778070000,267330000,10336050000,53,106,159
2363850000,2527120000,286490000,409940000,235470000,5822870000,57,135,192
269510000,977840000,129870000,1833230000,6086640000,9297090000,38,89,127
749090000,3094890000,646530000,90970000,3700250000,8281730000,41,101,142
3874130000,201260000,28650000,0,1492690000,5596730000,43,115,158
1747980000,4.669e+09,100540000,444100000,478740000,7440360000,55,125,180
1195860000,7551790000,423420000,797060000,3901520000,13869650000,42,98,140
4149750000,7783590000,631210000,290940000,972110000,13827600000,43,122,165
2341250000,4669720000,182460000,582500000,652280000,8428210000,48,113,161
2481900000,3216280000,507890000,1921030000,375760000,8502860000,47,106,153
2994390000,10315840000,715580000,1271740000,1248150000,16545700000,56,115,171
3557020000,20530000,15630000,5350000,1882400000,5480930000,35,103,138
6881100000,1334690000,182630000,51330000,2718550000,11168300000,45,127,172
5446320000,105130000,240030000,2370620000,2169800000,10331900000,40,102,142
7375490000,3507830000,614400000,1577580000,1013700000,1.4089e+10,49,110,159
147230000,6171650000,331690000,26930000,3547110000,10224610000,42,119,161
1025260000,8254130000,489370000,211900000,696210000,10676870000,49,110,159
168010000,2462520000,33880000,1409810000,1386680000,5460900000,39,112,151
2362450000,2673470000,7.5e+08,4418240000,248020000,10452180000,48,120,168
1843190000,1268950000,198100000,173710000,9202370000,12686320000,51,137,188
1908340000,4432170000,823020000,130400000,5223140000,12517070000,40,106,146
7036550000,22940000,16130000,13410000,5247760000,12336790000,33,99,132
2373390000,6875270000,776670000,208360000,229070000,10462760000,45,111,156
1093090000,2141400000,131980000,179170000,1624610000,5170250000,31,96,127
4788260000,4075200000,152880000,871070000,459500000,10346910000,50,123,173
3371390000,5249040000,477070000,1271970000,338260000,10707730000,52,119,171
8950470000,4149140000,348700000,223460000,1867200000,15538970000,44,122,166
9650970000,1579310000,158700000,2910000,4179420000,15571310000,44,130,174
3191450000,370160000,42210000,22910000,12008840000,15635570000,45,100,145
3684460000,3633570000,621220000,702170000,274670000,8916090000,53,126,179
9741940000,4920000,14370000,0,6952360000,16713590000,39,116,155
1947500000,2127180000,722040000,731200000,88290000,5616210000,40,87,127
1008550000,1385100000,133820000,706010000,4742700000,7976180000,55,126,181
1025200000,5577330000,753840000,2690280000,281410000,10328060000,49,116,165
4230510000,5242180000,455540000,655380000,124540000,10708150000,51,117,168
6836140000,1026130000,111080000,0,3130630000,11103980000,43,127,170
3475130000,3483930000,112370000,626320000,257520000,7955270000,46,105,151
2265310000,2578890000,50920000,1785380000,950550000,7631050000,48,134,182
1588600000,4499080000,221080000,781370000,154830000,7244960000,60,134,194
4039700000,2834150000,105580000,1114870000,2633850000,10728150000,50,132,182
3040480000,889210000,218340000,29480000,4743670000,8921180000,54,146,200
1982500000,10312770000,1124530000,560720000,675200000,14655720000,58,138,196
4055010000,3880740000,8.08e+08,1192080000,1.46e+08,10081830000,46,100,146
2138130000,2239130000,78370000,319550000,4236180000,9011360000,30,84,114
4768170000,485050000,54630000,67040000,15260760000,20635650000,38,104,142
4809720000,6560090000,1340660000,624620000,10062140000,23397230000,53,136,189
4385180000,1133410000,359560000,3167650000,4.115e+09,13160800000,46,124,170
1454010000,7564300000,611550000,93160000,347450000,10070470000,41,118,159
3151450000,4670500000,500280000,371310000,102080000,8795620000,50,112,162
1168410000,1181800000,232500000,2536670000,111060000,5230440000,43,113,156
1829790000,3271460000,157060000,1108050000,101860000,6468220000,58,132,190
3460580000,5470120000,641570000,566110000,203540000,10341920000,53,118,171
4612360000,3909730000,951550000,2047390000,785380000,12306410000,52,140,192
13500440000,1948840000,281030000,211880000,3169090000,19111280000,46,117,163
2016490000,1144720000,298290000,482580000,2687180000,6629260000,53,135,188
2202870000,2112030000,251170000,972640000,3653090000,9191800000,38,106,144
2332770000,7147590000,448320000,1036800000,246740000,11212220000,53,123,176
2124410000,1121600000,86400000,161830000,1799150000,5293390000,56,136,192
3509690000,2530610000,339610000,358610000,3225860000,9964380000,52,140,192
5114720000,105660000,52470000,0,3989550000,9262400000,39,113,152
1394770000,3690850000,193060000,443040000,364670000,6086390000,51,121,172
1481780000,4109170000,1262530000,2139830000,481320000,9474630000,46,120,166
7734390000,803970000,201270000,0,2685690000,11425320000,43,122,165
8736840000,145550000,86550000,15440000,5124410000,14108790000,35,111,146
7560140000,1223290000,134170000,6450000,6209910000,15133960000,47,133,180
516140000,4585300000,643870000,2841360000,1494580000,10081250000,49,120,169
9521330000,2911580000,411280000,380000,3067900000,15912470000,47,128,175
3190050000,4540620000,700280000,672690000,966750000,10070390000,48,131,179
7239190000,6540840000,343980000,2204650000,4362790000,20691450000,49,146,195
5542810000,1336160000,181090000,360000,3692800000,10753220000,55,145,200
2291860000,47540000,134330000,1522220000,1164290000,5160240000,38,100,138
3860430000,3222140000,560600000,1079640000,77940000,8800750000,40,87,127
2552100000,7720430000,83830000,290200000,3416120000,14062680000,50,145,195
4048390000,2925080000,735490000,921330000,165140000,8795430000,50,123,173
6874870000,5102730000,1007900000,634030000,6550440000,20169970000,50,145,195
775520000,6270210000,522390000,5307160000,2350530000,15225810000,48,114,162
84850000,1915440000,145780000,262200000,2969460000,5377730000,43,111,154
3963480000,3390730000,189850000,2783650000,129460000,10457170000,41,107,148
5665650000,631460000,97790000,510000,2997390000,9392800000,44,122,166
3038870000,2055400000,516580000,3901730000,563400000,10075980000,51,121,172
765080000,10013240000,1676710000,3461710000,4989640000,20906380000,47,125,172
1963660000,4912370000,130650000,410090000,489300000,7906070000,55,135,190
4214320000,7129020000,319420000,609100000,907670000,13179530000,55,127,182
2125800000,7017460000,218280000,1142880000,208720000,10713140000,51,121,172
51410000,1741410000,27170000,86980000,593030000,2.5e+09,31,88,119
2379540000,8033020000,338900000,933390000,14418080000,26102930000,40,127,167
2573750000,5653860000,157340000,855220000,11376390000,20616560000,41,122,163
3628490000,7923020000,974630000,1621870000,286170000,14434180000,54,123,177
3097260000,3043680000,715810000,630640000,92860000,7580250000,45,105,150
3454930000,4982460000,291790000,1126640000,496750000,10352570000,52,126,178
561470000,8886760000,1831360000,1158840000,2022420000,14460850000,47,116,163
511790000,3744460000,357770000,81600000,7013860000,11709480000,44,112,156
3716440000,5019680000,445390000,962460000,192910000,10336880000,53,122,175
3034830000,3646490000,1144300000,934280000,380200000,9140100000,51,113,164
3143480000,472650000,207800000,845580000,500810000,5170320000,38,102,140
606350000,1370790000,151380000,5024450000,10964520000,18117490000,40,91,131
4254920000,3158140000,363800000,1120000,1880870000,9658850000,49,139,188
5816800000,2623150000,253820000,3231150000,3360490000,15285410000,42,126,168
3291440000,1142310000,458630000,117390000,4511250000,9521020000,49,121,170
2150040000,6628350000,4.63e+08,3374530000,130840000,12746760000,39,99,138
289270000,1415350000,364200000,3089320000,3670970000,8829110000,45,125,170
7088660000,606450000,79150000,0,3319620000,11093880000,44,116,160
3688810000,5453370000,391740000,917050000,256690000,10707660000,56,128,184
3102420000,915460000,153170000,263530000,735730000,5170310000,41,113,154
2396610000,2766760000,168150000,117200000,3252580000,8701300000,31,95,126
3189360000,206170000,187330000,2509480000,3989290000,10081630000,46,115,161
3684320000,7402060000,621480000,863960000,230510000,12802330000,52,127,179
4355250000,1527620000,832090000,86900000,5496370000,12298230000,45,122,167
2850800000,5213850000,287680000,1944090000,161360000,10457780000,47,112,159
255370000,496420000,43640000,2160040000,6291650000,9247120000,34,79,113
1673590000,5495860000,31170000,718770000,3145790000,11065180000,37,116,153
2235250000,100600000,69610000,25480000,2954790000,5385730000,39,117,156
3903750000,5109330000,538970000,716260000,715420000,10983730000,53,141,194
1657200000,1666050000,137030000,388900000,84530000,3933710000,60,143,203
505900000,5013260000,268190000,223570000,2784750000,8795670000,43,112,155
3282840000,818680000,57850000,1770000,12486870000,16648010000,45,121,166
1857360000,8808540000,95510000,409850000,3323090000,14494350000,46,133,179
1459760000,6555820000,1232520000,1482890000,3111040000,13842030000,51,130,181
2799410000,5485500000,380420000,1372900000,167510000,10205740000,54,123,177
524210000,2504400000,63310000,74830000,1745670000,4912420000,28,90,118
3114460000,4452670000,437730000,1063130000,409620000,9477610000,54,125,179
4582450000,3500860000,349120000,93830000,2532580000,11058840000,38,104,142
5976600000,2470280000,187700000,4018170000,1531330000,14184080000,43,129,172
4924150000,988010000,186290000,0,2.164e+09,8262450000,49,138,187
5891290000,7099670000,737570000,1213690000,1501760000,16443980000,58,148,206
482900000,2440380000,424190000,1454200000,4168810000,8970480000,45,117,162
1037790000,3579560000,81060000,234200000,212660000,5145270000,34,96,130
3604940000,7424080000,368280000,1547510000,384950000,13329760000,42,104,146
1257600000,30400000,6e+06,160000,12911940000,14206100000,35,103,138
4985200000,3413750000,359270000,113190000,2.032e+09,10903410000,42,115,157
3272360000,3495510000,320980000,555030000,196780000,7840660000,50,118,168
3110410000,4902860000,268910000,203690000,590370000,9076240000,38,102,140
2751230000,2427250000,494570000,1808650000,190420000,7672120000,46,104,150
1224470000,44680000,11890000,2015870000,7730540000,11027450000,40,101,141
2225010000,3162860000,142880000,702230000,2700280000,8933260000,52,118,170
2623940000,104070000,11850000,330000,2830930000,5571120000,39,110,149
1108880000,481720000,26830000,253510000,5264910000,7135850000,44,125,169
2924560000,57320000,3860000,0,2585370000,5571110000,37,111,148
4200250000,2297570000,276400000,3242090000,440790000,10457100000,44,106,150
1541340000,6068130000,655110000,1117150000,370140000,9751870000,50,115,165
338740000,430840000,34990000,114850000,1579310000,2498730000,24,63,87
4749890000,4078940000,518550000,768200000,582640000,10698220000,54,124,178
3485220000,6432390000,574490000,593670000,871260000,11957030000,51,126,177
4428830000,3535300000,827980000,964410000,319220000,10075740000,50,120,170
5208640000,2308260000,199350000,113030000,2533320000,10362600000,42,116,158
1836700000,1416540000,168480000,2610200000,8553190000,14585110000,44,110,154
6137370000,4865650000,203750000,1151400000,2406350000,14764520000,48,134,182
3927770000,913030000,275600000,2170000,4306960000,9425530000,49,135,184
3078410000,3308390000,685270000,387340000,115550000,7574960000,41,98,139
2578240000,5126950000,198780000,669170000,633180000,9206320000,53,117,170
2759100000,6117300000,594580000,518600000,91770000,10081350000,49,107,156
4739620000,325280000,57240000,52040000,3771730000,8945910000,37,107,144
2540260000,4091140000,391240000,388720000,429330000,7840690000,52,117,169
5636940000,1557870000,129600000,0,3503940000,10828350000,45,134,179
3836880000,345080000,106500000,16610000,6079550000,10384620000,44,132,176
2561050000,3209550000,1197370000,391600000,215330000,7574900000,49,107,156
4606140000,2.143e+09,314050000,1470770000,527320000,9061280000,41,109,150
6548740000,26551460000,2749430000,14019200000,9467600000,59336430000,58,131,189
9772910000,45778400000,1129050000,1914380000,31413910000,90008650000,57,146,203
16598950000,19014480000,2580180000,4441750000,1120060000,43755420000,56,124,180
16197570000,21862130000,3024230000,2719940000,1714720000,45518590000,63,155,218
7021680000,23515130000,1911620000,3483090000,3060050000,38991570000,60,128,188
17724890000,26053660000,1795150000,4804320000,11485120000,61863140000,53,128,181
11868440000,33357910000,5736640000,6794520000,1179850000,58937360000,58,128,186
18660090000,21449690000,1691660000,4545690000,22833670000,69180800000,65,170,235
14794380000,15398950000,2485470000,4570940000,10859140000,48108880000,56,148,204
16695840000,22484780000,1116720000,3138880000,2994830000,46431050000,55,140,195
16846850000,4075040000,1000170000,51230000,11447480000,33420770000,55,149,204
24244980000,6641470000,766550000,650000,13896560000,45550210000,59,150,209
17732930000,19599180000,3636690000,6899580000,2833180000,50701560000,58,153,211
23826380000,11302870000,2038160000,3460000,19096180000,56267050000,59,152,211
24559110000,5492460000,655300000,683330000,14262580000,45652780000,51,136,187
4939200000,6603030000,413680000,430960000,12584720000,24971590000,36,100,136
10611410000,19180360000,2586150000,3086260000,1168630000,36632810000,56,132,188
7822280000,19395830000,3123180000,5984890000,1357300000,37683480000,56,139,195
16807780000,16459120000,2737640000,11255450000,5557970000,52817960000,59,137,196
2557900000,32672330000,2411280000,2790990000,1782640000,42215140000,61,132,193
9524250000,23281430000,2419580000,5144770000,1908130000,42278160000,61,149,210
20649810000,8012050000,1514380000,302420000,1.7842e+10,48320660000,48,137,185
24933570000,7006090000,1736090000,7103770000,7058700000,47838220000,56,150,206
1419530000,22755570000,4008730000,7577950000,9333550000,45095330000,52,130,182
13510560000,16298310000,1988950000,2422480000,1653760000,35874060000,57,132,189
8919860000,20057800000,1612790000,2569190000,841700000,34001340000,55,135,190
11012790000,20453570000,1551060000,2926980000,12711250000,48655650000,45,123,168
28168190000,2575630000,333670000,510000,14388520000,45466520000,48,136,184
11832820000,2499860000,270370000,31990000,48897790000,63532830000,52,142,194
14126970000,23481840000,1301460000,3372750000,3295930000,45578950000,59,142,201
14504850000,24528690000,1733820000,2604720000,3363240000,46735320000,56,148,204
15717470000,21225250000,3751800000,3772250000,720030000,45186800000,55,119,174
8634510000,7512420000,1475920000,692310000,12115070000,30430230000,54,138,192
23710020000,18314010000,1775570000,5096420000,11217810000,60113830000,67,175,242
15600820000,27765570000,1930620000,3983410000,11168100000,60448520000,71,177,248
3604130000,1936470000,235680000,5830230000,36544080000,48150590000,49,125,174
18518830000,39004120000,1676730000,2290810000,24737090000,86227580000,49,139,188
21361490000,11273590000,1274140000,3899490000,16926500000,54735210000,63,167,230
15367540000,31042450000,989310000,6028240000,14294820000,67722360000,57,162,219
2964870000,21651270000,1935160000,4203740000,21695530000,52450570000,53,129,182
11240990000,19510150000,2409840000,2501750000,1117370000,36780100000,57,136,193
14314060000,10622760000,1857020000,2848260000,1829410000,31471510000,60,144,204
18155650000,179200000,42350000,560000,45437780000,63815540000,48,130,178
18005970000,26185930000,1671790000,10963710000,8593270000,65420670000,59,156,215
12552770000,679690000,89760000,1046450000,42138100000,56506770000,48,126,174
13614340000,16399640000,1337650000,20200780000,1415010000,52967420000,56,132,188
10275330000,20856910000,2175470000,1977030000,905600000,36190340000,63,155,218
7187590000,15448610000,1151430000,4243750000,9121690000,37153070000,54,136,190
33684350000,5557140000,906750000,1070000,17472280000,57621590000,60,148,208
2923360000,11109670000,3634960000,21327830000,17487340000,56483160000,48,123,171
9558660000,24665170000,3586290000,2837850000,1257570000,41905540000,54,135,189
6895280000,15414880000,586110000,1621080000,4968790000,29486140000,63,148,211
1956500000,6422700000,640700000,22035650000,21301520000,52357070000,41,97,138
22044800000,459110000,110770000,278720000,49654330000,72547730000,50,125,175
13724030000,19418630000,685360000,5839530000,1979340000,41646890000,63,147,210
8943230000,15147140000,619080000,3883210000,28755990000,57348650000,57,154,211
18448470000,10410220000,3184780000,12458180000,10702390000,55204040000,57,148,205
10870020000,27697220000,1846520000,4493990000,1091980000,45999730000,59,133,192
15376460000,12730680000,2695440000,6339010000,2545910000,39687500000,56,142,198
15980220000,10485420000,2578610000,9906110000,7296620000,46246980000,56,151,207
39699810000,322940000,143590000,51710000,24882450000,65100500000,44,130,174
1.5201e+10,19432310000,1096740000,3540850000,16088820000,55359720000,61,152,213
26468110000,5437140000,437680000,26150000,17845550000,50214630000,59,150,209
3158630000,27830850000,5964080000,4992040000,15872210000,57817810000,53,135,188
20055920000,40460590000,867980000,7276990000,22329520000,9.0991e+10,54,156,210
1585980000,14716220000,1075390000,340660000,10890870000,28609120000,47,127,174
7944630000,14620910000,6.58e+08,2881800000,8801370000,34906710000,62,167,229
19710600000,3285460000,221830000,240510000,48948080000,72406480000,51,137,188
33398290000,1272360000,344060000,101460000,26686100000,61802270000,46,134,180
16521410000,16494760000,4665200000,5762630000,991900000,44435900000,53,121,174
14099610000,16282110000,1259120000,3872950000,5563480000,41077270000,57,136,193
1088360000,8402140000,702880000,285150000,8779340000,19257870000,48,118,166
1641520000,6983840000,1345930000,10930710000,23033230000,43935230000,55,122,177
10932610000,11148480000,1021770000,2016370000,591710000,25710940000,61,146,207
10879520000,43643190000,1144570000,11706790000,21558070000,88932140000,50,149,199
3491550000,5593840000,1505400000,18985330000,15143080000,44719200000,50,121,171
35201020000,1476800000,384530000,59500000,23175930000,60297780000,50,140,190
18183500000,15445020000,1575020000,5533950000,1943280000,42680770000,60,145,205
9350390000,16791740000,2333480000,1723940000,1217880000,31417430000,58,144,202
14859380000,20354410000,4646460000,4881770000,455730000,45197750000,50,117,167
16613420000,16774370000,1912450000,12432520000,1620470000,49353230000,56,141,197
4159150000,19265420000,8403810000,6780470000,9141810000,47750660000,58,136,194
12229840000,19585690000,1089470000,1262140000,9624020000,43791160000,46,124,170
29944890000,3936770000,445320000,17370000,26063240000,60407590000,50,147,197
12421840000,17623630000,806810000,2123870000,9363140000,42339290000,61,137,198
1238390000,9829880000,1082200000,5097420000,11682550000,28930440000,54,137,191
1430170000,5699370000,936880000,23059400000,28099610000,59225430000,39,105,144
3918390000,1648140000,1215770000,14483840000,30749210000,52015350000,47,118,165
11831050000,28970120000,2214390000,3626790000,760070000,47402420000,48,122,170
7619830000,19624490000,1112800000,3693290000,626580000,32676990000,62,142,204
9274580000,22347990000,1320140000,2956560000,993660000,36892930000,57,128,185
15015950000,49051170000,1328810000,2143960000,34718050000,102257940000,57,146,203
10695150000,5627460000,364200000,5947840000,16134550000,38769200000,49,147,196
21907580000,19510400000,3061910000,9178180000,1620160000,55278230000,57,136,193
19363640000,25060420000,1457500000,5996910000,33053570000,84932040000,50,145,195
3126280000,16404860000,2504680000,10376090000,10980200000,43392110000,58,137,195
5534420000,32553840000,2735350000,10112980000,5576640000,56513230000,56,134,190
19055020000,13165990000,346420000,6118090000,5465560000,44151080000,54,145,199
13234440000,17079720000,2991760000,3196060000,9169210000,45671190000,50,151,201
34779880000,1200870000,180840000,125450000,23316130000,59603170000,51,141,192
29389720000,4408540000,606620000,105970000,13997520000,48508370000,47,128,175
17811350000,2585920000,519740000,199730000,40540750000,61657490000,59,153,212
19803030000,7627210000,1055580000,491170000,11192800000,40169790000,50,140,190
19367610000,11821650000,724910000,2738380000,27069440000,61721990000,59,155,214
18489330000,15412580000,2088230000,7958850000,2224780000,46173770000,54,144,198
31036060000,1518520000,397410000,40670000,28916480000,61909140000,56,145,201
19881780000,872380000,72490000,532570000,48674060000,70033280000,52,133,185
9950280000,21655850000,1844860000,421940000,7506140000,41379070000,52,144,196
7825490000,23688390000,1067920000,2012350000,14689330000,49283480000,47,130,177
6830930000,40518660000,3445390000,2479250000,12861990000,66136220000,73,169,242
4276110000,12785410000,628530000,2322060000,33462180000,53474290000,42,118,160
14902290000,10129530000,2146840000,4005120000,18582690000,49766470000,61,165,226
99613440000,37306780000,5761160000,2298710000,84660070000,229640160000,59,161,220
70790400000,131480750000,5626040000,17760590000,97038080000,322695860000,71,188,259
31294280000,1116920000,196210000,1222350000,82560890000,116390650000,50,130,180
12299880000,18916080000,3647730000,58883670000,133970860000,227718220000,55,141,196
29272610000,61125740000,4170310000,8814800000,94005950000,197389410000,57,157,214
60071320000,93796870000,9993450000,16916690000,6478680000,187257010000,68,165,233
50456330000,17459620000,2394330000,574420000,105753960000,176638660000,64,175,239
36411070000,94832170000,21950630000,24825170000,30296690000,208315730000,68,157,225
79323480000,134988200000,10408390000,24618640000,20123170000,269461880000,69,180,249
40221130000,76693060000,3962050000,13291650000,14766070000,148933960000,69,159,228
79845140000,6641980000,1002160000,155340000,68906220000,156550840000,61,156,217
84519700000,3339500000,456470000,732120000,102553480000,191601270000,56,156,212
79369720000,69504040000,9459850000,52127200000,44316740000,254777550000,69,185,254
79792340000,90629500000,11439220000,22454680000,10537420000,214853160000,69,177,246
65344140000,68813170000,8725590000,14849360000,56706840000,214439100000,68,189,257
60502050000,97804750000,8976600000,16361910000,24443070000,208088380000,65,157,222
67996610000,193855810000,6241980000,25094810000,125120500000,418309710000,66,178,244
31449340000,102808330000,14019180000,28177930000,62275180000,238729960000,65,168,233
59431890000,55324410000,2736110000,14095670000,46336730000,177924810000,65,165,230
20283920000,39757650000,1806120000,8831790000,75056700000,145736180000,66,171,237
98595390000,24040350000,3612870000,30860000,62587690000,188867160000,65,165,230
48496720000,96326050000,8154200000,12793390000,30497850000,196268210000,76,188,264
34014080000,108079380000,9259850000,38098300000,4.8409e+10,237860610000,66,155,221
93449230000,8990570000,1264690000,336120000,108733690000,212774300000,57,165,222
46659240000,55788430000,8894870000,20411660000,11240460000,142994660000,71,177,248
10359710000,66614730000,14913570000,67601550000,80271830000,239761390000,60,143,203
46479720000,327470000,115800000,10580000,73212990000,120146560000,51,140,191
73199820000,70070990000,14374480000,30786240000,11531900000,199963430000,62,154,216
227956130000,361624550000,31705180000,64217190000,114083930000,799586980000,77,195,272
153536900000,352526530000,14410080000,54486620000,243037050000,817997180000,79,201,280
359788940000,43582990000,6115550000,4186310000,429717430000,843391220000,76,192,268
229744580000,85315900000,11052020000,7972950000,315114790000,649200240000,74,186,260
42126650000,189050020000,36502190000,160473900000,297383760000,725536520000,80,188,268
313679780000,375699680000,60291540000,141422740000,137201450000,1028295190000,76,222,298
269984690000,438648030000,38081380000,87256250000,316912520000,1150882870000,82,215,297
1547170170000,1789055420000,186008970000,503170950000,1976576460000,6001981970000,117,302,419
