"Forest","Agriculture","Other","Area_Total","natural_sp","human_dominated_sp","Sp_Total"
124760000,247110000,2118270000,2490140000,34,64,98
145150000,388660000,1664230000,2198040000,23,59,82
181440000,1195730000,1122830000,2.5e+09,30,59,89
477670000,685220000,1337110000,2.5e+09,30,61,91
346850000,449720000,1703430000,2.5e+09,36,68,104
167350000,1758200000,574450000,2.5e+09,36,64,100
696300000,498280000,1305420000,2.5e+09,25,54,79
200940000,1827710000,471350000,2.5e+09,32,67,99
309660000,1837590000,352750000,2.5e+09,38,72,110
507050000,1229450000,763500000,2.5e+09,31,71,102
610450000,1457110000,432440000,2.5e+09,34,72,106
690250000,557200000,1252550000,2.5e+09,24,55,79
1195260000,1019350000,285390000,2.5e+09,27,62,89
867320000,811630000,821050000,2.5e+09,26,58,84
727390000,344930000,1427680000,2.5e+09,19,48,67
122960000,800110000,1576930000,2.5e+09,37,68,105
428910000,710430000,1360660000,2.5e+09,27,55,82
268670000,836450000,1394880000,2.5e+09,42,76,118
247410000,1806490000,446100000,2.5e+09,36,66,102
380690000,1471040000,648270000,2.5e+09,33,68,101
168510000,1698900000,632590000,2.5e+09,29,61,90
123410000,1844420000,532170000,2.5e+09,43,81,124
367440000,968540000,1164020000,2.5e+09,27,64,91
267670000,1074310000,1158020000,2.5e+09,35,71,106
39860000,768310000,1691830000,2.5e+09,52,94,146
15690000,31970000,1691670000,1739330000,39,63,102
572660000,767310000,1160030000,2.5e+09,32,72,104
902670000,960240000,637090000,2.5e+09,18,44,62
306960000,1560060000,632980000,2.5e+09,33,64,97
83550000,927110000,1489340000,2.5e+09,41,71,112
106360000,1936770000,456870000,2.5e+09,46,81,127
105550000,1452780000,941670000,2.5e+09,40,81,121
221930000,150110000,1897870000,2269910000,17,34,51
378310000,291380000,1715030000,2384720000,29,56,85
393800000,1022140000,1084060000,2.5e+09,21,51,72
717870000,615100000,1167030000,2.5e+09,16,47,63
790910000,449450000,1259640000,2.5e+09,33,56,89
395660000,676390000,1427950000,2.5e+09,24,49,73
939720000,490910000,1069370000,2.5e+09,23,62,85
368620000,461670000,1669710000,2.5e+09,20,58,78
880200000,904580000,715220000,2.5e+09,25,53,78
1020590000,641400000,838010000,2.5e+09,33,60,93
959760000,1026110000,514130000,2.5e+09,21,52,73
330930000,781840000,1387230000,2.5e+09,26,58,84
426730000,772570000,1300700000,2.5e+09,27,61,88
231880000,1226180000,1041940000,2.5e+09,25,58,83
300270000,1008810000,1190920000,2.5e+09,23,57,80
136740000,1328340000,1034920000,2.5e+09,34,65,99
97310000,1087810000,1314880000,2.5e+09,35,66,101
658310000,631120000,1210570000,2.5e+09,35,64,99
289820000,1128300000,1081880000,2.5e+09,27,60,87
278760000,1309910000,911330000,2.5e+09,27,59,86
936380000,973730000,589890000,2.5e+09,22,49,71
932320000,351770000,1215910000,2.5e+09,27,56,83
962640000,422910000,1114450000,2.5e+09,22,38,60
593010000,669810000,1237180000,2.5e+09,39,74,113
86650000,1243240000,1170110000,2.5e+09,40,71,111
138430000,1375380000,986190000,2.5e+09,36,65,101
324290000,883140000,1292570000,2.5e+09,37,66,103
663010000,186100000,1650890000,2.5e+09,26,55,81
887670000,241270000,1371060000,2.5e+09,27,61,88
9570000,28480000,1801990000,1840040000,18,44,62
88650000,24020000,2224480000,2337150000,14,39,53
40170000,64350000,2395480000,2.5e+09,17,44,61
32590000,143050000,2324360000,2.5e+09,19,46,65
168700000,319410000,2011890000,2.5e+09,19,46,65
85680000,250090000,2164230000,2.5e+09,19,41,60
27190000,115700000,2350320000,2493210000,20,51,71
125210000,176200000,2198590000,2.5e+09,22,49,71
59540000,148750000,2227520000,2435810000,18,40,58
83130000,213150000,2203720000,2.5e+09,20,48,68
249280000,174700000,2076020000,2.5e+09,18,39,57
186730000,371930000,1941340000,2.5e+09,23,48,71
11450000,79630000,2246990000,2338070000,22,58,80
185020000,222810000,2092170000,2.5e+09,15,36,51
33070000,204340000,2262590000,2.5e+09,18,41,59
96250000,261300000,2122050000,2479600000,19,45,64
111540000,91740000,2296720000,2.5e+09,18,43,61
194690000,186900000,2118410000,2.5e+09,21,40,61
225980000,165120000,2108900000,2.5e+09,17,36,53
66160000,70720000,2363120000,2.5e+09,21,44,65
93020000,103460000,2303520000,2.5e+09,16,38,54
39980000,175990000,2284030000,2.5e+09,17,48,65
66270000,129390000,2254070000,2449730000,21,56,77
57760000,83090000,2359150000,2.5e+09,15,46,61
427510000,1482570000,589920000,2.5e+09,42,82,124
331760000,278140000,1890100000,2.5e+09,25,54,79
94130000,438020000,1967850000,2.5e+09,19,40,59
117750000,243400000,2138850000,2.5e+09,18,39,57
32940000,533740000,1933320000,2.5e+09,24,50,74
147650000,0,2352350000,2.5e+09,19,56,75
577890000,1255140000,666970000,2.5e+09,43,81,124
159010000,1779690000,561300000,2.5e+09,37,57,94
308990000,990360000,1200650000,2.5e+09,40,83,123
49430000,1677780000,772790000,2.5e+09,43,80,123
347420000,1258790000,893790000,2.5e+09,48,92,140
386470000,1199360000,914170000,2.5e+09,36,75,111
132320000,42870000,1899100000,2074290000,26,56,82
117970000,1122780000,1259250000,2.5e+09,49,85,134
14980000,2381280000,103740000,2.5e+09,28,56,84
79960000,1949090000,470950000,2.5e+09,39,73,112
597340000,1217810000,684850000,2.5e+09,29,58,87
495730000,836660000,1167610000,2.5e+09,35,74,109
391010000,1080370000,1028620000,2.5e+09,34,65,99
270240000,1802550000,427210000,2.5e+09,41,83,124
218760000,663520000,1617720000,2.5e+09,37,73,110
162640000,583640000,1753720000,2.5e+09,36,67,103
206750000,1913800000,379450000,2.5e+09,27,61,88
144930000,1989240000,365830000,2.5e+09,37,73,110
204330000,1515170000,780500000,2.5e+09,34,66,100
446810000,900080000,1153110000,2.5e+09,29,61,90
2.46e+08,1700290000,553710000,2.5e+09,29,66,95
74790000,1985290000,439920000,2.5e+09,38,77,115
95100000,428510000,1976390000,2.5e+09,37,67,104
479700000,1153680000,866620000,2.5e+09,31,63,94
6.43e+08,684390000,1172610000,2.5e+09,26,53,79
366020000,1394490000,739490000,2.5e+09,21,51,72
587690000,1228040000,684270000,2.5e+09,33,62,95
798820000,199300000,1501880000,2.5e+09,26,51,77
125380000,1131410000,1243210000,2.5e+09,44,74,118
424860000,1273470000,801670000,2.5e+09,32,65,97
169180000,1389290000,941530000,2.5e+09,49,79,128
732110000,1314550000,453340000,2.5e+09,25,55,80
475490000,881890000,1142620000,2.5e+09,29,60,89
637290000,661610000,1201100000,2.5e+09,33,67,100
1009100000,289830000,1201070000,2.5e+09,31,60,91
1031050000,465970000,1002980000,2.5e+09,32,62,94
404490000,583170000,1512340000,2.5e+09,36,72,108
64350000,830940000,1604710000,2.5e+09,46,88,134
80850000,1113790000,1305360000,2.5e+09,40,71,111
536490000,688490000,1275020000,2.5e+09,38,73,111
463330000,428390000,1608280000,2.5e+09,37,69,106
103080000,1743410000,653510000,2.5e+09,42,73,115
579300000,880160000,1040540000,2.5e+09,38,75,113
449190000,340460000,1710350000,2.5e+09,36,71,107
915490000,273480000,1311030000,2.5e+09,34,68,102
159370000,2185960000,154670000,2.5e+09,36,73,109
142120000,1847340000,510540000,2.5e+09,39,72,111
977820000,1298490000,223690000,2.5e+09,37,74,111
434690000,1393530000,671780000,2.5e+09,39,77,116
55150000,2375850000,6.9e+07,2.5e+09,34,65,99
133050000,2230510000,136440000,2.5e+09,36,67,103
143210000,2192690000,164100000,2.5e+09,36,73,109
383530000,1736940000,379530000,2.5e+09,37,71,108
839510000,96120000,1564370000,2.5e+09,32,59,91
956870000,975960000,567170000,2.5e+09,37,71,108
820760000,115610000,1563630000,2.5e+09,31,60,91
696900000,1343060000,460040000,2.5e+09,38,72,110
280640000,283700000,1675460000,2239800000,28,52,80
58320000,47850000,1573960000,1680130000,27,59,86
437510000,776500000,1285990000,2.5e+09,45,81,126
622660000,1291730000,585610000,2.5e+09,37,73,110
868580000,287810000,1343610000,2.5e+09,38,80,118
703900000,725510000,1070590000,2.5e+09,36,68,104
501120000,1002970000,995910000,2.5e+09,39,77,116
150420000,2086200000,263380000,2.5e+09,35,68,103
303870000,1960750000,235380000,2.5e+09,36,70,106
1168880000,554840000,776280000,2.5e+09,39,71,110
1049210000,999090000,451700000,2.5e+09,31,64,95
709120000,229390000,1561490000,2.5e+09,36,71,107
593520000,1011830000,894650000,2.5e+09,35,70,105
1027430000,489380000,983190000,2.5e+09,36,70,106
686820000,1247940000,565240000,2.5e+09,37,67,104
15250000,89270000,1893480000,1.998e+09,31,47,78
174950000,495480000,1824500000,2494930000,33,71,104
536750000,1318270000,644980000,2.5e+09,38,75,113
1394690000,463320000,641990000,2.5e+09,32,57,89
527850000,1092820000,879330000,2.5e+09,34,67,101
868980000,894100000,736920000,2.5e+09,35,68,103
1156540000,439770000,903690000,2.5e+09,25,58,83
1122100000,428440000,949460000,2.5e+09,37,70,107
1368200000,537980000,593820000,2.5e+09,33,69,102
394660000,1167240000,938100000,2.5e+09,36,77,113
483180000,1254650000,762170000,2.5e+09,36,69,105
1521090000,202060000,776850000,2.5e+09,37,69,106
703080000,1359370000,437550000,2.5e+09,43,88,131
1461240000,61680000,977080000,2.5e+09,35,67,102
785680000,1205050000,509270000,2.5e+09,38,78,116
45480000,611760000,1842760000,2.5e+09,32,79,111
297240000,1115780000,1086980000,2.5e+09,36,74,110
6830000,83910000,2025310000,2116050000,34,61,95
283020000,1612810000,604170000,2.5e+09,30,63,93
48540000,905470000,1545990000,2.5e+09,40,88,128
645630000,832900000,1021470000,2.5e+09,28,59,87
260690000,1646900000,592410000,2.5e+09,36,69,105
171150000,1840960000,487890000,2.5e+09,45,87,132
222340000,1590760000,686900000,2.5e+09,40,80,120
639090000,1333590000,527320000,2.5e+09,42,82,124
1273600000,181390000,1045010000,2.5e+09,35,59,94
759080000,1106920000,6.34e+08,2.5e+09,44,83,127
1066360000,449310000,984330000,2.5e+09,35,61,96
1437220000,305300000,757480000,2.5e+09,36,72,108
474780000,64510000,1651610000,2190900000,29,57,86
536810000,499490000,1430440000,2466740000,36,80,116
626940000,497610000,1375450000,2.5e+09,28,59,87
556690000,1587300000,356010000,2.5e+09,32,67,99
263280000,1740000,1479680000,1744700000,28,62,90
249130000,11390000,1626940000,1887460000,25,52,77
868560000,469190000,1162250000,2.5e+09,35,72,107
124150000,118150000,1933380000,2175680000,34,74,108
134070000,10370000,1443010000,1587450000,25,49,74
292300000,1659970000,547730000,2.5e+09,37,85,122
484060000,1109660000,906280000,2.5e+09,36,76,112
107100000,1830190000,562710000,2.5e+09,27,64,91
41810000,608100000,1850090000,2.5e+09,38,81,119
146690000,1710800000,642510000,2.5e+09,32,68,100
122810000,1940420000,436770000,2.5e+09,34,68,102
179490000,1739370000,581140000,2.5e+09,31,61,92
91760000,1554270000,853970000,2.5e+09,39,86,125
141850000,1340220000,1017930000,2.5e+09,35,79,114
131340000,1655790000,712870000,2.5e+09,35,73,108
1048150000,311990000,1139860000,2.5e+09,29,60,89
130440000,1971240000,398320000,2.5e+09,36,77,113
548870000,1245710000,705420000,2.5e+09,43,75,118
181450000,1915610000,402940000,2.5e+09,36,70,106
838190000,567890000,1093920000,2.5e+09,35,67,102
1027320000,141850000,1330830000,2.5e+09,38,70,108
477980000,1449260000,572760000,2.5e+09,32,59,91
1215910000,737520000,546570000,2.5e+09,28,56,84
258990000,2033450000,207560000,2.5e+09,34,63,97
668630000,1570250000,261120000,2.5e+09,28,56,84
276380000,1748040000,475580000,2.5e+09,34,72,106
590890000,1233970000,675140000,2.5e+09,39,73,112
517110000,1589080000,393810000,2.5e+09,41,76,117
24740000,397660000,2077600000,2.5e+09,26,60,86
122420000,681520000,1696060000,2.5e+09,23,58,81
32180000,339550000,1868800000,2240530000,19,50,69
15360000,65020000,1705060000,1785440000,24,51,75
19470000,137360000,2187820000,2344650000,26,65,91
39010000,86620000,2374370000,2.5e+09,22,53,75
28440000,199220000,2272010000,2499670000,24,44,68
343600000,1770000,2154630000,2.5e+09,18,40,58
205810000,70210000,2223980000,2.5e+09,28,71,99
251290000,47160000,2201550000,2.5e+09,25,60,85
35330000,632450000,1832220000,2.5e+09,29,58,87
25450000,312910000,2159290000,2497650000,33,60,93
80320000,481030000,1937630000,2498980000,27,66,93
61820000,166480000,2271700000,2.5e+09,21,54,75
196740000,828050000,1475210000,2.5e+09,17,58,75
121820000,368040000,2010140000,2.5e+09,27,64,91
168850000,839830000,1491320000,2.5e+09,25,69,94
256290000,12520000,2231190000,2.5e+09,22,59,81
135240000,68570000,2296190000,2.5e+09,28,73,101
190250000,236680000,2073070000,2.5e+09,27,63,90
346070000,146770000,2007160000,2.5e+09,25,67,92
31830000,17750000,2450420000,2.5e+09,34,84,118
217060000,20470000,2261440000,2498970000,24,60,84
196220000,142730000,2161050000,2.5e+09,28,70,98
232460000,149730000,2117810000,2.5e+09,25,61,86
22290000,128890000,2106320000,2257500000,33,67,100
249730000,189050000,2061220000,2.5e+09,24,74,98
118950000,275020000,2106030000,2.5e+09,27,69,96
165070000,53390000,2281540000,2.5e+09,28,73,101
231640000,1.57e+08,2111360000,2.5e+09,25,67,92
529380000,59880000,1910740000,2.5e+09,22,56,78
272820000,255550000,1971630000,2.5e+09,24,62,86
480800000,180150000,1839050000,2.5e+09,25,58,83
241410000,1437030000,821560000,2.5e+09,32,62,94
189500000,1743080000,567420000,2.5e+09,31,60,91
289190000,1883750000,327060000,2.5e+09,28,53,81
443590000,1708900000,347510000,2.5e+09,24,51,75
20690000,234060000,1751540000,2006290000,27,56,83
81020000,807190000,1611790000,2.5e+09,29,64,93
148310000,1259370000,1092320000,2.5e+09,24,64,88
468300000,397840000,1633860000,2.5e+09,29,66,95
270150000,616090000,1613760000,2.5e+09,33,79,112
192330000,1451660000,856010000,2.5e+09,24,62,86
287400000,780810000,1431790000,2.5e+09,30,73,103
74350000,1360080000,1065570000,2.5e+09,26,61,87
112670000,1322400000,1064930000,2.5e+09,29,71,100
69230000,876870000,1553900000,2.5e+09,23,64,87
174820000,1234590000,1090590000,2.5e+09,26,66,92
107270000,356310000,2036420000,2.5e+09,31,73,104
81590000,969300000,1449110000,2.5e+09,31,72,103
22920000,93830000,2383250000,2.5e+09,34,83,117
94700000,111290000,2294010000,2.5e+09,30,70,100
130090000,145910000,2.224e+09,2.5e+09,28,70,98
138670000,226980000,2134350000,2.5e+09,26,62,88
137380000,17590000,2345030000,2.5e+09,32,75,107
72880000,695710000,1731410000,2.5e+09,35,80,115
96550000,1159340000,1244110000,2.5e+09,30,78,108
544490000,176450000,1779060000,2.5e+09,24,53,77
43220000,440410000,1750240000,2233870000,32,82,114
160210000,1328430000,1011360000,2.5e+09,28,62,90
246360000,1866660000,386980000,2.5e+09,27,48,75
136910000,1342230000,1020860000,2.5e+09,34,69,103
308600000,1679690000,511710000,2.5e+09,29,64,93
19360000,215980000,2264660000,2.5e+09,29,64,93
195660000,362290000,1942050000,2.5e+09,32,77,109
89230000,360970000,1856930000,2307130000,30,74,104
47670000,1393130000,1059200000,2.5e+09,25,60,85
179710000,1260380000,1059910000,2.5e+09,29,70,99
172180000,582850000,1744970000,2.5e+09,31,71,102
114010000,1372130000,1013860000,2.5e+09,29,70,99
39740000,1257560000,1202700000,2.5e+09,31,62,93
54380000,2177850000,267770000,2.5e+09,28,64,92
88160000,1851680000,560160000,2.5e+09,30,71,101
57410000,1848760000,593830000,2.5e+09,30,76,106
116670000,1632300000,751030000,2.5e+09,31,76,107
78720000,1990880000,430400000,2.5e+09,29,60,89
239850000,816940000,1443210000,2.5e+09,29,74,103
107510000,1338480000,1054010000,2.5e+09,34,65,99
160740000,1683170000,656090000,2.5e+09,29,59,88
164850000,1023110000,1312040000,2.5e+09,31,64,95
146360000,1229350000,1124290000,2.5e+09,31,67,98
42400000,303720000,2121920000,2468040000,36,78,114
75480000,822390000,1602130000,2.5e+09,32,61,93
17900000,480040000,1783100000,2281040000,36,73,109
199450000,1215700000,1084850000,2.5e+09,27,55,82
367630000,1047260000,1085110000,2.5e+09,30,56,86
335340000,1117900000,1046760000,2.5e+09,30,62,92
386850000,1830000,2111320000,2.5e+09,20,58,78
319150000,1600000,2179250000,2.5e+09,19,49,68
306480000,1920000,2191600000,2.5e+09,23,55,78
91360000,2880000,2405760000,2.5e+09,22,58,80
133030000,3450000,2363520000,2.5e+09,20,54,74
389670000,2990000,2107340000,2.5e+09,20,53,73
20100000,1990000,2433960000,2456050000,22,67,89
87980000,2620000,2409400000,2.5e+09,24,61,85
334490000,4900000,2160610000,2.5e+09,22,67,89
413290000,218660000,1868050000,2.5e+09,27,71,98
369780000,587390000,1542830000,2.5e+09,28,74,102
522470000,327900000,1649630000,2.5e+09,31,76,107
213540000,10140000,2276320000,2.5e+09,30,65,95
616180000,285580000,1598240000,2.5e+09,31,70,101
291150000,2840000,2206010000,2.5e+09,28,69,97
131490000,0,2368510000,2.5e+09,23,60,83
359220000,83220000,2057560000,2.5e+09,26,69,95
145390000,34300000,2320310000,2.5e+09,26,74,100
7750000,3280000,2284410000,2295440000,18,42,60
0,38070000,2384550000,2422620000,20,57,77
711110000,1279340000,509550000,2.5e+09,34,63,97
129530000,739350000,1627380000,2496260000,41,73,114
493660000,1299530000,706810000,2.5e+09,40,78,118
807600000,1062060000,630340000,2.5e+09,34,75,109
994020000,711370000,794610000,2.5e+09,40,71,111
131970000,2088700000,279330000,2.5e+09,45,85,130
865650000,793500000,840850000,2.5e+09,34,70,104
949140000,55470000,1495390000,2.5e+09,28,60,88
531340000,1722430000,246230000,2.5e+09,29,52,81
336210000,1866370000,297420000,2.5e+09,27,53,80
764230000,1392840000,342930000,2.5e+09,30,56,86
470920000,1731240000,297840000,2.5e+09,29,56,85
517270000,1550340000,432390000,2.5e+09,34,67,101
789830000,1481470000,228700000,2.5e+09,30,56,86
681520000,1301950000,516530000,2.5e+09,35,73,108
1840000,266140000,1777220000,2045200000,45,81,126
563220000,986670000,950110000,2.5e+09,33,64,97
1126160000,349890000,1023950000,2.5e+09,37,68,105
2.44e+08,1854860000,401140000,2.5e+09,46,81,127
1721220000,197960000,580820000,2.5e+09,35,64,99
957550000,948090000,594360000,2.5e+09,36,68,104
931620000,26290000,1542090000,2.5e+09,28,55,83
732680000,1200480000,566840000,2.5e+09,32,72,104
884480000,51110000,1564410000,2.5e+09,29,58,87
153900000,2138810000,207290000,2.5e+09,29,62,91
167320000,2098450000,234230000,2.5e+09,30,55,85
421940000,1754020000,324040000,2.5e+09,32,67,99
157450000,1767660000,574890000,2.5e+09,33,71,104
1137430000,977240000,385330000,2.5e+09,29,64,93
484850000,1692100000,323050000,2.5e+09,30,56,86
1105730000,789050000,605220000,2.5e+09,29,61,90
1036870000,868640000,594490000,2.5e+09,27,54,81
716470000,815380000,968150000,2.5e+09,32,59,91
1114930000,1010740000,374330000,2.5e+09,27,53,80
793600000,599960000,1106440000,2.5e+09,31,62,93
654540000,1005430000,840030000,2.5e+09,32,61,93
565280000,1669170000,265550000,2.5e+09,35,75,110
277820000,1228390000,993790000,2.5e+09,41,73,114
548580000,1160240000,791180000,2.5e+09,38,83,121
361210000,931060000,1207730000,2.5e+09,29,65,94
520100000,1472350000,507550000,2.5e+09,34,70,104
491950000,1589620000,418430000,2.5e+09,35,74,109
649440000,1607040000,243520000,2.5e+09,39,76,115
564230000,1668670000,267100000,2.5e+09,37,76,113
340400000,171910000,1960550000,2472860000,40,72,112
1495910000,280100000,723990000,2.5e+09,40,67,107
1034420000,410180000,1055400000,2.5e+09,29,70,99
1328510000,614660000,556830000,2.5e+09,34,61,95
1674820000,557190000,267990000,2.5e+09,37,68,105
1425120000,315340000,759540000,2.5e+09,33,64,97
699210000,1373170000,427620000,2.5e+09,32,71,103
1284700000,154460000,1060840000,2.5e+09,33,65,98
515710000,1155830000,828460000,2.5e+09,45,82,127
682640000,898420000,918940000,2.5e+09,46,86,132
564530000,1500100000,435370000,2.5e+09,33,61,94
541690000,1599820000,358490000,2.5e+09,31,71,102
731760000,1259680000,508560000,2.5e+09,33,63,96
1481660000,350130000,668210000,2.5e+09,29,58,87
1013620000,537770000,948610000,2.5e+09,25,60,85
700850000,1025500000,773650000,2.5e+09,29,64,93
639070000,467750000,1393180000,2.5e+09,30,64,94
7.03e+08,737600000,1059400000,2.5e+09,28,60,88
1211450000,313360000,975190000,2.5e+09,28,61,89
1410360000,250770000,838870000,2.5e+09,28,62,90
804090000,519320000,1176590000,2.5e+09,30,63,93
670770000,223410000,1605820000,2.5e+09,29,67,96
339740000,1327600000,832660000,2.5e+09,36,71,107
458270000,8.59e+08,1182730000,2.5e+09,33,75,108
472460000,935810000,1091730000,2.5e+09,34,75,109
353230000,697750000,1449020000,2.5e+09,30,69,99
1450670000,812020000,237310000,2.5e+09,36,78,114
772680000,1444500000,282820000,2.5e+09,33,76,109
715870000,1274080000,510050000,2.5e+09,38,77,115
433540000,1533630000,532830000,2.5e+09,39,75,114
43270000,382630000,1936480000,2362380000,41,75,116
18990000,461990000,1740480000,2221460000,39,85,124
748800000,1132880000,618320000,2.5e+09,36,84,120
1215140000,620990000,663870000,2.5e+09,30,67,97
181810000,675690000,1642500000,2.5e+09,45,85,130
911590000,516830000,1071580000,2.5e+09,31,65,96
961840000,449860000,1088300000,2.5e+09,32,75,107
827450000,493930000,1178620000,2.5e+09,32,71,103
1486890000,184370000,828740000,2.5e+09,33,58,91
609670000,1065450000,824880000,2.5e+09,34,74,108
1054540000,604890000,840570000,2.5e+09,33,70,103
858520000,401040000,1240440000,2.5e+09,40,90,130
1132360000,562260000,805380000,2.5e+09,39,79,118
527640000,643190000,1329170000,2.5e+09,34,76,110
342880000,953820000,1203300000,2.5e+09,31,72,103
546480000,417540000,1535980000,2.5e+09,30,72,102
372200000,387170000,1740630000,2.5e+09,35,79,114
767680000,1359990000,372330000,2.5e+09,34,63,97
830650000,802460000,866890000,2.5e+09,35,75,110
824530000,1164690000,510780000,2.5e+09,30,68,98
1133620000,216710000,1149670000,2.5e+09,28,64,92
685490000,1198510000,6.16e+08,2.5e+09,34,68,102
74270000,993400000,1432330000,2.5e+09,47,93,140
835800000,1209310000,454890000,2.5e+09,34,71,105
330160000,666530000,1503310000,2.5e+09,43,90,133
1241600000,546590000,711810000,2.5e+09,34,71,105
998590000,845720000,655690000,2.5e+09,37,69,106
1133300000,848930000,517770000,2.5e+09,40,79,119
1144530000,867030000,488440000,2.5e+09,32,72,104
414870000,871720000,1213410000,2.5e+09,35,89,124
849420000,788760000,861820000,2.5e+09,34,70,104
612710000,1217910000,669380000,2.5e+09,43,98,141
691430000,1321580000,486990000,2.5e+09,39,75,114
593710000,706560000,1199730000,2.5e+09,37,82,119
668950000,804020000,1027030000,2.5e+09,36,85,121
583440000,1240690000,675870000,2.5e+09,39,76,115
693850000,1020110000,786040000,2.5e+09,43,93,136
1069750000,1034570000,395680000,2.5e+09,28,61,89
790170000,780640000,929190000,2.5e+09,33,69,102
873390000,1148750000,477860000,2.5e+09,31,71,102
712680000,1262280000,525040000,2.5e+09,38,85,123
94730000,35600000,2041910000,2172240000,29,59,88
1120260000,799420000,580320000,2.5e+09,34,73,107
1151500000,661670000,686830000,2.5e+09,36,77,113
1195970000,261440000,1042590000,2.5e+09,35,69,104
1156930000,546160000,796910000,2.5e+09,35,72,107
1087380000,762680000,649940000,2.5e+09,38,81,119
1126870000,563680000,809450000,2.5e+09,36,70,106
1324310000,398270000,777420000,2.5e+09,41,76,117
1097080000,576280000,826640000,2.5e+09,42,78,120
973480000,914980000,611540000,2.5e+09,34,73,107
1092550000,743160000,664290000,2.5e+09,41,77,118
418530000,1222930000,858540000,2.5e+09,28,61,89
403310000,1364070000,732620000,2.5e+09,33,66,99
345260000,1926680000,228060000,2.5e+09,27,65,92
252770000,2112530000,134700000,2.5e+09,30,65,95
357620000,1020320000,1122060000,2.5e+09,36,80,116
431130000,980800000,1088070000,2.5e+09,27,56,83
584670000,1194500000,720830000,2.5e+09,37,71,108
527480000,1634260000,338260000,2.5e+09,29,61,90
63180000,705630000,1530070000,2298880000,28,52,80
296090000,1129620000,1074290000,2.5e+09,32,60,92
278910000,839480000,1381610000,2.5e+09,33,73,106
88480000,202570000,1949860000,2240910000,31,65,96
99760000,787050000,1613190000,2.5e+09,33,71,104
60450000,1960910000,478640000,2.5e+09,31,74,105
64570000,1210400000,1225030000,2.5e+09,36,72,108
61970000,782360000,1618380000,2462710000,36,78,114
9980000,298230000,2152100000,2460310000,29,60,89
191190000,1912840000,395970000,2.5e+09,37,84,121
60010000,615100000,1574650000,2249760000,31,76,107
115500000,1807610000,576890000,2.5e+09,30,73,103
582400000,1559040000,358560000,2.5e+09,36,73,109
426660000,1762880000,310460000,2.5e+09,35,73,108
795090000,1102670000,602240000,2.5e+09,39,79,118
437150000,1800920000,261930000,2.5e+09,33,72,105
349980000,1591790000,558230000,2.5e+09,29,58,87
641890000,1501060000,357050000,2.5e+09,38,70,108
137940000,831840000,1526310000,2496090000,42,85,127
300600000,1767600000,431800000,2.5e+09,31,62,93
109600000,1778680000,611720000,2.5e+09,33,61,94
145330000,2086380000,268290000,2.5e+09,38,67,105
58510000,793100000,1634340000,2485950000,41,77,118
64990000,2020230000,414780000,2.5e+09,37,83,120
24440000,345990000,1615370000,1985800000,30,69,99
406470000,1901560000,191970000,2.5e+09,34,79,113
649260000,1655660000,195080000,2.5e+09,34,72,106
217830000,2061840000,220330000,2.5e+09,34,68,102
788380000,1402180000,309440000,2.5e+09,36,72,108
743540000,1417980000,338480000,2.5e+09,38,74,112
552540000,1692020000,255440000,2.5e+09,30,63,93
324070000,1895270000,280660000,2.5e+09,33,71,104
504120000,1791320000,204560000,2.5e+09,32,67,99
216930000,1508320000,774750000,2.5e+09,40,75,115
142190000,2024170000,333640000,2.5e+09,36,68,104
388770000,1069500000,1041730000,2.5e+09,38,70,108
478330000,952950000,1068720000,2.5e+09,38,72,110
61750000,1315680000,1122570000,2.5e+09,40,92,132
51660000,1524720000,923620000,2.5e+09,37,72,109
97840000,1262810000,1139350000,2.5e+09,41,99,140
26330000,102840000,2065080000,2194250000,42,76,118
49590000,1145740000,1304670000,2.5e+09,45,97,142
701700000,1348660000,449640000,2.5e+09,38,83,121
1110530000,1166090000,223380000,2.5e+09,31,69,100
1038580000,1035250000,426170000,2.5e+09,34,62,96
884940000,840260000,774800000,2.5e+09,28,58,86
536950000,1263930000,699120000,2.5e+09,37,79,116
464810000,1630430000,404760000,2.5e+09,43,78,121
743180000,1054930000,701890000,2.5e+09,38,75,113
885510000,1119740000,494750000,2.5e+09,42,75,117
629750000,1170110000,700140000,2.5e+09,33,66,99
1359770000,402180000,738050000,2.5e+09,36,69,105
1115020000,673160000,711820000,2.5e+09,32,57,89
1155170000,692010000,652820000,2.5e+09,34,63,97
358030000,924580000,1217390000,2.5e+09,35,85,120
487090000,1186940000,825970000,2.5e+09,41,93,134
240360000,1247180000,1012460000,2.5e+09,44,83,127
40010000,337890000,2122100000,2.5e+09,47,96,143
210600000,1143490000,1145910000,2.5e+09,46,93,139
7e+08,525300000,1274700000,2.5e+09,46,94,140
282880000,1295390000,921730000,2.5e+09,42,94,136
14670000,355860000,2129470000,2.5e+09,39,80,119
72780000,407990000,2019230000,2.5e+09,40,88,128
36720000,134710000,2328570000,2.5e+09,41,91,132
241260000,917970000,1340770000,2.5e+09,47,101,148
4460000,178220000,2315640000,2498320000,39,87,126
729790000,810290000,959920000,2.5e+09,34,69,103
975380000,623670000,900950000,2.5e+09,35,65,100
108100000,282300000,1992080000,2382480000,22,70,92
32610000,129250000,2266090000,2427950000,29,68,97
0,15670000,1463900000,1479570000,23,48,71
759080000,261390000,1479530000,2.5e+09,25,76,101
349430000,587950000,1562620000,2.5e+09,34,90,124
660700000,138190000,1701110000,2.5e+09,26,72,98
513630000,215760000,1770610000,2.5e+09,27,74,101
609610000,86340000,1804050000,2.5e+09,20,73,93
1168520000,416040000,915440000,2.5e+09,34,69,103
695800000,269280000,1534920000,2.5e+09,24,79,103
193230000,88850000,2217920000,2.5e+09,21,63,84
553710000,127030000,1819260000,2.5e+09,19,73,92
640000,19720000,1742450000,1762810000,20,66,86
414420000,238640000,1846940000,2.5e+09,32,72,104
1040180000,493340000,966480000,2.5e+09,38,75,113
1238490000,549960000,711550000,2.5e+09,29,68,97
425610000,90270000,1984120000,2.5e+09,25,57,82
907330000,440130000,1152540000,2.5e+09,34,69,103
1014620000,225930000,1259450000,2.5e+09,35,67,102
1310080000,64310000,1125610000,2.5e+09,27,64,91
751150000,186960000,1561890000,2.5e+09,32,70,102
1155640000,124580000,1219780000,2.5e+09,26,62,88
69600000,25090000,1805130000,1899820000,27,62,89
832480000,39240000,1628280000,2.5e+09,24,57,81
636190000,58860000,1804950000,2.5e+09,23,55,78
660220000,1211800000,627980000,2.5e+09,29,76,105
913430000,998440000,588130000,2.5e+09,29,70,99
679890000,72440000,1747670000,2.5e+09,30,63,93
573650000,56500000,1869850000,2.5e+09,26,58,84
560470000,129780000,1809750000,2.5e+09,28,58,86
641600000,281420000,1576980000,2.5e+09,26,59,85
640210000,1210870000,648920000,2.5e+09,46,81,127
980110000,217910000,1301980000,2.5e+09,42,76,118
646080000,670430000,1183490000,2.5e+09,39,70,109
595110000,174580000,1730310000,2.5e+09,36,62,98
1209080000,606010000,684910000,2.5e+09,33,74,107
983190000,579200000,937610000,2.5e+09,37,62,99
846320000,1118110000,535570000,2.5e+09,40,86,126
933110000,992900000,573990000,2.5e+09,41,79,120
944110000,269240000,1286650000,2.5e+09,27,60,87
517880000,1795080000,187040000,2.5e+09,27,63,90
1064310000,1190360000,245330000,2.5e+09,27,54,81
190850000,2074520000,234630000,2.5e+09,31,73,104
935320000,478700000,1085980000,2.5e+09,26,51,77
1041540000,82170000,1376290000,2.5e+09,25,55,80
396060000,1708930000,395010000,2.5e+09,37,80,117
1110260000,485770000,903970000,2.5e+09,34,80,114
183600000,1961030000,355370000,2.5e+09,37,72,109
724880000,182280000,1592840000,2.5e+09,33,64,97
594390000,61630000,1843980000,2.5e+09,28,60,88
402410000,27610000,2069980000,2.5e+09,31,58,89
1270130000,78660000,1151210000,2.5e+09,32,71,103
1301920000,503400000,694680000,2.5e+09,35,73,108
794460000,1120330000,585210000,2.5e+09,40,68,108
842490000,1061330000,596180000,2.5e+09,38,74,112
714450000,680780000,1104770000,2.5e+09,41,80,121
6.29e+08,238150000,1589850000,2.457e+09,32,65,97
597670000,1616530000,285800000,2.5e+09,38,79,117
1550980000,281200000,667820000,2.5e+09,23,54,77
243830000,1966070000,290100000,2.5e+09,37,72,109
1606910000,654120000,238970000,2.5e+09,24,52,76
1024410000,578300000,897290000,2.5e+09,39,75,114
34550000,1713660000,751790000,2.5e+09,35,66,101
1239530000,447660000,812810000,2.5e+09,36,74,110
37280000,2119880000,342840000,2.5e+09,32,64,96
690020000,57130000,1752850000,2.5e+09,31,59,90
1031840000,98560000,1369600000,2.5e+09,33,64,97
400140000,8950000,2090910000,2.5e+09,27,53,80
783390000,121970000,1594640000,2.5e+09,38,60,98
480140000,921750000,1098110000,2.5e+09,38,83,121
878650000,236710000,1384640000,2.5e+09,38,66,104
798640000,60840000,1640520000,2.5e+09,41,74,115
853310000,27900000,1618790000,2.5e+09,33,57,90
501390000,542470000,1456140000,2.5e+09,25,58,83
1216750000,996140000,287110000,2.5e+09,24,52,76
409460000,1089130000,1001410000,2.5e+09,34,63,97
1541900000,612110000,345990000,2.5e+09,37,78,115
536460000,1284280000,679260000,2.5e+09,33,71,104
1343560000,826630000,329810000,2.5e+09,30,67,97
893740000,1404890000,201370000,2.5e+09,26,56,82
44820000,2109150000,346030000,2.5e+09,37,68,105
803680000,1391890000,304430000,2.5e+09,30,66,96
18500000,2292360000,189140000,2.5e+09,33,65,98
483710000,1619160000,397130000,2.5e+09,32,78,110
1428450000,266610000,804940000,2.5e+09,31,60,91
94710000,1807480000,597810000,2.5e+09,36,72,108
1412780000,471920000,615300000,2.5e+09,32,63,95
216350000,1928740000,354910000,2.5e+09,31,57,88
551600000,83850000,1864550000,2.5e+09,31,58,89
1087540000,200940000,1211520000,2.5e+09,32,62,94
1528790000,402640000,568570000,2.5e+09,34,64,98
986300000,3360000,1510340000,2.5e+09,36,67,103
841060000,2.1e+07,1637940000,2.5e+09,30,49,79
1280930000,11660000,1207410000,2.5e+09,37,70,107
850970000,74050000,1574980000,2.5e+09,34,56,90
204720000,872360000,1338080000,2415160000,32,64,96
575720000,1643750000,280530000,2.5e+09,27,61,88
728890000,1435370000,335740000,2.5e+09,27,62,89
1473480000,824930000,201590000,2.5e+09,21,53,74
1292470000,924620000,282910000,2.5e+09,29,65,94
9930000,2292730000,197340000,2.5e+09,33,55,88
67570000,2184610000,247820000,2.5e+09,33,75,108
828810000,1162140000,509050000,2.5e+09,34,63,97
116080000,2033440000,350480000,2.5e+09,25,52,77
1175420000,81250000,1243330000,2.5e+09,30,56,86
1394590000,207740000,897670000,2.5e+09,32,66,98
1415590000,43110000,1041300000,2.5e+09,39,69,108
680840000,14600000,1804560000,2.5e+09,24,44,68
1074340000,252850000,1172810000,2.5e+09,32,61,93
969480000,745490000,785030000,2.5e+09,33,55,88
1156350000,752920000,590730000,2.5e+09,35,59,94
1264620000,588790000,646590000,2.5e+09,29,56,85
276810000,1327810000,895380000,2.5e+09,42,78,120
640730000,958310000,900960000,2.5e+09,40,77,117
692870000,252330000,1554800000,2.5e+09,34,68,102
793160000,413980000,1292860000,2.5e+09,38,67,105
214440000,1127880000,1157680000,2.5e+09,43,98,141
283850000,1175320000,1040830000,2.5e+09,35,88,123
255720000,1658200000,586080000,2.5e+09,32,76,108
446520000,934250000,1119230000,2.5e+09,32,71,103
263940000,715570000,1520490000,2.5e+09,46,98,144
205840000,610980000,1683180000,2.5e+09,44,98,142
166910000,1707590000,625500000,2.5e+09,40,87,127
365600000,1534670000,599730000,2.5e+09,35,82,117
15230000,436570000,2048200000,2.5e+09,45,94,139
22180000,601810000,1876010000,2.5e+09,39,86,125
964370000,806040000,729590000,2.5e+09,39,76,115
1468510000,411360000,620130000,2.5e+09,31,58,89
1327370000,752710000,419920000,2.5e+09,34,66,100
1067810000,1.002e+09,430190000,2.5e+09,39,79,118
806860000,855670000,837470000,2.5e+09,38,72,110
467430000,1280980000,751590000,2.5e+09,37,79,116
956170000,459100000,1084730000,2.5e+09,32,55,87
922820000,792310000,784870000,2.5e+09,37,66,103
1136900000,647150000,715950000,2.5e+09,34,57,91
683540000,1293670000,522790000,2.5e+09,37,69,106
859130000,905500000,735370000,2.5e+09,38,84,122
789370000,822960000,887670000,2.5e+09,39,79,118
1288110000,140890000,1.071e+09,2.5e+09,32,57,89
1264570000,62770000,1172660000,2.5e+09,32,62,94
1222410000,375670000,901920000,2.5e+09,33,57,90
1125080000,523750000,851170000,2.5e+09,38,67,105
318550000,1485600000,695850000,2.5e+09,36,73,109
264370000,1628380000,607250000,2.5e+09,36,72,108
354230000,1293010000,852760000,2.5e+09,38,72,110
661100000,1125350000,713550000,2.5e+09,36,71,107
269150000,1348830000,882020000,2.5e+09,38,79,117
303880000,1820060000,376060000,2.5e+09,36,84,120
232610000,1069780000,1197610000,2.5e+09,37,81,118
212030000,1713210000,574760000,2.5e+09,36,81,117
127890000,505330000,1866780000,2.5e+09,36,81,117
28320000,298730000,2172950000,2.5e+09,38,87,125
204620000,470980000,1824400000,2.5e+09,37,86,123
35070000,631080000,1833850000,2.5e+09,39,95,134
32010000,4790000,1470490000,1507290000,27,63,90
180130000,1746720000,573150000,2.5e+09,38,88,126
39690000,967930000,1492380000,2.5e+09,35,85,120
1029850000,810560000,659590000,2.5e+09,42,77,119
1351690000,405250000,743060000,2.5e+09,35,68,103
1238160000,675910000,585930000,2.5e+09,36,60,96
1080860000,450890000,968250000,2.5e+09,32,61,93
1300710000,713230000,486060000,2.5e+09,35,60,95
1127600000,877270000,495130000,2.5e+09,40,78,118
883170000,812090000,804740000,2.5e+09,42,81,123
1004760000,918320000,576920000,2.5e+09,36,71,107
1211980000,368600000,919420000,2.5e+09,33,62,95
1407410000,542010000,550580000,2.5e+09,32,61,93
1085970000,742850000,671180000,2.5e+09,37,60,97
566870000,1534910000,398220000,2.5e+09,37,68,105
955100000,922870000,622030000,2.5e+09,36,68,104
1059450000,707110000,733440000,2.5e+09,32,56,88
974220000,963370000,562410000,2.5e+09,41,64,105
1001140000,600140000,898720000,2.5e+09,39,67,106
749020000,1307250000,443730000,2.5e+09,34,71,105
984680000,1010610000,504710000,2.5e+09,36,61,97
532150000,1502560000,465290000,2.5e+09,41,75,116
908530000,1112960000,478510000,2.5e+09,38,68,106
476110000,1209880000,814010000,2.5e+09,36,76,112
530840000,1250530000,718630000,2.5e+09,39,85,124
1231720000,754020000,514260000,2.5e+09,39,72,111
887240000,1007720000,605040000,2.5e+09,41,82,123
160830000,942900000,1396270000,2.5e+09,40,82,122
257620000,1150380000,1.092e+09,2.5e+09,39,85,124
340200000,1237640000,922160000,2.5e+09,36,81,117
456670000,738670000,1304660000,2.5e+09,40,86,126
147200000,1516480000,836320000,2.5e+09,35,80,115
152640000,1039260000,1308100000,2.5e+09,40,88,128
31540000,505340000,1963120000,2.5e+09,35,83,118
172310000,980360000,1347330000,2.5e+09,40,85,125
198830000,1818670000,482500000,2.5e+09,34,76,110
90200000,1672980000,736820000,2.5e+09,36,80,116
71080000,758850000,1670070000,2.5e+09,35,78,113
924050000,726400000,849550000,2.5e+09,32,63,95
894270000,895140000,710590000,2.5e+09,38,70,108
794200000,1063030000,642770000,2.5e+09,37,76,113
674350000,822520000,1003130000,2.5e+09,39,67,106
990520000,1126850000,382630000,2.5e+09,32,56,88
796390000,1030520000,673090000,2.5e+09,32,67,99
556370000,1586080000,357550000,2.5e+09,33,56,89
923410000,705260000,871330000,2.5e+09,34,62,96
987320000,972950000,539730000,2.5e+09,40,70,110
1003420000,974470000,522110000,2.5e+09,40,79,119
1110350000,680680000,708970000,2.5e+09,36,61,97
1104810000,694970000,700220000,2.5e+09,39,69,108
397850000,1757560000,344590000,2.5e+09,40,74,114
1170090000,648810000,681100000,2.5e+09,38,67,105
327990000,1832170000,339840000,2.5e+09,42,80,122
1052370000,896820000,550810000,2.5e+09,40,67,107
387090000,1676860000,436050000,2.5e+09,40,71,111
1304160000,748530000,447310000,2.5e+09,41,72,113
248220000,1736240000,515540000,2.5e+09,45,79,124
261390000,1836180000,402430000,2.5e+09,45,83,128
777340000,1308020000,414640000,2.5e+09,41,76,117
676480000,1190880000,632640000,2.5e+09,42,77,119
682640000,1116580000,700780000,2.5e+09,42,84,126
733430000,1157540000,609030000,2.5e+09,44,84,128
214660000,1254410000,1030930000,2.5e+09,39,85,124
642520000,1178310000,679170000,2.5e+09,42,84,126
323390000,1351510000,825100000,2.5e+09,44,86,130
694180000,1147540000,658280000,2.5e+09,38,78,116
98180000,671680000,1730140000,2.5e+09,39,82,121
13100000,72780000,2414120000,2.5e+09,31,59,90
649260000,1215730000,635010000,2.5e+09,37,64,101
620120000,678750000,1201130000,2.5e+09,40,74,114
507820000,1505190000,486990000,2.5e+09,34,65,99
777180000,541720000,1181100000,2.5e+09,42,80,122
752940000,1057330000,689730000,2.5e+09,33,65,98
747380000,1133410000,619210000,2.5e+09,39,78,117
1098130000,715280000,686590000,2.5e+09,36,71,107
907070000,1189870000,403060000,2.5e+09,37,79,116
416480000,1641940000,441580000,2.5e+09,37,73,110
762960000,633690000,1103350000,2.5e+09,42,71,113
1262090000,118760000,1119150000,2.5e+09,29,69,98
308070000,63710000,1742820000,2114600000,34,74,108
210500000,26710000,2262790000,2.5e+09,21,58,79
265160000,30460000,2204380000,2.5e+09,20,46,66
383690000,1.9e+07,2097310000,2.5e+09,16,51,67
606570000,70190000,1823240000,2.5e+09,26,63,89
670290000,110220000,1719490000,2.5e+09,14,57,71
718380000,129570000,1652050000,2.5e+09,13,57,70
43040000,83950000,2178920000,2305910000,17,49,66
652630000,147160000,1700210000,2.5e+09,21,60,81
8020000,68250000,1436430000,1512700000,28,66,94
105770000,1436530000,957700000,2.5e+09,34,82,116
222050000,1818210000,459740000,2.5e+09,30,75,105
1968860000,135570000,395570000,2.5e+09,29,70,99
566180000,51510000,1647090000,2264780000,32,70,102
1381980000,114950000,1003070000,2.5e+09,32,81,113
38630000,5380000,1054940000,1098950000,18,41,59
1128660000,35670000,1335670000,2.5e+09,20,49,69
1078440000,23910000,1397650000,2.5e+09,18,47,65
1724200000,57340000,718460000,2.5e+09,27,59,86
1982860000,30920000,486220000,2.5e+09,26,55,81
567120000,22190000,1910690000,2.5e+09,15,57,72
1146720000,51540000,1301740000,2.5e+09,22,65,87
583630000,46890000,1869480000,2.5e+09,18,54,72
400680000,82100000,2017220000,2.5e+09,19,54,73
1077190000,127230000,1295580000,2.5e+09,26,65,91
429670000,98220000,1972110000,2.5e+09,18,56,74
688480000,271630000,1539890000,2.5e+09,23,74,97
617480000,99070000,1783450000,2.5e+09,24,62,86
826390000,146600000,1527010000,2.5e+09,29,73,102
272410000,50790000,2176800000,2.5e+09,17,48,65
551760000,95740000,1852500000,2.5e+09,25,75,100
152900000,1703390000,643710000,2.5e+09,31,81,112
4.34e+08,1621480000,444520000,2.5e+09,29,78,107
200640000,1324940000,974420000,2.5e+09,32,79,111
192750000,1326190000,981060000,2.5e+09,32,78,110
100920000,1144010000,1255070000,2.5e+09,34,87,121
109420000,1193370000,1197210000,2.5e+09,37,79,116
24420000,910000,1034960000,1060290000,15,29,44
1842920000,221370000,435710000,2.5e+09,33,74,107
1145350000,61760000,1280700000,2487810000,31,82,113
776810000,552920000,1170270000,2.5e+09,39,84,123
76930000,72320000,1712390000,1861640000,29,61,90
1705560000,96110000,698330000,2.5e+09,19,55,74
1823960000,176220000,499820000,2.5e+09,33,75,108
1576720000,328880000,594400000,2.5e+09,33,77,110
1293810000,383590000,822600000,2.5e+09,33,81,114
985690000,138840000,1375470000,2.5e+09,25,58,83
1466770000,93490000,939740000,2.5e+09,22,53,75
1186140000,360780000,953080000,2.5e+09,36,80,116
1270100000,361550000,868350000,2.5e+09,30,72,102
562990000,116090000,1820920000,2.5e+09,23,67,90
1105580000,138590000,1255830000,2.5e+09,28,76,104
1054430000,116720000,1328850000,2.5e+09,24,63,87
650470000,152580000,1696950000,2.5e+09,25,78,103
367460000,87210000,2045330000,2.5e+09,25,72,97
769750000,151120000,1579130000,2.5e+09,27,72,99
708870000,102100000,1689030000,2.5e+09,25,72,97
169700000,181010000,2149290000,2.5e+09,26,74,100
884890000,234800000,1380310000,2.5e+09,34,83,117
803980000,194620000,1501400000,2.5e+09,26,71,97
802550000,370130000,1327320000,2.5e+09,33,86,119
47800000,212970000,1963460000,2224230000,26,58,84
56380000,196370000,2210960000,2463710000,28,69,97
1106740000,416820000,976440000,2.5e+09,41,89,130
497720000,269980000,1719130000,2486830000,40,85,125
1310580000,600840000,588580000,2.5e+09,38,85,123
892930000,204960000,1402110000,2.5e+09,35,81,116
1827770000,156840000,515390000,2.5e+09,33,65,98
1792380000,3.44e+08,363620000,2.5e+09,31,70,101
1.282e+09,702750000,515250000,2.5e+09,31,74,105
1485930000,572130000,441940000,2.5e+09,35,82,117
1403140000,115130000,981730000,2.5e+09,27,78,105
1273730000,404060000,822210000,2.5e+09,34,83,117
984550000,39410000,1476040000,2.5e+09,27,65,92
1484930000,29750000,985320000,2.5e+09,20,68,88
552550000,90260000,1857190000,2.5e+09,23,66,89
950920000,115990000,1433090000,2.5e+09,25,70,95
629070000,489730000,1381200000,2.5e+09,33,86,119
624900000,147020000,1728080000,2.5e+09,29,76,105
53310000,14980000,2377420000,2445710000,12,48,60
448360000,49270000,2002370000,2.5e+09,20,70,90
734460000,173720000,1591820000,2.5e+09,20,61,81
1089910000,229300000,1180790000,2.5e+09,27,70,97
242530000,53230000,2204240000,2.5e+09,16,51,67
340980000,414640000,1743110000,2498730000,24,49,73
541710000,336020000,1456070000,2333800000,22,36,58
265500000,255450000,1714810000,2235760000,20,37,57
1045640000,415830000,1038530000,2.5e+09,23,50,73
784890000,791750000,923360000,2.5e+09,16,35,51
827240000,1193430000,479330000,2.5e+09,26,60,86
1353660000,783320000,363020000,2.5e+09,24,51,75
193080000,1060360000,1246560000,2.5e+09,27,48,75
451610000,1765220000,283170000,2.5e+09,29,57,86
69130000,700600000,1689360000,2459090000,27,60,87
705190000,1410250000,384560000,2.5e+09,24,59,83
725910000,1592440000,181650000,2.5e+09,24,54,78
481230000,1564240000,454530000,2.5e+09,30,64,94
1238460000,892460000,369080000,2.5e+09,23,50,73
18440000,345760000,1936580000,2300780000,38,70,108
36860000,1199530000,1263610000,2.5e+09,37,73,110
348410000,1740180000,411410000,2.5e+09,31,66,97
8390000,1114030000,1377580000,2.5e+09,34,66,100
74290000,764520000,1575780000,2414590000,23,42,65
352620000,745790000,1401590000,2.5e+09,21,42,63
1163150000,997550000,339300000,2.5e+09,26,55,81
584210000,1469330000,446460000,2.5e+09,23,52,75
616170000,694140000,1189690000,2.5e+09,24,52,76
1004160000,977020000,518820000,2.5e+09,23,52,75
907690000,1164570000,427740000,2.5e+09,27,56,83
1231250000,798090000,470660000,2.5e+09,24,55,79
337490000,1799530000,362980000,2.5e+09,24,54,78
1137290000,689480000,673230000,2.5e+09,24,49,73
41310000,724320000,1516110000,2281740000,23,54,77
648860000,1510710000,340430000,2.5e+09,26,55,81
35690000,2026440000,437870000,2.5e+09,35,80,115
267740000,1101210000,1131050000,2.5e+09,41,93,134
159640000,282030000,1722820000,2164490000,34,68,102
1344560000,71200000,1084240000,2.5e+09,29,50,79
1329850000,515690000,654460000,2.5e+09,39,71,110
1524580000,183190000,792230000,2.5e+09,32,62,94
1332070000,547030000,620900000,2.5e+09,38,69,107
1447230000,15280000,1037490000,2.5e+09,34,58,92
720170000,10860000,1768970000,2.5e+09,30,53,83
1413060000,16730000,1070210000,2.5e+09,34,62,96
991320000,7930000,1500750000,2.5e+09,27,51,78
45920000,220230000,1907700000,2173850000,22,39,61
750580000,1299360000,450060000,2.5e+09,25,64,89
762160000,1177710000,560130000,2.5e+09,24,48,72
473080000,1431420000,595500000,2.5e+09,26,57,83
1219970000,496620000,783410000,2.5e+09,23,50,73
52680000,710660000,1519980000,2283320000,21,51,72
505630000,1741450000,252920000,2.5e+09,27,55,82
13540000,180320000,1356600000,1550460000,18,38,56
57550000,890800000,1359040000,2307390000,20,39,59
418830000,125340000,1955830000,2.5e+09,25,59,84
1532740000,485950000,481310000,2.5e+09,43,84,127
1369870000,543220000,586910000,2.5e+09,42,89,131
1635300000,494930000,369770000,2.5e+09,44,88,132
1801770000,80300000,617930000,2.5e+09,29,67,96
1465620000,333710000,700670000,2.5e+09,36,66,102
1675880000,317490000,506630000,2.5e+09,33,65,98
1373870000,623800000,502330000,2.5e+09,38,64,102
1585150000,477370000,437480000,2.5e+09,39,80,119
1411150000,18600000,1070250000,2.5e+09,31,57,88
1251960000,53590000,1194450000,2.5e+09,25,50,75
1759600000,10470000,729930000,2.5e+09,33,59,92
1535670000,154350000,809980000,2.5e+09,35,60,95
980560000,1079210000,440230000,2.5e+09,27,59,86
1121870000,911160000,466970000,2.5e+09,29,55,84
236810000,2124850000,138340000,2.5e+09,24,39,63
771090000,1371290000,357620000,2.5e+09,27,56,83
8550000,1999790000,491660000,2.5e+09,26,55,81
379330000,1964080000,156590000,2.5e+09,22,44,66
65220000,1748290000,686490000,2.5e+09,25,53,78
546460000,560720000,1392820000,2.5e+09,26,52,78
113990000,485980000,1900030000,2.5e+09,30,62,92
380550000,545860000,1573590000,2.5e+09,30,61,91
1661730000,334760000,503510000,2.5e+09,25,49,74
1368060000,903600000,228340000,2.5e+09,39,74,113
1461750000,628480000,409770000,2.5e+09,33,67,100
699520000,1130120000,670360000,2.5e+09,37,67,104
1.002e+09,939930000,558070000,2.5e+09,31,58,89
1406180000,660310000,433510000,2.5e+09,39,68,107
1269430000,894900000,335670000,2.5e+09,39,77,116
784740000,1514270000,200990000,2.5e+09,40,77,117
854970000,1263790000,381240000,2.5e+09,43,86,129
1879650000,44750000,575600000,2.5e+09,29,55,84
1481500000,364600000,653900000,2.5e+09,37,63,100
1536440000,544800000,418760000,2.5e+09,32,62,94
996100000,1290410000,213490000,2.5e+09,37,71,108
378680000,1706240000,415080000,2.5e+09,34,55,89
62630000,780800000,1641210000,2484640000,28,38,66
132650000,1940250000,427100000,2.5e+09,28,43,71
195530000,1873440000,431030000,2.5e+09,26,38,64
406370000,248240000,1845390000,2.5e+09,24,54,78
558110000,457040000,1484850000,2.5e+09,31,56,87
1199030000,954200000,346770000,2.5e+09,27,57,84
1677690000,270440000,551870000,2.5e+09,23,40,63
978130000,1363680000,158190000,2.5e+09,33,66,99
704170000,1361440000,434390000,2.5e+09,35,58,93
796040000,983290000,720670000,2.5e+09,35,69,104
857100000,1228190000,414710000,2.5e+09,33,72,105
1102070000,888360000,509570000,2.5e+09,34,66,100
1001090000,1081520000,417390000,2.5e+09,37,74,111
656820000,1352140000,491040000,2.5e+09,36,70,106
648140000,964160000,887700000,2.5e+09,40,90,130
834930000,1123650000,541420000,2.5e+09,37,71,108
634850000,1333050000,532100000,2.5e+09,43,94,137
737350000,1478290000,284360000,2.5e+09,38,68,106
355140000,1678380000,466480000,2.5e+09,41,83,124
627450000,1.349e+09,523550000,2.5e+09,36,67,103
628980000,1251470000,619550000,2.5e+09,46,87,133
276940000,579830000,1643230000,2.5e+09,28,81,109
1013320000,310780000,1175900000,2.5e+09,28,65,93
967500000,1308240000,224260000,2.5e+09,26,45,71
1521030000,537750000,441220000,2.5e+09,20,38,58
643310000,1448220000,408470000,2.5e+09,35,69,104
1077270000,1059650000,363080000,2.5e+09,36,70,106
440600000,1598380000,461020000,2.5e+09,40,75,115
780220000,1278020000,441760000,2.5e+09,37,63,100
402720000,1702470000,394810000,2.5e+09,43,80,123
727620000,924260000,848120000,2.5e+09,38,78,116
291110000,426020000,1782870000,2.5e+09,38,76,114
234220000,1016020000,1249760000,2.5e+09,45,90,135
77750000,1121030000,1301220000,2.5e+09,38,90,128
2570000,343850000,1756860000,2103280000,29,67,96
481590000,1598240000,420170000,2.5e+09,36,62,98
644060000,840360000,1015580000,2.5e+09,41,78,119
563470000,1282630000,653900000,2.5e+09,40,70,110
783720000,910570000,805710000,2.5e+09,40,68,108
1124670000,677650000,697680000,2.5e+09,45,81,126
651060000,1225110000,623830000,2.5e+09,43,78,121
824080000,1070640000,605280000,2.5e+09,41,70,111
1414200000,109140000,976660000,2.5e+09,35,63,98
1249270000,505120000,745610000,2.5e+09,44,79,123
1130730000,681330000,687940000,2.5e+09,43,78,121
739140000,909360000,851500000,2.5e+09,44,84,128
921180000,1188830000,389990000,2.5e+09,40,73,113
449400000,1293200000,757400000,2.5e+09,39,77,116
309600000,1728750000,461650000,2.5e+09,41,77,118
745250000,855620000,899130000,2.5e+09,37,70,107
1084270000,932670000,483060000,2.5e+09,39,74,113
1032440000,852640000,614920000,2.5e+09,40,79,119
849860000,1131160000,518980000,2.5e+09,47,78,125
1182250000,680050000,637700000,2.5e+09,42,77,119
582900000,587070000,1330030000,2.5e+09,41,85,126
369660000,1428180000,702160000,2.5e+09,39,77,116
643140000,1134480000,722380000,2.5e+09,41,77,118
309990000,1563920000,626090000,2.5e+09,41,84,125
807070000,1081140000,611790000,2.5e+09,42,80,122
90440000,105480000,2113280000,2309200000,31,73,104
435700000,836690000,1227610000,2.5e+09,38,90,128
18410000,399790000,1423480000,1841680000,29,66,95
975490000,722320000,802190000,2.5e+09,39,64,103
582280000,1428500000,489220000,2.5e+09,43,68,111
1211520000,864940000,423540000,2.5e+09,35,63,98
839790000,1068090000,592120000,2.5e+09,40,70,110
766350000,1287300000,446350000,2.5e+09,46,88,134
1156960000,594180000,748860000,2.5e+09,49,92,141
707480000,1432960000,359560000,2.5e+09,41,79,120
948640000,915730000,635630000,2.5e+09,49,93,142
416980000,1791730000,291290000,2.5e+09,44,81,125
1144790000,968020000,387190000,2.5e+09,42,78,120
525890000,1606570000,367540000,2.5e+09,43,77,120
687550000,1273670000,538780000,2.5e+09,42,74,116
816030000,933170000,750800000,2.5e+09,42,78,120
1021450000,637360000,841190000,2.5e+09,40,80,120
802790000,983060000,714150000,2.5e+09,44,84,128
1075150000,676130000,748720000,2.5e+09,41,74,115
1297360000,570550000,632090000,2.5e+09,40,78,118
946720000,7.29e+08,824280000,2.5e+09,44,86,130
1490040000,594250000,415710000,2.5e+09,39,84,123
1.241e+09,584560000,674440000,2.5e+09,41,83,124
968050000,954140000,577810000,2.5e+09,46,87,133
913740000,964270000,621990000,2.5e+09,43,84,127
708290000,1325780000,465930000,2.5e+09,38,85,123
791520000,1245420000,463060000,2.5e+09,47,90,137
393540000,737660000,1368800000,2.5e+09,43,91,134
482550000,1426630000,590820000,2.5e+09,42,83,125
487020000,375540000,1637440000,2.5e+09,38,85,123
949280000,701200000,849520000,2.5e+09,43,85,128
27890000,40310000,1312320000,1380520000,34,70,104
306260000,485620000,1496140000,2288020000,35,81,116
1184390000,1114920000,200690000,2.5e+09,39,73,112
1165950000,879770000,454280000,2.5e+09,40,64,104
514690000,1751810000,233500000,2.5e+09,38,75,113
1360620000,586090000,553290000,2.5e+09,38,71,109
740190000,1454290000,305520000,2.5e+09,39,77,116
846850000,1394420000,258730000,2.5e+09,41,73,114
777900000,1414100000,3.08e+08,2.5e+09,44,78,122
648100000,1671860000,180040000,2.5e+09,43,87,130
552410000,1648970000,298620000,2.5e+09,47,83,130
598910000,1593680000,307410000,2.5e+09,43,82,125
727690000,1274720000,497590000,2.5e+09,42,83,125
661330000,1424610000,414060000,2.5e+09,45,81,126
1141720000,998910000,359370000,2.5e+09,36,78,114
1045930000,724970000,729100000,2.5e+09,42,73,115
596970000,1502470000,400560000,2.5e+09,39,80,119
926920000,881280000,691800000,2.5e+09,44,74,118
1422860000,739120000,338020000,2.5e+09,39,75,114
1230820000,898100000,371080000,2.5e+09,36,73,109
918880000,1105290000,475830000,2.5e+09,36,75,111
885510000,1153930000,460560000,2.5e+09,39,81,120
965230000,1187530000,347240000,2.5e+09,38,80,118
1257440000,778310000,464250000,2.5e+09,40,85,125
1588450000,559260000,352290000,2.5e+09,40,78,118
1199320000,1051280000,249400000,2.5e+09,38,79,117
773560000,1206140000,520300000,2.5e+09,37,83,120
741960000,1309430000,448610000,2.5e+09,37,82,119
1087640000,1054870000,357490000,2.5e+09,37,74,111
1244340000,807730000,447930000,2.5e+09,39,82,121
1062840000,1021350000,415810000,2.5e+09,37,83,120
455470000,392940000,1567130000,2415540000,38,83,121
1103760000,1033810000,362430000,2.5e+09,35,75,110
446640000,1789840000,263520000,2.5e+09,42,86,128
361850000,1544410000,593740000,2.5e+09,44,90,134
941890000,1266640000,291470000,2.5e+09,43,77,120
307580000,1730770000,461650000,2.5e+09,46,88,134
1045110000,1094210000,360680000,2.5e+09,41,72,113
326190000,1870520000,303290000,2.5e+09,45,94,139
592680000,1480780000,426540000,2.5e+09,45,95,140
786430000,1295070000,418500000,2.5e+09,46,91,137
1045930000,904470000,549600000,2.5e+09,44,78,122
921180000,1106970000,471850000,2.5e+09,41,81,122
602910000,1469760000,427330000,2.5e+09,48,81,129
700630000,863180000,936190000,2.5e+09,48,77,125
513130000,1454970000,531900000,2.5e+09,41,80,121
408770000,1834220000,257010000,2.5e+09,44,80,124
754660000,1310440000,434900000,2.5e+09,41,82,123
733390000,1418370000,348240000,2.5e+09,40,80,120
472420000,1600660000,426920000,2.5e+09,41,85,126
591120000,1523580000,385300000,2.5e+09,41,83,124
437790000,1726200000,336010000,2.5e+09,37,83,120
734250000,1350080000,415670000,2.5e+09,40,84,124
818650000,1191460000,489890000,2.5e+09,40,83,123
686500000,1294130000,519370000,2.5e+09,39,78,117
489850000,1503870000,506280000,2.5e+09,37,78,115
423180000,1797640000,279180000,2.5e+09,38,76,114
1381970000,733660000,384370000,2.5e+09,35,77,112
1146400000,1004440000,349160000,2.5e+09,40,76,116
1308090000,659170000,532740000,2.5e+09,38,80,118
614750000,1577220000,308030000,2.5e+09,36,77,113
531840000,1676900000,291260000,2.5e+09,40,75,115
86830000,2162830000,250340000,2.5e+09,44,81,125
156190000,482620000,1850480000,2489290000,36,76,112
891460000,677120000,931420000,2.5e+09,43,88,131
823970000,1057310000,618720000,2.5e+09,36,84,120
754140000,249480000,1496380000,2.5e+09,39,83,122
68680000,223550000,1901310000,2193540000,41,84,125
1827970000,279210000,392820000,2.5e+09,36,76,112
1723890000,416410000,359700000,2.5e+09,36,74,110
512640000,1264250000,723110000,2.5e+09,40,88,128
1606720000,559140000,334140000,2.5e+09,35,78,113
1678520000,327990000,493490000,2.5e+09,38,80,118
573350000,216250000,1710400000,2.5e+09,36,80,116
2031290000,80010000,388700000,2.5e+09,30,64,94
1849520000,206140000,444340000,2.5e+09,35,74,109
1584710000,13050000,902240000,2.5e+09,24,74,98
1941870000,21010000,537120000,2.5e+09,26,74,100
1341380000,15480000,1143140000,2.5e+09,28,74,102
674990000,11210000,1813800000,2.5e+09,20,61,81
861590000,7660000,1630750000,2.5e+09,26,70,96
1749780000,243850000,506370000,2.5e+09,32,81,113
1553200000,602760000,344040000,2.5e+09,36,88,124
1553780000,249390000,696830000,2.5e+09,34,81,115
1215810000,384870000,899320000,2.5e+09,43,95,138
1927420000,211260000,361320000,2.5e+09,32,79,111
1631100000,243060000,625840000,2.5e+09,33,82,115
1811430000,360630000,327940000,2.5e+09,36,79,115
1738250000,237720000,524030000,2.5e+09,34,80,114
1062820000,1111470000,325710000,2.5e+09,38,89,127
1484920000,648640000,366440000,2.5e+09,36,86,122
692870000,518010000,1289120000,2.5e+09,38,87,125
1257050000,374710000,868240000,2.5e+09,38,86,124
676320000,294220000,1529460000,2.5e+09,38,86,124
396340000,230140000,1873520000,2.5e+09,38,78,116
1734910000,322920000,442170000,2.5e+09,42,85,127
1494110000,291730000,714160000,2.5e+09,40,84,124
1821420000,60310000,618270000,2.5e+09,26,66,92
1869170000,195800000,435030000,2.5e+09,32,76,108
1876480000,14440000,609080000,2.5e+09,34,71,105
1930770000,40240000,528990000,2.5e+09,35,69,104
1802420000,26820000,670760000,2.5e+09,29,66,95
1763600000,28360000,708040000,2.5e+09,27,76,103
1863240000,63130000,573630000,2.5e+09,36,80,116
1493640000,3090000,1003270000,2.5e+09,20,58,78
1658450000,930000,840620000,2.5e+09,21,59,80
1687400000,16970000,795630000,2.5e+09,24,61,85
1717430000,280000,782290000,2.5e+09,17,58,75
1200820000,2760000,1296420000,2.5e+09,20,61,81
1587340000,8750000,903910000,2.5e+09,26,65,91
1675540000,163180000,661280000,2.5e+09,31,65,96
1704180000,23550000,772270000,2.5e+09,25,67,92
1650980000,65240000,783780000,2.5e+09,31,74,105
2009820000,158960000,331220000,2.5e+09,27,74,101
778870000,175930000,1545130000,2499930000,43,98,141
204290000,393420000,1900860000,2498570000,42,100,142
1973960000,264810000,261230000,2.5e+09,32,77,109
2.055e+09,122390000,322610000,2.5e+09,33,78,111
1976500000,180640000,342860000,2.5e+09,38,85,123
1669970000,193220000,636810000,2.5e+09,35,85,120
1009490000,1076010000,414500000,2.5e+09,38,89,127
1869470000,211590000,418940000,2.5e+09,35,80,115
818750000,477560000,1203690000,2.5e+09,38,91,129
1023020000,888930000,588050000,2.5e+09,42,87,129
1842220000,337160000,320620000,2.5e+09,33,82,115
1134200000,769820000,595980000,2.5e+09,43,82,125
1499220000,499680000,501100000,2.5e+09,38,86,124
1850240000,200880000,448880000,2.5e+09,38,83,121
1837730000,220080000,442190000,2.5e+09,33,80,113
1666110000,428600000,405290000,2.5e+09,34,85,119
1208750000,735010000,556240000,2.5e+09,42,89,131
1893960000,43760000,562280000,2.5e+09,29,73,102
1790190000,158690000,551120000,2.5e+09,35,78,113
1818020000,154460000,527520000,2.5e+09,35,79,114
1763640000,38700000,697660000,2.5e+09,29,64,93
1800840000,36250000,662910000,2.5e+09,34,74,108
1868380000,102600000,529020000,2.5e+09,35,76,111
1908060000,223160000,368780000,2.5e+09,36,79,115
1805820000,27070000,667110000,2.5e+09,23,59,82
1798940000,32660000,668400000,2.5e+09,30,63,93
1888550000,56420000,555030000,2.5e+09,25,63,88
1767690000,93450000,638860000,2.5e+09,30,67,97
1447050000,39990000,1012960000,2.5e+09,29,70,99
1735330000,47470000,717200000,2.5e+09,29,64,93
1611180000,36330000,852490000,2.5e+09,18,51,69
1962160000,71470000,466370000,2.5e+09,23,60,83
109630000,81420000,2293590000,2484640000,38,88,126
1167480000,513680000,818840000,2.5e+09,39,85,124
1114620000,590400000,794980000,2.5e+09,41,93,134
925470000,314030000,1260500000,2.5e+09,35,85,120
357170000,111220000,1961090000,2429480000,37,88,125
1490020000,5.43e+08,466980000,2.5e+09,40,92,132
1031920000,1069900000,398180000,2.5e+09,41,89,130
456260000,14490000,1757610000,2228360000,36,78,114
1123560000,101460000,1274980000,2.5e+09,43,96,139
891540000,93950000,1514510000,2.5e+09,39,88,127
522640000,45560000,1892330000,2460530000,38,84,122
1929070000,111940000,458990000,2.5e+09,34,82,116
1292110000,185460000,1022430000,2.5e+09,41,91,132
1691890000,18800000,789310000,2.5e+09,17,52,69
1872590000,110160000,517250000,2.5e+09,30,73,103
772070000,102910000,1625020000,2.5e+09,20,57,77
778310000,74540000,1647150000,2.5e+09,20,60,80
314120000,120450000,2065430000,2.5e+09,16,56,72
647960000,70510000,1781530000,2.5e+09,16,53,69
171540000,112860000,2215600000,2.5e+09,20,70,90
777570000,22560000,1699870000,2.5e+09,22,60,82
499010000,13540000,1987450000,2.5e+09,22,62,84
1118180000,5570000,1376250000,2.5e+09,20,55,75
1306910000,4370000,1188720000,2.5e+09,26,69,95
782120000,31470000,1686410000,2.5e+09,13,48,61
813150000,21290000,1665560000,2.5e+09,15,50,65
501700000,6350000,1991950000,2.5e+09,16,62,78
317120000,46320000,2136560000,2.5e+09,20,56,76
776980000,144070000,1578950000,2.5e+09,28,69,97
640110000,29650000,1830240000,2.5e+09,27,60,87
171440000,32040000,2118060000,2321540000,23,66,89
268210000,56210000,2175580000,2.5e+09,21,65,86
561970000,54830000,1883200000,2.5e+09,22,60,82
1459470000,8160000,1032370000,2.5e+09,20,61,81
1686400000,30700000,782900000,2.5e+09,25,57,82
1369560000,27100000,1103340000,2.5e+09,27,73,100
1559760000,24210000,916030000,2.5e+09,28,60,88
1270680000,3950000,1225370000,2.5e+09,18,54,72
1435920000,3330000,1060750000,2.5e+09,22,60,82
1828470000,6820000,664710000,2.5e+09,20,54,74
1602790000,4980000,892230000,2.5e+09,23,64,87
148930000,1660000,2349410000,2.5e+09,14,49,63
355280000,460000,2144260000,2.5e+09,21,60,81
1120690000,0,1379310000,2.5e+09,19,47,66
609670000,28740000,1861590000,2.5e+09,24,70,94
483770000,30130000,1986100000,2.5e+09,18,53,71
675400000,60090000,1764510000,2.5e+09,14,50,64
622100000,48290000,1829610000,2.5e+09,18,62,80
453630000,37060000,2009310000,2.5e+09,14,52,66
761390000,127380000,1611230000,2.5e+09,21,66,87
1457570000,15980000,1026450000,2.5e+09,21,59,80
1592700000,19470000,887830000,2.5e+09,24,62,86
1434560000,19040000,1046400000,2.5e+09,22,57,79
263040000,0,2236960000,2.5e+09,13,53,66
1006040000,3e+05,1493660000,2.5e+09,13,40,53
792240000,71800000,1635960000,2.5e+09,11,44,55
119170000,250490000,2130340000,2.5e+09,22,41,63
130900000,438690000,1930410000,2.5e+09,35,68,103
477400000,681630000,1340970000,2.5e+09,27,48,75
105220000,618700000,1776080000,2.5e+09,29,65,94
1183190000,281070000,1035740000,2.5e+09,26,57,83
56870000,557200000,1885930000,2.5e+09,20,33,53
24260000,893750000,1581990000,2.5e+09,20,34,54
330770000,1033690000,1135540000,2.5e+09,20,40,60
221650000,1157330000,1121020000,2.5e+09,16,29,45
461250000,886360000,1152390000,2.5e+09,29,65,94
35260000,588260000,1876480000,2.5e+09,26,53,79
1303310000,305530000,891160000,2.5e+09,18,40,58
262930000,735460000,1501610000,2.5e+09,27,51,78
616920000,513390000,1369690000,2.5e+09,25,54,79
169070000,1400280000,930650000,2.5e+09,26,51,77
451330000,878040000,1170630000,2.5e+09,22,41,63
187880000,615780000,1696340000,2.5e+09,21,44,65
0,47470000,2009250000,2056720000,11,25,36
50260000,439800000,2009940000,2.5e+09,19,26,45
397970000,721050000,1380980000,2.5e+09,23,51,74
530020000,640780000,1329200000,2.5e+09,19,47,66
127700000,801320000,1570980000,2.5e+09,22,30,52
83730000,239270000,2.177e+09,2.5e+09,21,35,56
725820000,541060000,1233120000,2.5e+09,32,66,98
245250000,389020000,1865730000,2.5e+09,22,49,71
147220000,1008300000,1344480000,2.5e+09,23,36,59
306530000,505730000,1687740000,2.5e+09,22,34,56
6180000,1937490000,556330000,2.5e+09,25,38,63
177070000,1199990000,1122940000,2.5e+09,32,69,101
374120000,405150000,1671490000,2450760000,33,65,98
382710000,485980000,1631310000,2.5e+09,19,32,51
673700000,366980000,1459320000,2.5e+09,20,51,71
222490000,214280000,2063230000,2.5e+09,23,57,80
830930000,1377630000,291440000,2.5e+09,32,61,93
435160000,1712920000,351920000,2.5e+09,36,70,106
6.36e+08,1498810000,365190000,2.5e+09,33,66,99
1202170000,512060000,785770000,2.5e+09,25,56,81
314840000,1889230000,295930000,2.5e+09,36,69,105
358670000,1647110000,494220000,2.5e+09,43,80,123
313360000,1796120000,390520000,2.5e+09,35,61,96
5910000,2268320000,225770000,2.5e+09,36,61,97
249670000,1937590000,312740000,2.5e+09,36,74,110
305390000,1789600000,405010000,2.5e+09,43,82,125
534780000,1635340000,329880000,2.5e+09,39,69,108
337350000,1218090000,944560000,2.5e+09,39,83,122
489750000,1445250000,5.65e+08,2.5e+09,36,74,110
768790000,1053190000,678020000,2.5e+09,41,81,122
181310000,1736630000,582060000,2.5e+09,42,90,132
451520000,1128250000,920230000,2.5e+09,40,76,116
444560000,1194570000,860870000,2.5e+09,41,84,125
774510000,1548840000,176650000,2.5e+09,30,47,77
1280690000,732240000,487070000,2.5e+09,21,56,77
231790000,1889420000,378790000,2.5e+09,36,76,112
104510000,1814790000,580700000,2.5e+09,41,79,120
15560000,2.048e+09,436440000,2.5e+09,39,78,117
118690000,1832470000,548840000,2.5e+09,43,92,135
5650000,2276610000,217740000,2.5e+09,37,62,99
14020000,1961030000,524950000,2.5e+09,36,70,106
268700000,1623180000,608120000,2.5e+09,41,88,129
254650000,1618250000,627100000,2.5e+09,42,93,135
35840000,2.187e+09,277160000,2.5e+09,34,69,103
33570000,2154280000,312150000,2.5e+09,41,81,122
169700000,1829550000,500750000,2.5e+09,37,73,110
106090000,1566320000,827590000,2.5e+09,41,92,133
612460000,994960000,892580000,2.5e+09,34,64,98
744960000,832580000,922460000,2.5e+09,43,100,143
843330000,509850000,1146820000,2.5e+09,35,67,102
811520000,734850000,953630000,2.5e+09,32,67,99
737680000,1480700000,281620000,2.5e+09,30,56,86
479230000,1465210000,555560000,2.5e+09,44,89,133
1794860000,312840000,392300000,2.5e+09,28,53,81
1721180000,417870000,360950000,2.5e+09,27,63,90
220590000,1676420000,602990000,2.5e+09,36,63,99
159970000,1895810000,444220000,2.5e+09,34,66,100
881870000,1021920000,596210000,2.5e+09,31,53,84
1268350000,696540000,535110000,2.5e+09,23,50,73
134790000,1684670000,680540000,2.5e+09,40,85,125
86870000,2003600000,409530000,2.5e+09,37,65,102
701340000,1279800000,518860000,2.5e+09,35,69,104
1199140000,868670000,432190000,2.5e+09,32,59,91
91580000,1392620000,1015800000,2.5e+09,40,97,137
60010000,1760910000,679080000,2.5e+09,41,88,129
722230000,1203200000,574570000,2.5e+09,38,76,114
271730000,1658860000,569410000,2.5e+09,38,78,116
441530000,1274430000,784040000,2.5e+09,36,74,110
118710000,918090000,1463200000,2.5e+09,37,64,101
789160000,723550000,987290000,2.5e+09,37,73,110
378760000,1775280000,345960000,2.5e+09,30,53,83
895120000,1002800000,602080000,2.5e+09,44,100,144
355380000,1352440000,792180000,2.5e+09,35,61,96
1188270000,623260000,688470000,2.5e+09,36,73,109
879890000,839650000,780460000,2.5e+09,43,77,120
1182050000,592900000,725050000,2.5e+09,37,75,112
999170000,600020000,900810000,2.5e+09,40,87,127
441800000,1166930000,891270000,2.5e+09,41,85,126
144730000,1867100000,488170000,2.5e+09,36,74,110
1434170000,368640000,697190000,2.5e+09,23,50,73
457890000,1646510000,395600000,2.5e+09,27,51,78
1584840000,221110000,694050000,2.5e+09,19,52,71
1481110000,402860000,616030000,2.5e+09,32,57,89
1640900000,438470000,420630000,2.5e+09,24,44,68
1279140000,418460000,802400000,2.5e+09,31,58,89
231200000,1750720000,518080000,2.5e+09,34,64,98
892260000,606310000,1001430000,2.5e+09,39,69,108
396610000,1313360000,790030000,2.5e+09,31,54,85
1585060000,438900000,476040000,2.5e+09,40,76,116
906630000,883910000,709460000,2.5e+09,34,67,101
1216440000,727890000,555670000,2.5e+09,38,77,115
237100000,1813140000,449760000,2.5e+09,44,78,122
364850000,1281540000,853610000,2.5e+09,37,72,109
1303630000,329190000,867180000,2.5e+09,25,54,79
751980000,1166730000,581290000,2.5e+09,42,79,121
393450000,1300640000,805910000,2.5e+09,45,92,137
897310000,524170000,1078520000,2.5e+09,36,81,117
825150000,958740000,716110000,2.5e+09,41,90,131
547560000,1614550000,337890000,2.5e+09,35,66,101
1253530000,897580000,348890000,2.5e+09,43,84,127
741120000,1120290000,638590000,2.5e+09,33,73,106
811110000,988330000,700560000,2.5e+09,37,74,111
528890000,1334950000,636160000,2.5e+09,39,84,123
446370000,1613610000,440020000,2.5e+09,37,82,119
217050000,1860520000,422430000,2.5e+09,35,78,113
542350000,1336420000,621230000,2.5e+09,37,77,114
761390000,1.28e+09,458610000,2.5e+09,38,75,113
243690000,1909870000,346440000,2.5e+09,37,81,118
608100000,1664970000,226930000,2.5e+09,42,83,125
534220000,1636820000,328960000,2.5e+09,42,84,126
1058940000,1134270000,306790000,2.5e+09,35,75,110
790250000,1.394e+09,315750000,2.5e+09,37,79,116
379250000,1745790000,374960000,2.5e+09,43,81,124
460950000,1741170000,297880000,2.5e+09,43,83,126
388230000,326410000,1756690000,2471330000,37,78,115
746250000,1.097e+09,656750000,2.5e+09,42,83,125
80980000,8.89e+08,1530020000,2.5e+09,40,83,123
1387350000,780940000,331710000,2.5e+09,39,65,104
519760000,1780750000,199490000,2.5e+09,44,77,121
1353780000,744280000,401940000,2.5e+09,42,67,109
904040000,1132080000,463880000,2.5e+09,40,79,119
1505600000,522150000,472250000,2.5e+09,41,67,108
993130000,901640000,605230000,2.5e+09,40,85,125
1410670000,653960000,435370000,2.5e+09,44,81,125
1310700000,486290000,703010000,2.5e+09,40,67,107
1645580000,342950000,511470000,2.5e+09,38,72,110
389630000,1796860000,313510000,2.5e+09,34,68,102
725120000,1158030000,616850000,2.5e+09,40,76,116
222940000,1712480000,564580000,2.5e+09,39,86,125
736190000,1398240000,365570000,2.5e+09,36,77,113
820410000,1140610000,538980000,2.5e+09,36,81,117
847850000,1134050000,518100000,2.5e+09,38,79,117
1180250000,780500000,539250000,2.5e+09,36,83,119
774410000,1122960000,602630000,2.5e+09,40,80,120
303530000,1792710000,403760000,2.5e+09,36,80,116
612020000,1489560000,398420000,2.5e+09,38,75,113
547260000,1254800000,697940000,2.5e+09,42,86,128
503400000,1664140000,332460000,2.5e+09,37,79,116
634790000,1283280000,581930000,2.5e+09,39,82,121
355390000,1851060000,293550000,2.5e+09,38,80,118
472500000,1591200000,436300000,2.5e+09,37,72,109
497340000,1594400000,408260000,2.5e+09,38,84,122
774980000,1309730000,415290000,2.5e+09,40,80,120
689060000,1424290000,386650000,2.5e+09,40,74,114
747120000,1306660000,446220000,2.5e+09,39,84,123
1302370000,700370000,497260000,2.5e+09,40,79,119
0,0,2.24e+08,2.24e+08,40,83,123
469100000,847330000,644720000,1961150000,40,83,123
346770000,818750000,171060000,1336580000,43,81,124
10470000,0,919510000,929980000,31,57,88
1225890000,940640000,333470000,2.5e+09,41,72,113
1293710000,594350000,611940000,2.5e+09,38,70,108
1198500000,761530000,539970000,2.5e+09,40,73,113
826770000,1056540000,616690000,2.5e+09,40,81,121
1010750000,622940000,866310000,2.5e+09,41,74,115
1269990000,380770000,849240000,2.5e+09,35,60,95
1304550000,785940000,409510000,2.5e+09,40,68,108
1314150000,706970000,478880000,2.5e+09,40,63,103
676160000,1400430000,423410000,2.5e+09,38,80,118
649820000,1578450000,271730000,2.5e+09,38,74,112
651960000,1302080000,545960000,2.5e+09,38,79,117
527080000,1567260000,405660000,2.5e+09,38,80,118
473400000,1678770000,347830000,2.5e+09,40,86,126
880820000,1193850000,425330000,2.5e+09,39,79,118
751610000,898040000,850350000,2.5e+09,41,89,130
891620000,1070270000,538110000,2.5e+09,43,85,128
587370000,1280350000,632280000,2.5e+09,40,83,123
603050000,1376070000,520880000,2.5e+09,40,87,127
809680000,1008030000,682290000,2.5e+09,41,86,127
810380000,1039120000,650500000,2.5e+09,42,91,133
530110000,1397160000,572730000,2.5e+09,42,90,132
712660000,1311530000,475810000,2.5e+09,37,82,119
651520000,1316130000,532350000,2.5e+09,45,85,130
1238950000,484970000,776080000,2.5e+09,39,80,119
708530000,1247490000,543980000,2.5e+09,42,83,125
647510000,1193230000,659260000,2.5e+09,43,90,133
203250000,730630000,153010000,1086890000,43,83,126
7210000,2710000,15280000,25200000,40,77,117
391240000,646550000,116710000,1154500000,44,84,128
643020000,1114020000,742960000,2.5e+09,47,85,132
238140000,514770000,796830000,1549740000,50,95,145
802660000,1121160000,576180000,2.5e+09,38,81,119
735830000,1103740000,554260000,2393830000,47,92,139
878240000,1160570000,461190000,2.5e+09,41,79,120
199360000,1629880000,670760000,2.5e+09,42,85,127
223810000,1477550000,412850000,2114210000,42,94,136
388970000,1476740000,633540000,2499250000,39,79,118
1462070000,647630000,390300000,2.5e+09,39,59,98
1214160000,970480000,315360000,2.5e+09,38,64,102
1417520000,678970000,403510000,2.5e+09,37,62,99
1374430000,821770000,303800000,2.5e+09,42,74,116
1068180000,1006460000,425360000,2.5e+09,40,87,127
546090000,1224580000,393840000,2164510000,40,77,117
592190000,740650000,220970000,1553810000,48,90,138
8880000,4010000,2080000,14970000,40,87,127
375130000,1645800000,479070000,2.5e+09,42,86,128
803370000,1402850000,293780000,2.5e+09,38,91,129
505270000,1076980000,495280000,2077530000,45,94,139
345530000,1724790000,429680000,2.5e+09,42,85,127
585330000,1355920000,547110000,2488360000,40,85,125
608010000,1247960000,644030000,2.5e+09,41,90,131
298390000,464960000,268270000,1031620000,43,97,140
541530000,5.44e+08,290930000,1376460000,46,96,142
560030000,1242090000,697880000,2.5e+09,45,88,133
709920000,1296550000,493530000,2.5e+09,39,86,125
1157810000,574240000,592720000,2324770000,46,90,136
593800000,322580000,241420000,1157800000,49,91,140
873410000,1238350000,388240000,2.5e+09,40,84,124
658350000,905420000,936230000,2.5e+09,47,93,140
1023170000,374530000,254610000,1652310000,49,94,143
568870000,753070000,293940000,1615880000,48,89,137
251160000,1492180000,169680000,1913020000,39,74,113
363840000,1621920000,281650000,2267410000,46,80,126
823620000,1145720000,530660000,2.5e+09,44,92,136
440330000,1436800000,622870000,2.5e+09,45,90,135
689920000,1299650000,510430000,2.5e+09,41,87,128
516830000,1649090000,334080000,2.5e+09,38,61,99
563580000,1668420000,2.68e+08,2.5e+09,39,65,104
0,3340000,3190000,6530000,38,80,118
137890000,1045790000,457990000,1641670000,41,82,123
413650000,468410000,286490000,1168550000,38,78,116
910690000,148210000,245040000,1303940000,35,62,97
693720000,45260000,103010000,841990000,33,61,94
372200000,159130000,259090000,790420000,30,62,92
430520000,46040000,2023440000,2.5e+09,35,82,117
951810000,220530000,1327660000,2.5e+09,40,90,130
1326570000,436960000,736470000,2.5e+09,43,91,134
1912370000,27410000,560220000,2.5e+09,24,62,86
1858960000,167190000,473850000,2.5e+09,39,86,125
545960000,40200000,1699160000,2285320000,38,73,111
1036900000,117210000,1345890000,2.5e+09,41,89,130
745040000,909340000,845620000,2.5e+09,48,90,138
738820000,1189310000,571870000,2.5e+09,43,90,133
833890000,979740000,686370000,2.5e+09,42,80,122
702810000,1424340000,372850000,2.5e+09,37,74,111
592630000,359420000,1547950000,2.5e+09,46,86,132
1006910000,653540000,839550000,2.5e+09,41,82,123
155900000,30440000,2313660000,2.5e+09,36,84,120
875470000,378680000,1245850000,2.5e+09,43,93,136
905530000,309990000,1284480000,2.5e+09,42,101,143
880820000,400040000,1219140000,2.5e+09,47,97,144
1288530000,777730000,433740000,2.5e+09,42,98,140
1.209e+09,924720000,366280000,2.5e+09,44,96,140
1150070000,143100000,1206830000,2.5e+09,48,107,155
666400000,204610000,1628990000,2.5e+09,48,105,153
1604130000,425830000,470040000,2.5e+09,39,91,130
1780020000,388620000,331360000,2.5e+09,42,94,136
1.15e+09,382800000,967200000,2.5e+09,44,104,148
1266550000,433050000,800400000,2.5e+09,45,108,153
1243760000,933410000,322830000,2.5e+09,38,89,127
1406270000,650310000,443420000,2.5e+09,36,93,129
516080000,66810000,1917110000,2.5e+09,44,100,144
438540000,119520000,1809540000,2367600000,46,102,148
1284010000,540650000,675340000,2.5e+09,46,104,150
667290000,1286900000,545810000,2.5e+09,43,80,123
662970000,1439590000,397440000,2.5e+09,37,74,111
604440000,1437550000,458010000,2.5e+09,40,80,120
689090000,770490000,1040420000,2.5e+09,46,93,139
370270000,152270000,1939770000,2462310000,42,88,130
423320000,214200000,1802810000,2440330000,35,91,126
657460000,279850000,1562690000,2.5e+09,50,105,155
31430000,35150000,2159940000,2226520000,40,86,126
64480000,8080000,2079040000,2151600000,33,70,103
370980000,114900000,2014120000,2.5e+09,42,99,141
801290000,214780000,1483930000,2.5e+09,48,90,138
1146920000,498970000,854110000,2.5e+09,48,95,143
1460660000,563630000,475710000,2.5e+09,45,95,140
282510000,18020000,1931890000,2232420000,43,91,134
1330350000,894060000,275590000,2.5e+09,41,87,128
1146090000,1117030000,236880000,2.5e+09,39,85,124
1.884e+09,157230000,458770000,2.5e+09,42,86,128
1270770000,460380000,768850000,2.5e+09,45,95,140
1623060000,491990000,384950000,2.5e+09,40,91,131
1687920000,358880000,453200000,2.5e+09,38,90,128
1554350000,423850000,521800000,2.5e+09,45,100,145
1525520000,438230000,536250000,2.5e+09,39,92,131
1668680000,18300000,813020000,2.5e+09,25,73,98
1661370000,19200000,819430000,2.5e+09,22,59,81
1251250000,7370000,1241380000,2.5e+09,20,63,83
794870000,0,1705130000,2.5e+09,9,46,55
1203470000,146900000,1149630000,2.5e+09,22,63,85
404730000,14670000,2080600000,2.5e+09,14,43,57
370090000,21930000,2107980000,2.5e+09,19,66,85
159380000,0,2340620000,2.5e+09,15,48,63
479480000,62940000,1957580000,2.5e+09,23,70,93
127090000,13430000,2359480000,2.5e+09,9,46,55
3.87e+08,65830000,2047170000,2.5e+09,11,43,54
1765060000,11530000,723410000,2.5e+09,25,66,91
1855410000,53050000,591540000,2.5e+09,22,65,87
1909370000,199790000,390840000,2.5e+09,33,77,110
1948770000,163250000,387980000,2.5e+09,37,79,116
1581060000,6090000,912850000,2.5e+09,22,73,95
1710280000,20060000,769660000,2.5e+09,28,77,105
1919420000,30270000,550310000,2.5e+09,22,56,78
1644780000,470000,854750000,2.5e+09,14,44,58
1688960000,5100000,805940000,2.5e+09,21,69,90
1758530000,0,741470000,2.5e+09,20,59,79
1691520000,1720000,806760000,2.5e+09,20,58,78
745830000,0,1754170000,2.5e+09,13,47,60
1302990000,1120000,1195890000,2.5e+09,17,57,74
1476140000,820000,1023040000,2.5e+09,14,39,53
465920000,0,2034080000,2.5e+09,17,63,80
835890000,7250000,1656860000,2.5e+09,13,42,55
1137950000,1930000,1360120000,2.5e+09,14,53,67
459920000,1930000,2038150000,2.5e+09,15,46,61
496670000,55660000,1719180000,2271510000,34,76,110
470950000,58840000,1565110000,2094900000,38,77,115
491290000,24270000,1984440000,2.5e+09,37,85,122
1672710000,63460000,763830000,2.5e+09,25,77,102
1604750000,2380000,892870000,2.5e+09,17,47,64
1302700000,8600000,1188700000,2.5e+09,18,55,73
1584420000,5850000,909730000,2.5e+09,28,80,108
1765180000,1310000,733510000,2.5e+09,30,76,106
621650000,0,1878350000,2.5e+09,17,55,72
495850000,160930000,1646300000,2303080000,45,100,145
1622430000,59050000,818520000,2.5e+09,29,83,112
1763610000,13040000,723350000,2.5e+09,29,79,108
1713870000,14540000,771590000,2.5e+09,26,85,111
1377820000,353250000,768930000,2.5e+09,35,65,100
214810000,573480000,1711710000,2.5e+09,33,71,104
1866070000,281230000,352700000,2.5e+09,30,68,98
797410000,1158150000,544440000,2.5e+09,33,65,98
1394870000,555150000,549980000,2.5e+09,30,74,104
944680000,669720000,885600000,2.5e+09,33,72,105
1383720000,440390000,675890000,2.5e+09,34,64,98
100590000,650500000,1647890000,2398980000,43,77,120
940180000,804260000,755560000,2.5e+09,34,73,107
198580000,696010000,1583960000,2478550000,38,68,106
1612470000,400360000,487170000,2.5e+09,31,74,105
678790000,1089260000,731950000,2.5e+09,39,83,122
1155960000,728540000,615500000,2.5e+09,41,83,124
1422230000,652280000,425490000,2.5e+09,35,76,111
1441570000,395720000,662710000,2.5e+09,30,58,88
636740000,1113610000,749650000,2.5e+09,37,73,110
1375380000,469430000,655190000,2.5e+09,34,62,96
899420000,775240000,825340000,2.5e+09,40,74,114
1414400000,107660000,891020000,2413080000,21,48,69
1444860000,122330000,827840000,2395030000,22,43,65
1561920000,237240000,700840000,2.5e+09,21,47,68
1055950000,880360000,563690000,2.5e+09,36,73,109
394200000,1033970000,1071830000,2.5e+09,46,95,141
1.11e+08,2009410000,379590000,2.5e+09,27,55,82
538350000,1328860000,632790000,2.5e+09,41,84,125
334210000,1629120000,536670000,2.5e+09,35,77,112
159540000,1800420000,540040000,2.5e+09,35,70,105
929140000,1102540000,468320000,2.5e+09,36,65,101
1100730000,909450000,489820000,2.5e+09,39,84,123
869390000,1218840000,411770000,2.5e+09,38,71,109
659460000,1426690000,413850000,2.5e+09,39,90,129
229460000,1846010000,424530000,2.5e+09,43,81,124
460740000,1604110000,435150000,2.5e+09,42,79,121
313830000,1827980000,358190000,2.5e+09,44,91,135
508950000,1664570000,326480000,2.5e+09,30,63,93
243800000,1511030000,745170000,2.5e+09,33,71,104
1072620000,880830000,546550000,2.5e+09,32,63,95
1557890000,354920000,587190000,2.5e+09,22,49,71
1834750000,181550000,483700000,2.5e+09,20,51,71
1639740000,267750000,592510000,2.5e+09,22,51,73
1679170000,279360000,541470000,2.5e+09,24,53,77
493480000,1374900000,631620000,2.5e+09,33,66,99
1221370000,871020000,407610000,2.5e+09,44,95,139
653550000,130190000,1498660000,2282400000,45,92,137
749980000,1323080000,426940000,2.5e+09,36,73,109
460640000,1384670000,654690000,2.5e+09,50,106,156
466270000,632970000,1400760000,2.5e+09,43,91,134
295230000,209590000,1745800000,2250620000,49,88,137
446440000,1609410000,444150000,2.5e+09,48,99,147
394760000,1777070000,328170000,2.5e+09,32,54,86
213140000,1939640000,347220000,2.5e+09,37,72,109
39730000,2014370000,445900000,2.5e+09,35,59,94
177350000,1416020000,339600000,1932970000,38,85,123
560420000,1453190000,486390000,2.5e+09,25,50,75
340870000,1293820000,466320000,2101010000,36,70,106
108510000,958340000,426740000,1493590000,38,80,118
417450000,1310970000,732760000,2461180000,38,81,119
159560000,362480000,172170000,694210000,37,71,108
31320000,1023590000,1433960000,2488870000,43,88,131
568380000,1339700000,591920000,2.5e+09,40,86,126
58730000,299180000,2142090000,2.5e+09,41,83,124
206100000,401590000,261130000,868820000,43,95,138
104880000,375250000,1048970000,1529100000,45,92,137
739740000,1190160000,570100000,2.5e+09,44,90,134
1078540000,949170000,472290000,2.5e+09,43,82,125
832530000,980940000,686530000,2.5e+09,46,85,131
1123630000,687430000,413820000,2224880000,47,90,137
719440000,1502280000,278280000,2.5e+09,39,75,114
725650000,1433330000,341020000,2.5e+09,36,71,107
744620000,1340850000,414530000,2.5e+09,41,77,118
584740000,1473800000,441460000,2.5e+09,42,73,115
271700000,120000,124820000,396640000,26,57,83
235390000,38590000,64340000,338320000,25,57,82
15930000,55070000,2.5e+07,9.6e+07,40,76,116
715160000,90110000,183360000,988630000,44,92,136
720190000,310710000,288240000,1319140000,42,93,135
789570000,1111460000,598970000,2.5e+09,44,93,137
1162320000,709390000,628290000,2.5e+09,47,100,147
702580000,527090000,679140000,1908810000,47,100,147
270090000,634400000,327650000,1232140000,49,101,150
139510000,1331990000,627680000,2099180000,37,75,112
229830000,226530000,206490000,662850000,49,101,150
11950000,222140000,105530000,339620000,33,69,102
935590000,1014360000,550050000,2.5e+09,39,80,119
338580000,1984890000,176530000,2.5e+09,41,68,109
1133590000,563940000,802470000,2.5e+09,44,82,126
7.76e+08,1330400000,393600000,2.5e+09,44,81,125
742130000,245580000,1512290000,2.5e+09,44,90,134
963090000,790170000,746740000,2.5e+09,43,85,128
1092250000,614420000,793330000,2.5e+09,42,80,122
1183430000,431710000,884860000,2.5e+09,46,99,145
1144310000,602020000,753670000,2.5e+09,48,92,140
893500000,478570000,1127930000,2.5e+09,44,93,137
1322890000,579590000,597520000,2.5e+09,41,78,119
908280000,335860000,1255860000,2.5e+09,48,102,150
1461880000,497040000,541080000,2.5e+09,43,93,136
1461930000,697120000,340950000,2.5e+09,44,93,137
1823920000,142940000,533140000,2.5e+09,40,91,131
1507040000,335700000,657260000,2.5e+09,40,91,131
1889930000,169140000,440930000,2.5e+09,40,88,128
2034880000,56180000,408940000,2.5e+09,39,88,127
1565040000,412400000,522560000,2.5e+09,39,90,129
1699900000,175090000,625010000,2.5e+09,36,88,124
981600000,636350000,882050000,2.5e+09,43,80,123
681660000,841260000,977080000,2.5e+09,47,101,148
1145060000,675030000,679910000,2.5e+09,43,79,122
1022710000,450400000,1026890000,2.5e+09,43,80,123
1265020000,5.69e+08,665980000,2.5e+09,42,75,117
1156110000,612520000,731370000,2.5e+09,46,83,129
1061920000,816590000,621490000,2.5e+09,41,82,123
1125130000,776270000,598600000,2.5e+09,43,83,126
911680000,1025610000,562710000,2.5e+09,47,92,139
1076330000,1088370000,335300000,2.5e+09,40,83,123
1247620000,569800000,682580000,2.5e+09,45,88,133
1147540000,877580000,474880000,2.5e+09,37,75,112
1036770000,764380000,698850000,2.5e+09,49,89,138
1308100000,721810000,470090000,2.5e+09,41,87,128
548300000,185780000,1729710000,2463790000,46,100,146
206080000,29220000,1903970000,2139270000,43,87,130
145650000,7790000,2015600000,2169040000,38,83,121
1391380000,443480000,665140000,2.5e+09,41,87,128
1357030000,921630000,221340000,2.5e+09,42,92,134
1599160000,242250000,658590000,2.5e+09,45,90,135
1356460000,740120000,403420000,2.5e+09,45,104,149
1663310000,158360000,678330000,2.5e+09,39,86,125
1355740000,182160000,962100000,2.5e+09,38,83,121
1753930000,81260000,664810000,2.5e+09,37,86,123
1689760000,76080000,734160000,2.5e+09,33,76,109
1698720000,102280000,6.99e+08,2.5e+09,34,84,118
1731170000,208040000,560790000,2.5e+09,38,88,126
1472860000,135760000,891380000,2.5e+09,36,84,120
1626890000,151920000,721190000,2.5e+09,39,86,125
1802560000,399900000,297540000,2.5e+09,38,90,128
1822590000,125780000,551630000,2.5e+09,39,88,127
1743440000,345240000,411320000,2.5e+09,36,86,122
1796250000,181150000,522600000,2.5e+09,33,85,118
651380000,903760000,944860000,2.5e+09,41,85,126
833790000,683140000,976320000,2493250000,39,83,122
349010000,169640000,393650000,912300000,45,103,148
9.04e+08,390140000,419100000,1713240000,39,74,113
936890000,626610000,821930000,2385430000,42,85,127
395750000,245880000,870610000,1512240000,43,91,134
852270000,684800000,426640000,1963710000,45,80,125
1010280000,250480000,1239240000,2.5e+09,45,95,140
333560000,71540000,1200650000,1605750000,42,84,126
1752710000,199070000,548220000,2.5e+09,40,85,125
1557400000,311350000,620850000,2489600000,49,104,153
1009820000,286330000,941540000,2237690000,44,97,141
1718860000,166800000,614340000,2.5e+09,39,86,125
1678070000,93630000,728300000,2.5e+09,39,88,127
1320860000,148090000,1031050000,2.5e+09,38,81,119
1556160000,46090000,897750000,2.5e+09,37,74,111
1369210000,196190000,934600000,2.5e+09,39,84,123
1701140000,105370000,693490000,2.5e+09,38,90,128
1636050000,177150000,686800000,2.5e+09,39,80,119
1689820000,41470000,768710000,2.5e+09,32,74,106
1827920000,205730000,466350000,2.5e+09,34,79,113
1582050000,397670000,520280000,2.5e+09,40,88,128
2056060000,86210000,357730000,2.5e+09,35,80,115
1906270000,116480000,477250000,2.5e+09,35,80,115
1393290000,111710000,9.95e+08,2.5e+09,38,92,130
951240000,159340000,640040000,1750620000,41,94,135
1625560000,186390000,688050000,2.5e+09,39,99,138
1207080000,259010000,1033910000,2.5e+09,38,98,136
2124260000,43090000,331580000,2498930000,35,79,114
1479670000,117750000,902580000,2.5e+09,37,85,122
861500000,151020000,1477960000,2490480000,52,105,157
1682100000,473130000,344770000,2.5e+09,44,96,140
280210000,9930000,2191480000,2481620000,44,95,139
1423930000,28460000,1047610000,2.5e+09,26,74,100
1637180000,209060000,653760000,2.5e+09,38,89,127
1338160000,625210000,536630000,2.5e+09,45,108,153
1745170000,318210000,436620000,2.5e+09,34,90,124
1465510000,149400000,885090000,2.5e+09,39,92,131
1626360000,146720000,726920000,2.5e+09,35,92,127
1274850000,57610000,1167540000,2.5e+09,38,97,135
1016530000,93600000,1389870000,2.5e+09,46,114,160
1339800000,32240000,1127960000,2.5e+09,26,79,105
1632090000,39420000,828490000,2.5e+09,34,84,118
1627820000,15120000,857060000,2.5e+09,34,92,126
1568530000,73170000,858300000,2.5e+09,33,81,114
1926960000,12480000,560560000,2.5e+09,29,82,111
1505280000,25800000,968920000,2.5e+09,26,74,100
1657770000,5890000,836340000,2.5e+09,23,72,95
1948690000,11220000,540090000,2.5e+09,24,71,95
1543270000,20650000,936080000,2.5e+09,25,74,99
1728010000,6020000,765970000,2.5e+09,20,69,89
1560510000,1850000,937640000,2.5e+09,17,64,81
1514210000,10610000,975180000,2.5e+09,26,71,97
1.619e+09,0,8.81e+08,2.5e+09,21,57,78
1364050000,1300000,1134650000,2.5e+09,21,72,93
1677250000,770000,821980000,2.5e+09,10,43,53
1460080000,0,1039920000,2.5e+09,19,59,78
1344920000,0,1155080000,2.5e+09,21,64,85
1867040000,290000,632670000,2.5e+09,24,70,94
417940000,13190000,2068870000,2.5e+09,24,70,94
1122940000,2490000,1374570000,2.5e+09,14,51,65
194710000,0,2305290000,2.5e+09,13,54,67
629530000,4070000,1866400000,2.5e+09,24,68,92
1170000,0,2498830000,2.5e+09,10,42,52
181240000,8300000,2310460000,2.5e+09,13,45,58
1649640000,27300000,823060000,2.5e+09,31,81,112
1773910000,22110000,703980000,2.5e+09,33,78,111
1773280000,68320000,658400000,2.5e+09,37,86,123
1812220000,18560000,669220000,2.5e+09,25,87,112
1520250000,14560000,965190000,2.5e+09,28,77,105
1463120000,17120000,1019760000,2.5e+09,28,79,107
1758190000,19920000,721890000,2.5e+09,22,76,98
1851790000,15380000,632830000,2.5e+09,26,74,100
1748710000,19790000,731410000,2499910000,25,82,107
1560760000,9360000,929880000,2.5e+09,26,73,99
1692170000,16160000,791670000,2.5e+09,30,83,113
1720930000,5610000,773460000,2.5e+09,24,70,94
1768500000,320000,731180000,2.5e+09,25,71,96
1.18e+09,0,1.32e+09,2.5e+09,21,66,87
1719010000,0,775720000,2494730000,19,55,74
1258820000,0,1241180000,2.5e+09,23,72,95
1852610000,3380000,644010000,2.5e+09,32,80,112
737140000,33650000,1729210000,2.5e+09,20,67,87
4.42e+08,0,2.058e+09,2.5e+09,20,66,86
410590000,23670000,2065740000,2.5e+09,20,69,89
1111720000,3080000,1385200000,2.5e+09,30,75,105
304470000,18440000,2177090000,2.5e+09,12,49,61
86450000,7430000,2406120000,2.5e+09,13,58,71
1543740000,9130000,756730000,2309600000,23,69,92
1746770000,22260000,725190000,2494220000,30,83,113
1430440000,8650000,477980000,1917070000,24,76,100
1033180000,4970000,624090000,1662240000,25,77,102
1483150000,51760000,636360000,2171270000,39,94,133
720540000,1382320000,397140000,2.5e+09,39,68,107
1863370000,31950000,604680000,2.5e+09,41,93,134
1911620000,92500000,401250000,2405370000,41,96,137
1585430000,21980000,445850000,2053260000,39,86,125
3700000,706980000,1633860000,2344540000,29,74,103
887140000,565650000,1047210000,2.5e+09,45,87,132
0,6450000,2238960000,2245410000,14,54,68
354920000,26260000,4089650000,4470830000,46,97,143
3682420000,3518650000,1709960000,8911030000,41,86,127
381630000,2061150000,3188460000,5631240000,34,80,114
587910000,3944900000,3920460000,8453270000,43,77,120
3356890000,380830000,6332480000,10070200000,37,70,107
1557400000,311350000,620850000,2489600000,49,104,153
1972180000,4839960000,6226890000,13039030000,41,80,121
4439980000,1842690000,4048570000,10331240000,44,84,128
4443840000,2886870000,2415800000,9746510000,47,104,151
5.536e+09,1207590000,3588960000,10332550000,42,85,127
4026620000,3214840000,2840170000,10081630000,45,75,120
2735910000,10052160000,1420500000,14208570000,44,86,130
2271430000,9759430000,2954110000,14984970000,43,84,127
138230000,2429300000,2838260000,5405790000,35,72,107
3857990000,3467250000,5221500000,12546740000,47,87,134
433370000,8609130000,1645930000,10688430000,43,90,133
611340000,4290510000,8098690000,13000540000,38,85,123
722540000,5476180000,1993330000,8192050000,42,94,136
9352260000,1496280000,9252140000,20100680000,38,92,130
2527060000,7645840000,6739480000,16912380000,42,92,134
2291770000,3561310000,4583980000,10437060000,53,102,155
4570960000,208990000,3833760000,8613710000,35,89,124
2881280000,7338930000,4259270000,14479480000,48,89,137
3093450000,6081640000,1808620000,10983710000,44,95,139
1496650000,4006730000,3472510000,8975890000,42,91,133
2046740000,8464560000,4612440000,15123740000,46,98,144
4752700000,278500000,5294850000,10326050000,38,64,102
5896520000,1511210000,1498330000,8906060000,47,97,144
3346150000,4874940000,2477190000,10698280000,48,94,142
314840000,75370000,11646390000,12036600000,31,83,114
367740000,1307050000,7121200000,8795990000,40,95,135
4555720000,5166720000,9270040000,18992480000,39,75,114
6825800000,1080710000,3182350000,11088860000,47,97,144
923870000,7944880000,9570550000,18439300000,45,105,150
1234540000,7771100000,1011100000,10016740000,36,67,103
3455930000,2496310000,4012140000,9964380000,52,114,166
433160000,4679040000,3137980000,8250180000,42,100,142
7240410000,112910000,3092840000,10446160000,29,82,111
7765820000,3284440000,15021050000,26071310000,44,102,146
2770800000,3307730000,5843090000,11921620000,43,90,133
1081750000,4388830000,7845980000,13316560000,49,92,141
8840850000,4988230000,4213610000,18042690000,45,103,148
7.337e+09,3472040000,8944010000,19753050000,48,99,147
3561040000,3853560000,3553880000,10968480000,49,92,141
287550000,4160410000,1063020000,5510980000,38,86,124
4154520000,35730000,6187350000,10377600000,24,74,98
2840310000,5395210000,2216620000,10452140000,35,74,109
2269920000,1979880000,1090860000,5340660000,36,63,99
1055830000,5712130000,8496170000,15264130000,53,121,174
1073320000,3101520000,10851320000,15026160000,39,90,129
8635270000,16270000,5834340000,14485880000,26,74,100
2915450000,2767170000,5111300000,10793920000,53,105,158
6948800000,2463380000,2672840000,12085020000,45,104,149
3457490000,159870000,1908670000,5526030000,41,88,129
2641080000,8992500000,8797220000,20430800000,53,94,147
1249370000,30580000,12926150000,14206100000,25,84,109
3973120000,135810000,4772500000,8881430000,40,73,113
2471510000,86620000,6242370000,8800500000,23,66,89
4983920000,3245390000,4693630000,12922940000,31,62,93
549750000,4955330000,8337610000,13842690000,46,101,147
6034820000,90750000,3951560000,10077130000,31,78,109
3715610000,427010000,1649370000,5791990000,42,100,142
2638390000,3600820000,2546070000,8785280000,34,74,108
472990000,3422010000,7671700000,11566700000,48,97,145
4362700000,2925050000,3000950000,10288700000,44,85,129
4498220000,2606480000,3648550000,10753250000,52,115,167
1622720000,5565190000,2893640000,10081550000,42,86,128
3314850000,2874680000,8209730000,14399260000,35,87,122
4063650000,1820910000,7231100000,13115660000,50,115,165
2219920000,1381800000,1412990000,5014710000,42,71,113
4435480000,8125930000,3519270000,16080680000,54,105,159
340980000,414640000,1743110000,2498730000,24,49,73
202980000,3189130000,1953550000,5345660000,42,98,140
3113700000,5477760000,2020380000,10611840000,44,90,134
1888050000,5053780000,3201270000,10143100000,47,93,140
7532130000,637320000,2934470000,11103920000,42,96,138
5189920000,92560000,2651160000,7933640000,30,97,127
5260340000,4018420000,6386880000,15665640000,40,87,127
7333210000,920200000,2850570000,11103980000,44,94,138
656770000,4314730000,4155350000,9126850000,35,80,115
870780000,8419090000,6548730000,15838600000,43,96,139
4296740000,5282430000,2971850000,12551020000,46,89,135
1881430000,760900000,11208190000,13850520000,53,109,162
4256040000,2398710000,2398900000,9053650000,48,107,155
2619680000,4011950000,3352440000,9984070000,31,67,98
6503710000,188830000,4540600000,11233140000,35,93,128
4264830000,3982060000,6318610000,14565500000,36,67,103
12437510000,1641520000,3101820000,17180850000,45,103,148
1356210000,697350000,8794890000,10848450000,32,87,119
2254170000,2243190000,532680000,5030040000,32,71,103
670780000,4284750000,3442130000,8397660000,31,66,97
4301880000,3218320000,2555950000,10076150000,40,76,116
2702690000,5807340000,1836890000,10346920000,45,91,136
3164090000,5206840000,1970270000,10341200000,41,83,124
626300000,6644910000,1210720000,8481930000,51,104,155
4633450000,1478210000,2085120000,8196780000,40,73,113
1492990000,3125250000,20253260000,24871500000,30,75,105
983240000,5511740000,1886520000,8381500000,45,86,131
2415840000,106370000,2863520000,5385730000,39,91,130
2970250000,961980000,1238030000,5170260000,38,66,104
2254920000,897610000,1834160000,4986690000,34,70,104
4349730000,2693570000,3413850000,10457150000,35,71,106
7008750000,365550000,6645980000,14020280000,46,107,153
5240580000,330360000,3305190000,8876130000,39,88,127
4208820000,3977030000,1380330000,9566180000,46,104,150
2071290000,12465950000,17108930000,31646170000,40,85,125
4218440000,4214540000,2324340000,10757320000,52,103,155
7995940000,49940000,3083080000,11128960000,34,93,127
1452500000,6538150000,5369450000,13360100000,49,110,159
2996040000,4701530000,2649330000,10346900000,50,92,142
5852830000,1090120000,5665450000,12608400000,52,118,170
1534580000,2088570000,1406790000,5029940000,43,83,126
265630000,2569490000,4372930000,7208050000,35,87,122
8059230000,2833780000,3992650000,14885660000,39,97,136
1992020000,26800000,13377240000,15396060000,27,73,100
2602710000,289770000,2172570000,5065050000,34,67,101
2401530000,3796880000,1693190000,7891600000,51,100,151
2682390000,3454530000,2758820000,8895740000,30,64,94
375320000,4061250000,593150000,5029720000,39,82,121
5651080000,1817370000,5925310000,13393760000,53,113,166
4535780000,4052710000,1749010000,10337500000,48,81,129
3496580000,3643960000,3879820000,11020360000,45,86,131
4047060000,1645150000,7789860000,13482070000,45,99,144
2457300000,5060240000,1403290000,8920830000,48,98,146
3065640000,8052790000,1598570000,1.2717e+10,47,93,140
3460990000,3562470000,3052860000,10076320000,41,83,124
6589760000,510810000,2980990000,10081560000,37,89,126
2833910000,2737850000,3504140000,9075900000,45,90,135
3545350000,689350000,8841080000,13075780000,36,73,109
1572390000,12779830000,8079330000,22431550000,46,94,140
4582830000,6797430000,10620490000,22000750000,46,85,131
621890000,3634190000,1214840000,5470920000,39,81,120
2004180000,1963410000,1066970000,5034560000,42,82,124
5979520000,4243320000,3526670000,13749510000,50,101,151
2462710000,4207400000,2223160000,8893270000,45,89,134
3671320000,2340200000,5092230000,11103750000,30,59,89
3999830000,4291770000,2406490000,10698090000,45,86,131
487290000,1114840000,1616960000,3219090000,46,91,137
1133340000,2248570000,4768430000,8150340000,52,94,146
5707570000,5219590000,4196500000,15123660000,46,97,143
313500000,6705030000,2119040000,9137570000,32,76,108
1882720000,625400000,5056880000,7.565e+09,33,84,117
3801750000,4541720000,5860780000,14204250000,42,87,129
2281250000,1918230000,3370740000,7570220000,44,81,125
4770160000,2190500000,3481440000,10442100000,43,87,130
3556880000,1964510000,3384890000,8906280000,50,107,157
1453950000,4871800000,9380030000,15705780000,57,122,179
1899420000,145260000,6876730000,8921410000,22,76,98
394080000,2020370000,11872290000,14286740000,50,112,162
1601490000,2229550000,1334230000,5165270000,46,75,121
11117400000,183540000,4259940000,15560880000,40,92,132
6255850000,954290000,1716030000,8926170000,37,83,120
3625010000,3666880000,3476360000,10768250000,44,84,128
2.39e+09,4567410000,2677030000,9634440000,34,76,110
438100000,4071430000,6323430000,10832960000,39,86,125
3954870000,3116990000,3275050000,10346910000,47,90,137
6202250000,4869300000,9375330000,20446880000,39,87,126
1058560000,3505980000,5577750000,10142290000,48,101,149
2493510000,651100000,11154270000,14298880000,25,86,111
3770120000,2407430000,7652830000,13830380000,50,90,140
5251850000,1481720000,2332370000,9065940000,36,63,99
2386740000,4878660000,1529970000,8795370000,33,84,117
1022680000,7342880000,4186380000,12551940000,38,97,135
3729740000,2843990000,4153570000,10727300000,45,92,137
2173300000,2594150000,4473640000,9241090000,36,71,107
1285110000,6831380000,2576620000,10693110000,43,99,142
939170000,6495460000,1736980000,9171610000,49,96,145
1758930000,5623700000,8785280000,16167910000,49,93,142
1934650000,6272630000,2251490000,10458770000,54,91,145
1833900000,6919120000,1960120000,10713140000,46,91,137
716290000,2577840000,5246440000,8540570000,49,88,137
2831370000,9395550000,2420970000,14647890000,45,90,135
1747320000,267510000,3025230000,5040060000,38,67,105
4206650000,3501820000,2639110000,10347580000,50,89,139
3359080000,116330000,17368140000,20843550000,34,93,127
501180000,1792230000,3012150000,5305560000,44,78,122
5839160000,6231030000,2095280000,14165470000,51,97,148
1261830000,1752940000,21841450000,24856220000,26,65,91
4267080000,2682010000,6967220000,13916310000,43,81,124
3218200000,4656590000,2827830000,10702620000,42,85,127
1710240000,5137260000,2358750000,9206250000,48,104,152
1498640000,7024040000,4699110000,13221790000,45,91,136
2458920000,6764320000,2830570000,12053810000,46,96,142
4899920000,3149050000,3029470000,11078440000,51,97,148
3395270000,5163770000,1778290000,10337330000,50,91,141
2529650000,6403130000,2214690000,11147470000,38,86,124
9247940000,2332820000,2527080000,14107840000,40,92,132
3722520000,386720000,4296580000,8405820000,41,92,133
964620000,6464010000,5443490000,12872120000,37,70,107
2550580000,223100000,8732530000,11506210000,27,77,104
4272320000,6722770000,3470130000,14465220000,43,81,124
1248450000,5138410000,2694120000,9080980000,45,94,139
292400000,4104090000,643270000,5039760000,41,78,119
3983430000,1948990000,4069080000,10001500000,51,105,156
3011350000,10615850000,2072650000,15699850000,43,87,130
1406530000,1965280000,1943800000,5315610000,44,102,146
3148750000,4777390000,7317410000,15243550000,44,100,144
1955440000,4421840000,2388410000,8765690000,42,84,126
277430000,4089360000,6555640000,10922430000,39,90,129
2259520000,2455960000,5736630000,10452110000,42,93,135
7214520000,507560000,3371780000,11093860000,40,94,134
4964600000,10641720000,3125940000,18732260000,53,104,157
4768650000,3688560000,3119150000,11576360000,48,97,145
306230000,8026640000,1029930000,9362800000,40,84,124
2645180000,276340000,1.917e+09,4838520000,43,98,141
7597390000,610700000,2895890000,11103980000,41,97,138
4900630000,2327730000,1692820000,8921180000,41,88,129
1317500000,3340430000,4717900000,9375830000,50,96,146
256620000,3165150000,2073060000,5494830000,46,93,139
7618120000,389680000,2881040000,10888840000,44,103,147
4149330000,4109230000,2454680000,10713240000,49,93,142
6862190000,2679870000,4173310000,13715370000,43,92,135
6.262e+09,2917180000,6365740000,15544920000,43,99,142
2424350000,4961060000,12261200000,19646610000,38,74,112
4480910000,3997150000,2711910000,11189970000,48,88,136
2532230000,6101140000,1853050000,10486420000,46,87,133
2173530000,6997880000,8113010000,17284420000,39,89,128
3501920000,2626300000,4900010000,11028230000,45,80,125
3399880000,2757440000,4284700000,10442020000,42,97,139
2928500000,8642600000,4529950000,16101050000,40,83,123
6646940000,1174640000,4403940000,12225520000,46,106,152
521960000,1007470000,17561480000,19090910000,25,65,90
4687040000,4000940000,1654320000,10342300000,46,88,134
4931290000,5003460000,3823040000,13757790000,43,84,127
2518340000,3469650000,1858040000,7846030000,51,94,145
5432690000,2431620000,6184200000,14048510000,57,95,152
3310210000,387120000,10746350000,14443680000,29,84,113
5864970000,470880000,4325550000,10661400000,43,100,143
2771240000,1758390000,484790000,5014420000,31,68,99
2820510000,7586680000,2069730000,12476920000,45,84,129
1415450000,1948370000,7880850000,11244670000,40,77,117
3572540000,7197180000,3687500000,14457220000,54,103,157
134420000,2958900000,2312470000,5405790000,28,63,91
3994470000,4359090000,2649940000,11003500000,42,87,129
4518040000,7750440000,1934990000,14203470000,41,90,131
7274410000,468530000,2827590000,10570530000,41,96,137
1768950000,7204490000,5502320000,14475760000,53,96,149
4859800000,2995990000,2224430000,10080220000,44,89,133
1285700000,2581960000,1162150000,5029810000,43,84,127
1402740000,3081200000,681310000,5165250000,48,94,142
2435790000,5736220000,5167450000,13339460000,33,76,109
2750900000,236730000,5808110000,8795740000,38,69,107
2744900000,7754060000,5058960000,15557920000,43,79,122
2745930000,31330000,9895090000,12672350000,28,81,109
8431770000,247790000,2249090000,10928650000,40,97,137
2883130000,214450000,6972820000,10070400000,29,75,104
1525340000,2881080000,808950000,5215370000,42,86,128
4373930000,1395150000,11754560000,17523640000,38,99,137
5503310000,42720000,3048150000,8594180000,27,77,104
4823400000,571140000,8712420000,14106960000,36,87,123
6573490000,413050000,10487860000,17474400000,36,90,126
2549860000,4831640000,5446730000,12828230000,29,70,99
2863740000,2717770000,4494860000,10076370000,46,89,135
3036140000,497920000,1682280000,5216340000,45,98,143
10028430000,1946460000,2601230000,14576120000,45,103,148
3574400000,4303160000,2474480000,10352040000,49,88,137
1066180000,2071100000,7948400000,11085680000,37,81,118
5484180000,887560000,3293030000,9664770000,36,69,105
6163450000,242830000,3931100000,10337380000,37,66,103
815650000,7915820000,1946120000,10677590000,43,96,139
5064480000,3718570000,1909590000,10692640000,45,84,129
2720460000,1121110000,1323740000,5165310000,40,78,118
10688730000,1771580000,3085540000,15545850000,42,93,135
6389710000,5064560000,4732960000,16187230000,52,98,150
1130040000,8315520000,6041040000,15486600000,52,98,150
2900670000,3149750000,4108300000,10158720000,52,98,150
4369050000,7136310000,2417250000,13922610000,38,78,116
2705970000,5933430000,2494940000,11134340000,46,84,130
1712730000,1517110000,717580000,3947420000,45,94,139
3463540000,4608180000,3000390000,11072110000,45,87,132
4120020000,3430980000,3389950000,10940950000,51,101,152
5912350000,7695750000,2111090000,15719190000,46,88,134
2014610000,9983530000,2215780000,14213920000,43,81,124
9918960000,1058370000,1700020000,12677350000,42,95,137
2595060000,4423230000,1902840000,8921130000,46,86,132
179980000,4550640000,4500430000,9231050000,38,81,119
843360000,4252360000,7741520000,12837240000,39,88,127
3228210000,4764020000,1084010000,9076240000,36,71,107
47460000,218490000,4246750000,4512700000,29,65,94
12454380000,821010000,3482290000,16757680000,38,91,129
4890830000,691550000,4863910000,10446290000,38,72,110
3.632e+09,3810040000,5763370000,13205410000,47,92,139
465710000,835970000,7320690000,8622370000,26,64,90
3593780000,4399400000,2458210000,10451390000,38,89,127
1147790000,997020000,6820640000,8965450000,39,100,139
13551460000,312460000,6513230000,20377150000,42,84,126
5959590000,4428730000,9833620000,20221940000,55,110,165
3204320000,4967310000,1909900000,10081530000,44,82,126
2131020000,1696810000,5249130000,9076960000,40,83,123
5126960000,2611630000,5911310000,13649900000,43,88,131
6936200000,3874100000,3953830000,14764130000,51,106,157
7920360000,3990000,3214820000,11139170000,33,88,121
2474150000,2250250000,2962490000,7686890000,49,109,158
3127060000,805020000,11004990000,14937070000,37,91,128
963020000,2156300000,11425720000,14545040000,35,85,120
6100120000,2324570000,1912650000,10337340000,42,76,118
2654250000,2230570000,5196160000,10080980000,43,92,135
3589790000,5830000,1790110000,5385730000,23,72,95
2803360000,1554850000,1147780000,5505990000,41,91,132
2284290000,6006210000,6368830000,14659330000,46,87,133
967980000,6122330000,1611930000,8702240000,44,90,134
5709350000,8300000,5119820000,10837470000,29,83,112
6870730000,19520000,4230650000,11120900000,30,86,116
460230000,4113390000,12189160000,16762780000,41,93,134
1228100000,4107260000,4745970000,10081330000,46,94,140
4577180000,4573090000,1557880000,10708150000,43,77,120
939050000,507180000,9313200000,10759430000,31,78,109
1145640000,1718240000,1435460000,4299340000,54,103,157
1457440000,8524720000,2669950000,12652110000,35,74,109
3297160000,242960000,3604660000,7144780000,37,80,117
1784250000,1789560000,5338430000,8912240000,40,86,126
2324120000,5607250000,2509910000,10441280000,51,85,136
5234790000,36300000,3415430000,8686520000,31,84,115
5694550000,510420000,4566880000,10771850000,41,96,137
1062930000,2310890000,1660840000,5034660000,44,88,132
800120000,110880000,3718230000,4629230000,19,69,88
623610000,696680000,13002720000,14323010000,40,99,139
2950010000,1017730000,6208180000,10175920000,42,104,146
1246530000,72440000,7476440000,8795410000,25,72,97
3612960000,660820000,4521830000,8795610000,38,86,124
9500640000,4298860000,5298800000,19098300000,44,82,126
4524690000,624900000,12378330000,17527920000,34,86,120
8562950000,90480000,4322540000,12975970000,38,93,131
4239290000,2008530000,1916050000,8163870000,39,71,110
2270320000,6162090000,2019730000,10452140000,39,84,123
2248080000,9716120000,2771170000,14735370000,46,90,136
1846590000,1774350000,1729730000,5350670000,33,64,97
782430000,187840000,3890100000,4860370000,21,71,92
2238250000,5061010000,2130360000,9429620000,51,99,150
3761780000,4365750000,4720460000,12847990000,42,79,121
1411900000,2638190000,1455900000,5505990000,43,89,132
3149400000,5016530000,2170160000,10336090000,42,97,139
1192490000,131900000,3705340000,5029730000,39,64,103
4804510000,5266810000,6014420000,16085740000,51,97,148
3056400000,2781260000,4432220000,10269880000,56,116,172
3141870000,6116110000,1084440000,10342420000,50,93,143
1342990000,166310000,8280420000,9789720000,23,77,100
5009150000,20730000,7884720000,12914600000,23,58,81
4312890000,6046520000,2087550000,12446960000,31,77,108
1852380000,11552770000,1092370000,14497520000,42,84,126
1869340000,780450000,5351390000,8001180000,35,72,107
549890000,6947050000,5059860000,12556800000,42,91,133
2866440000,4557070000,2132220000,9555730000,50,96,146
1504600000,12274710000,2417410000,16196720000,43,83,126
1294930000,5658710000,5399270000,12352910000,48,109,157
4412270000,3853020000,5328140000,13593430000,49,100,149
1735570000,6499980000,2100630000,10336180000,48,106,154
530770000,3635220000,593510000,4759500000,37,86,123
854020000,7580880000,2248350000,10683250000,48,94,142
428750000,369760000,8900420000,9698930000,39,91,130
6398640000,2778120000,5322890000,14499650000,48,116,164
3307110000,401560000,5772020000,9480690000,39,81,120
4965940000,3684430000,2983070000,11633440000,53,107,160
3711700000,8375960000,4642310000,16729970000,44,80,124
2393210000,6197180000,2117830000,10708220000,44,93,137
7235450000,2524770000,3162160000,12922380000,37,70,107
3365790000,3412850000,2495730000,9274370000,54,109,163
1741820000,2252910000,1130460000,5125190000,46,90,136
5467070000,4708120000,3665210000,13840400000,45,100,145
3905590000,1930000,8889890000,12797410000,17,67,84
1943230000,5816820000,1414670000,9174720000,44,91,135
2934870000,959710000,6028870000,9923450000,37,96,133
3716440000,1646220000,6960520000,12323180000,55,109,164
846990000,16910000,12475170000,13339070000,29,76,105
3460190000,6867640000,1701880000,12029710000,37,73,110
2030260000,397280000,7268930000,9696470000,31,85,116
2328280000,6222290000,1858950000,10409520000,48,88,136
6040750000,2812670000,3548830000,12402250000,46,100,146
6961310000,8294110000,6382140000,21637560000,46,93,139
3908830000,4921920000,1876910000,10707660000,44,98,142
6529850000,4923270000,2628490000,14081610000,43,92,135
9975860000,557260000,5055930000,15589050000,41,97,138
2023920000,223710000,11525620000,13773250000,32,87,119
1969840000,6948570000,1669460000,10587870000,48,94,142
3189340000,5098010000,2054540000,10341890000,50,91,141
4521690000,3e+05,5899410000,10421400000,21,68,89
6885190000,4172910000,4065670000,15123770000,46,86,132
10808290000,59140000,6061190000,16928620000,35,95,130
2159540000,1912750000,957390000,5029680000,40,84,124
1615540000,2369970000,2086610000,6072120000,39,81,120
614630000,2650300000,1229630000,4494560000,39,82,121
2417100000,4255940000,3171020000,9844060000,44,85,129
3111370000,5809090000,5527770000,14448230000,51,93,144
5525610000,1316660000,3910950000,10753220000,52,112,164
1044430000,3360480000,13669070000,18073980000,33,59,92
975640000,11404890000,6590360000,18970890000,48,101,149
3871420000,729660000,884860000,5485940000,33,75,108
1566110000,1027410000,10243960000,12837480000,32,82,114
3245720000,8111720000,1679040000,13036480000,48,89,137
1574810000,737760000,8336320000,10648890000,35,86,121
3144890000,5856140000,1451510000,10452540000,41,82,123
4207390000,8212340000,3656790000,16076520000,48,96,144
1915550000,2601350000,989070000,5505970000,40,93,133
3521440000,3182780000,2086180000,8790400000,47,96,143
5507170000,3883740000,5219620000,14610530000,50,101,151
2288980000,3741810000,4425640000,10456430000,41,76,117
4400790000,2590170000,2794140000,9785100000,42,86,128
4876030000,3936560000,4271700000,13084290000,49,108,157
3223920000,1165820000,5131280000,9521020000,45,94,139
2505150000,3316840000,7110620000,12932610000,38,75,113
3237400000,1145750000,4307580000,8690730000,46,83,129
1533910000,4502210000,6000290000,12036410000,54,106,160
3137990000,3169520000,4735550000,11043060000,51,95,146
2214650000,646190000,6633700000,9494540000,44,75,119
1832220000,6667550000,2486180000,10985950000,46,97,143
1763730000,5802590000,11347140000,18913460000,33,77,110
3211170000,3024520000,2845360000,9081050000,46,94,140
6435050000,1788770000,6899060000,15122880000,45,80,125
1552620000,2735570000,746360000,5034550000,34,63,97
1405640000,5594280000,3661840000,10661760000,44,100,144
7034560000,119320000,3965330000,11119210000,36,96,132
1916500000,4715900000,2534270000,9166670000,45,97,142
4958790000,3803510000,1585080000,10347380000,43,86,129
5937850000,3898360000,4925870000,14762080000,41,79,120
2365120000,2011080000,653680000,5029880000,40,85,125
447120000,655340000,12086930000,13189390000,25,65,90
3146380000,64320000,1217580000,4428280000,39,94,133
2355140000,291110000,5863390000,8509640000,24,74,98
589460000,3323220000,12326230000,16238910000,31,78,109
3418010000,4896140000,1778930000,10093080000,51,91,142
443610000,3673280000,3960560000,8077450000,39,90,129
3246560000,5517320000,1949330000,10713210000,43,88,131
422120000,3040530000,5674250000,9136900000,34,77,111
4290460000,9670000,6844050000,11144180000,29,83,112
9029950000,101750000,3791630000,12923330000,33,92,125
2969080000,1972360000,3683460000,8624900000,35,73,108
817150000,6459620000,3022940000,10299710000,37,57,94
8630720000,2660630000,3127490000,14418840000,41,71,112
58240000,2071090000,3548220000,5677550000,41,75,116
162400000,1661760000,775850000,2600010000,38,80,118
2864550000,6361670000,1877640000,11103860000,49,92,141
1575010000,4801150000,2021560000,8397720000,40,85,125
1831810000,6676830000,5825870000,14334510000,50,104,154
5729150000,49490000,4593920000,10372560000,33,84,117
9757110000,262040000,4089780000,14108930000,35,79,114
2164040000,5506130000,1.251e+09,8921170000,50,88,138
6417420000,6752480000,2268010000,15437910000,45,88,133
1691240000,465550000,5394830000,7551620000,38,90,128
6272980000,817420000,2161010000,9251410000,40,100,140
2172780000,1565710000,1431830000,5170320000,52,97,149
1216280000,3117890000,811210000,5145380000,49,94,143
1038650000,7975320000,1663620000,10677590000,44,95,139
241280000,597010000,12999280000,13837570000,25,69,94
3364580000,3676790000,3270420000,10311790000,29,70,99
1760300000,701480000,10380740000,12842520000,28,83,111
3098950000,1441270000,4887850000,9428070000,42,92,134
784890000,791750000,923360000,2.5e+09,16,35,51
4447570000,4480840000,1408980000,10337390000,50,94,144
2075500000,6783650000,5910030000,14769180000,51,90,141
3517360000,8649540000,2276570000,14443470000,46,88,134
5281540000,8779450000,4978420000,19039410000,49,103,152
17114140000,9429520000,21961330000,48504990000,51,109,160
18205130000,15259260000,24526490000,57990880000,71,119,190
19782330000,31259130000,25837730000,76879190000,59,108,167
4265740000,16742040000,24358200000,45365980000,48,104,152
2114690000,7428060000,22802970000,32345720000,35,71,106
20095520000,44106480000,12585400000,76787400000,54,117,171
19252500000,20260720000,9136200000,48649420000,53,109,162
13009830000,4249090000,7538220000,24797140000,53,115,168
20501010000,1084520000,14487950000,36073480000,42,98,140
17968080000,28698920000,17490580000,64157580000,63,128,191
13235310000,3270180000,41375890000,57881380000,42,107,149
20909590000,21455870000,10505650000,52871110000,54,109,163
2738030000,23496130000,31117550000,57351710000,47,104,151
11576320000,23049290000,18956660000,53582270000,40,90,130
8719160000,25068660000,28828390000,62616210000,53,111,164
12149710000,16819830000,16938030000,45907570000,45,102,147
2340480000,3054520000,41821380000,47216380000,28,73,101
36641280000,1769860000,18043010000,56454150000,43,105,148
17882710000,30986220000,26064950000,74933880000,58,95,153
18447550000,4263590000,22760390000,45471530000,48,91,139
2773810000,24673320000,31110790000,58557920000,48,109,157
4925880000,19796270000,35931810000,60653960000,62,136,198
17351520000,30972490000,16910340000,65234350000,55,118,173
2206240000,1.3109e+10,18023720000,33338960000,41,90,131
12371060000,19772180000,12914250000,45057490000,55,111,166
19498580000,18273570000,23101580000,60873730000,59,124,183
22661210000,9584630000,31872900000,64118740000,50,110,160
6932500000,35569530000,27219300000,69721330000,60,117,177
19514300000,1863970000,10117660000,31495930000,47,108,155
2281120000,21708280000,39468420000,63457820000,46,113,159
2115440000,4715160000,57072020000,63902620000,33,84,117
11252220000,15870420000,14295860000,41418500000,46,97,143
19698230000,5509060000,11707960000,36915250000,54,118,172
11879950000,44143670000,35107980000,91131600000,59,108,167
15241740000,30255020000,14110670000,59607430000,50,102,152
15083860000,19378680000,11985820000,46448360000,49,97,146
33717330000,34496930000,25230550000,93444810000,50,112,162
7198110000,32201080000,20048880000,59448070000,56,118,174
23543360000,9080560000,13874330000,46498250000,56,124,180
15709780000,22711960000,19019980000,57441720000,60,119,179
8698120000,3136760000,20602080000,32436960000,57,113,170
4665980000,1525760000,50299270000,56491010000,39,109,148
13953360000,16962780000,10127280000,41043420000,53,102,155
19146290000,17203210000,12013330000,48362830000,48,97,145
18415490000,15939410000,19943700000,54298600000,57,109,166
32969760000,4668050000,26516310000,64154120000,45,111,156
15467520000,25757490000,8365380000,49590390000,55,100,155
13435030000,26452010000,10516940000,50403980000,51,97,148
9209090000,18433140000,19869310000,47511540000,54,109,163
1.5974e+10,3148720000,10615110000,29737830000,53,120,173
15888910000,1574290000,37786160000,55249360000,41,107,148
14791120000,212530000,47690680000,62694330000,38,106,144
11046420000,20979870000,7533710000,3.956e+10,56,108,164
10033870000,15505940000,6542150000,32081960000,58,111,169
27303340000,10110480000,21799550000,59213370000,48,106,154
11923230000,9783420000,15215320000,36921970000,44,89,133
3761630000,25141350000,19718170000,48621150000,52,113,165
12242210000,8990570000,11371300000,32604080000,52,111,163
12730260000,7906900000,15026570000,35663730000,50,108,158
16151420000,23398360000,13413190000,52962970000,54,105,159
13378260000,39189960000,36504770000,89072990000,59,102,161
20010650000,2684500000,36897730000,59592880000,42,115,157
12553060000,28615090000,36034690000,77202840000,44,86,130
15415770000,1851440000,5548620000,22815830000,44,103,147
5730720000,5530340000,45010910000,56271970000,40,100,140
8929150000,1762420000,34934640000,45626210000,38,97,135
9046910000,10224910000,23181480000,42453300000,54,113,167
37368690000,1377120000,17224520000,55970330000,45,109,154
7071970000,3967470000,7944800000,18984240000,53,114,167
23169490000,14156120000,20710660000,58036270000,59,107,166
10749190000,27965880000,8442150000,47157220000,46,104,150
3223600000,15518820000,43020790000,61763210000,45,105,150
20147290000,1028160000,6599040000,27774490000,45,107,152
16900350000,16183520000,11680870000,44764740000,51,96,147
17281940000,32162970000,9029910000,58474820000,57,113,170
35385720000,97350000,21246070000,56729140000,38,106,144
4156760000,22474260000,11002790000,37633810000,50,103,153
10123360000,30804010000,23494170000,64421540000,58,108,166
15415430000,24694090000,12719580000,52829100000,58,109,167
12419870000,25107510000,8171100000,45698480000,48,102,150
2001950000,2005820000,35422960000,39430730000,39,95,134
35354800000,10575900000,23676960000,69607660000,46,109,155
21458420000,20896580000,10673450000,53028450000,56,119,175
6994770000,33224550000,11196970000,51416290000,50,108,158
28526530000,697080000,19075870000,48299480000,47,112,159
18147020000,15545160000,12828600000,46520780000,54,100,154
13468870000,718770000,46632670000,60820310000,37,99,136
11783960000,7851470000,18697440000,38332870000,44,101,145
19420060000,21941020000,43570960000,84932040000,57,97,154
14805160000,11140030000,19204780000,45149970000,50,102,152
11840850000,8028660000,21496600000,41366110000,59,112,171
8986660000,19072420000,7943720000,36002800000,53,115,168
12558110000,10359090000,18478620000,41395820000,62,120,182
31606310000,247910000,18700840000,50555060000,38,98,136
11674730000,7210270000,14459010000,33344010000,57,116,173
5769900000,10328420000,7081200000,23179520000,58,108,166
17167960000,1524980000,6565320000,25258260000,46,102,148
15142660000,4967510000,11077800000,31187970000,55,117,172
27648220000,862330000,69838440000,98348990000,35,103,138
2573930000,18043090000,9071270000,29688290000,53,111,164
16367470000,11653100000,11392040000,39412610000,54,105,159
15112720000,24233760000,17267420000,56613900000,64,106,170
15556680000,25209640000,8537440000,49303760000,48,96,144
12349010000,8212080000,7370930000,27932020000,53,106,159
10828820000,19177490000,10573390000,40579700000,56,114,170
26329060000,389570000,12746840000,39465470000,45,103,148
29113860000,7394670000,18090010000,54598540000,50,110,160
6666530000,12188570000,23940240000,42795340000,43,100,143
14609900000,21306610000,12642120000,48558630000,52,97,149
8162920000,4178430000,11160950000,23502300000,52,111,163
8504210000,41175940000,22045400000,71725550000,55,133,188
10265090000,14451900000,6232660000,30949650000,57,112,169
111390620000,8623910000,68695920000,188710450000,57,124,181
8606140000,56189290000,127885930000,192681360000,53,127,180
58042550000,58956460000,62542010000,179541020000,67,128,195
29686510000,61638060000,108284110000,199608680000,55,120,175
45451570000,81391510000,3.9409e+10,166252080000,61,122,183
63264670000,81305180000,39409230000,183979080000,62,125,187
6.9427e+10,55071420000,93206420000,217704840000,77,154,231
60186180000,74007970000,75116880000,209311030000,77,139,216
122065450000,6466300000,145728650000,274260400000,48,126,174
20963220000,75339010000,63293170000,159595400000,64,115,179
82957450000,12878480000,142700040000,238535970000,49,126,175
114551330000,37787230000,100027070000,252365630000,56,124,180
17481510000,56262610000,51192570000,124936690000,64,114,178
28671500000,94550290000,115990340000,239212130000,65,136,201
88508140000,1.311e+09,155386100000,245205240000,43,127,170
24711870000,37596890000,57758560000,120067320000,59,103,162
70352680000,102088840000,51874330000,224315850000,60,119,179
98225530000,23564420000,70481680000,192271630000,62,130,192
30736180000,104639190000,95311300000,230686670000,56,130,186
75834930000,62608470000,60858040000,199301440000,65,122,187
49935210000,62472640000,73510100000,185917950000,72,138,210
73108840000,112451650000,52098530000,237659020000,58,128,186
81876410000,73292630000,49777420000,204946460000,69,139,208
43721160000,89100650000,78412920000,211234730000,68,146,214
72661600000,139346640000,72214080000,284222320000,63,145,208
16499330000,20557230000,246575690000,283632250000,51,129,180
39768040000,69606950000,54052260000,163427250000,67,120,187
43029410000,54358260000,137637640000,235025310000,61,131,192
227629860000,85623790000,337075220000,650328870000,65,145,210
389106510000,41598560000,417029550000,847734620000,69,152,221
269502940000,425503410000,442843610000,1137849960000,75,161,236
161645790000,333903310000,325535490000,821084590000,80,160,240
317238410000,343279530000,357062840000,1017580780000,91,185,276
48276210000,187777140000,511391290000,747444640000,74,179,253
227911970000,331095270000,228097130000,787104370000,74,151,225
1596762660000,1695128470000,2708204500000,6000095630000,122,270,392
